genome	S_alg	k	d	M_alg	kmer_count	l	o	z	r	tigs_ns	tigs_cl	enc0_xz_bytes	S_xz_bytes	M_xz_bytes	enc1_xz_bytes	enc2_xz_bytes	pref
spneumo-pangenome	eulertigs	11	na	default	1545282	2529652	1545282	984370	98437	98437	2529652	756496	691004	91236	782240	821412	spneumo-pangenome.S_eulertigs.k_11.d_na.M_default
spneumo-pangenome	eulertigs	11	na	ones	1545282	2529652	2200774	328878	171132	98437	2529652	756496	691004	174124	865128	839416	spneumo-pangenome.S_eulertigs.k_11.d_na.M_ones
spneumo-pangenome	eulertigs	11	na	runs	1545282	2529652	1977798	551854	84400	98437	2529652	756496	691004	129656	820660	808600	spneumo-pangenome.S_eulertigs.k_11.d_na.M_runs
spneumo-pangenome	eulertigs	11	na	zeros	1545282	2529652	1545282	984370	289299	98437	2529652	756496	691004	250400	941404	930072	spneumo-pangenome.S_eulertigs.k_11.d_na.M_zeros
spneumo-pangenome	greedytigs	11	na	default	1545282	1861118	1852348	8770	877	877	1861118	503304	509176	3716	512892	510164	spneumo-pangenome.S_greedytigs.k_11.d_na.M_default
spneumo-pangenome	greedytigs	11	na	ones	1545282	1861118	1855052	6066	1934	877	1861118	503304	509176	4872	514048	511116	spneumo-pangenome.S_greedytigs.k_11.d_na.M_ones
spneumo-pangenome	greedytigs	11	na	runs	1545282	1861118	1853102	8016	877	877	1861118	503304	509176	3904	513080	510724	spneumo-pangenome.S_greedytigs.k_11.d_na.M_runs
spneumo-pangenome	greedytigs	11	na	zeros	1545282	1861118	1545282	315836	164818	877	1861118	503304	509176	148384	657560	644740	spneumo-pangenome.S_greedytigs.k_11.d_na.M_zeros
spneumo-pangenome	eulertigs	12	na	default	3336895	6813225	3336895	3476330	316030	316030	6813225	2035828	1808668	255108	2063776	2223232	spneumo-pangenome.S_eulertigs.k_12.d_na.M_default
spneumo-pangenome	eulertigs	12	na	ones	3336895	6813225	5176736	1636489	659045	316030	6813225	2035828	1808668	608112	2416780	2410164	spneumo-pangenome.S_eulertigs.k_12.d_na.M_ones
spneumo-pangenome	eulertigs	12	na	runs	3336895	6813225	4331480	2481745	292734	316030	6813225	2035828	1808668	398168	2206836	2220208	spneumo-pangenome.S_eulertigs.k_12.d_na.M_runs
spneumo-pangenome	eulertigs	12	na	zeros	3336895	6813225	3336895	3476330	874486	316030	6813225	2035828	1808668	722568	2531236	2537188	spneumo-pangenome.S_eulertigs.k_12.d_na.M_zeros
spneumo-pangenome	greedytigs	12	na	default	3336895	4398137	4360759	37378	3398	3398	4398137	1166376	1165972	12584	1178556	1172896	spneumo-pangenome.S_greedytigs.k_12.d_na.M_default
spneumo-pangenome	greedytigs	12	na	ones	3336895	4398137	4368944	29193	6819	3398	4398137	1166376	1165972	16664	1182636	1178220	spneumo-pangenome.S_greedytigs.k_12.d_na.M_ones
spneumo-pangenome	greedytigs	12	na	runs	3336895	4398137	4363089	35048	3398	3398	4398137	1166376	1165972	13264	1179236	1174108	spneumo-pangenome.S_greedytigs.k_12.d_na.M_runs
spneumo-pangenome	greedytigs	12	na	zeros	3336895	4398137	3336895	1061242	500670	3398	4398137	1166376	1165972	415424	1581396	1577204	spneumo-pangenome.S_greedytigs.k_12.d_na.M_zeros
spneumo-pangenome	eulertigs	13	na	default	5038555	10244419	5038555	5205864	433822	433822	10244419	2993344	2661464	379128	3040592	3285684	spneumo-pangenome.S_eulertigs.k_13.d_na.M_default
spneumo-pangenome	eulertigs	13	na	ones	5038555	10244419	6874480	3369939	931975	433822	10244419	2993344	2661464	915188	3576652	3628092	spneumo-pangenome.S_eulertigs.k_13.d_na.M_ones
spneumo-pangenome	eulertigs	13	na	runs	5038555	10244419	5878417	4366002	420809	433822	10244419	2993344	2661464	568224	3229688	3281548	spneumo-pangenome.S_eulertigs.k_13.d_na.M_runs
spneumo-pangenome	eulertigs	13	na	zeros	5038555	10244419	5038555	5205864	1022247	433822	10244419	2993344	2661464	957392	3618856	3699288	spneumo-pangenome.S_eulertigs.k_13.d_na.M_zeros
spneumo-pangenome	greedytigs	13	na	default	5038555	6801307	6644359	156948	13079	13079	6801307	1772900	1752348	40836	1793184	1789244	spneumo-pangenome.S_greedytigs.k_13.d_na.M_default
spneumo-pangenome	greedytigs	13	na	ones	5038555	6801307	6667207	134100	21684	13079	6801307	1772900	1752348	53260	1805608	1794872	spneumo-pangenome.S_greedytigs.k_13.d_na.M_ones
spneumo-pangenome	greedytigs	13	na	runs	5038555	6801307	6654197	147110	13078	13079	6801307	1772900	1752348	43668	1796016	1788368	spneumo-pangenome.S_greedytigs.k_13.d_na.M_runs
spneumo-pangenome	greedytigs	13	na	zeros	5038555	6801307	5038555	1762752	647019	13079	6801307	1772900	1752348	618832	2371180	2397040	spneumo-pangenome.S_greedytigs.k_13.d_na.M_zeros
spneumo-pangenome	eulertigs	14	na	default	6089164	10737262	6089164	4648098	357546	357546	10737262	3044916	2751064	371580	3122644	3329512	spneumo-pangenome.S_eulertigs.k_14.d_na.M_default
spneumo-pangenome	eulertigs	14	na	ones	6089164	10737262	7031037	3706225	640060	357546	10737262	3044916	2751064	755208	3506272	3580952	spneumo-pangenome.S_eulertigs.k_14.d_na.M_ones
spneumo-pangenome	eulertigs	14	na	runs	6089164	10737262	6547586	4189676	353301	357546	10737262	3044916	2751064	494444	3245508	3327096	spneumo-pangenome.S_eulertigs.k_14.d_na.M_runs
spneumo-pangenome	eulertigs	14	na	zeros	6089164	10737262	6089164	4648098	736507	357546	10737262	3044916	2751064	816364	3567428	3664384	spneumo-pangenome.S_eulertigs.k_14.d_na.M_zeros
spneumo-pangenome	greedytigs	14	na	default	6089164	8090537	7615465	475072	36544	36544	8090537	2070992	2021796	94276	2116072	2126416	spneumo-pangenome.S_greedytigs.k_14.d_na.M_default
spneumo-pangenome	greedytigs	14	na	ones	6089164	8090537	7664871	425666	51434	36544	8090537	2070992	2021796	121956	2143752	2138936	spneumo-pangenome.S_greedytigs.k_14.d_na.M_ones
spneumo-pangenome	greedytigs	14	na	runs	6089164	8090537	7643380	447157	36541	36544	8090537	2070992	2021796	102064	2123860	2126484	spneumo-pangenome.S_greedytigs.k_14.d_na.M_runs
spneumo-pangenome	greedytigs	14	na	zeros	6089164	8090537	6089164	2001373	533038	36544	8090537	2070992	2021796	623656	2645452	2716548	spneumo-pangenome.S_greedytigs.k_14.d_na.M_zeros
spneumo-pangenome	eulertigs	15	na	default	6634628	10112774	6634628	3478146	248439	248439	10112774	2748860	2531744	308828	2840572	3019940	spneumo-pangenome.S_eulertigs.k_15.d_na.M_default
spneumo-pangenome	eulertigs	15	na	ones	6634628	10112774	7014715	3098059	340057	248439	10112774	2748860	2531744	493304	3025048	3125244	spneumo-pangenome.S_eulertigs.k_15.d_na.M_ones
spneumo-pangenome	eulertigs	15	na	runs	6634628	10112774	6874150	3238624	247460	248439	10112774	2748860	2531744	377860	2909604	3020672	spneumo-pangenome.S_eulertigs.k_15.d_na.M_runs
spneumo-pangenome	eulertigs	15	na	zeros	6634628	10112774	6634628	3478146	424534	248439	10112774	2748860	2531744	568016	3099760	3217548	spneumo-pangenome.S_eulertigs.k_15.d_na.M_zeros
spneumo-pangenome	greedytigs	15	na	default	6634628	8594150	7708930	885220	63230	63230	8594150	2145472	2070524	138628	2209152	2258168	spneumo-pangenome.S_greedytigs.k_15.d_na.M_default
spneumo-pangenome	greedytigs	15	na	ones	6634628	8594150	7775557	818593	76669	63230	8594150	2145472	2070524	174064	2244588	2275380	spneumo-pangenome.S_greedytigs.k_15.d_na.M_ones
spneumo-pangenome	greedytigs	15	na	runs	6634628	8594150	7756587	837563	63224	63230	8594150	2145472	2070524	153340	2223864	2257736	spneumo-pangenome.S_greedytigs.k_15.d_na.M_runs
spneumo-pangenome	greedytigs	15	na	zeros	6634628	8594150	6634628	1959522	341884	63230	8594150	2145472	2070524	505036	2575560	2686316	spneumo-pangenome.S_greedytigs.k_15.d_na.M_zeros
spneumo-pangenome	eulertigs	16	na	default	6945327	9972762	6945327	3027435	201829	201829	9972762	2617672	2432020	266512	2698532	2905336	spneumo-pangenome.S_eulertigs.k_16.d_na.M_default
spneumo-pangenome	eulertigs	16	na	ones	6945327	9972762	7146174	2826588	226952	201829	9972762	2617672	2432020	360588	2792608	2942128	spneumo-pangenome.S_eulertigs.k_16.d_na.M_ones
spneumo-pangenome	eulertigs	16	na	runs	6945327	9972762	7109857	2862905	201508	201829	9972762	2617672	2432020	319324	2751344	2907092	spneumo-pangenome.S_eulertigs.k_16.d_na.M_runs
spneumo-pangenome	eulertigs	16	na	zeros	6945327	9972762	6945327	3027435	317098	201829	9972762	2617672	2432020	462672	2894692	3054332	spneumo-pangenome.S_eulertigs.k_16.d_na.M_zeros
spneumo-pangenome	greedytigs	16	na	default	6945327	8906590	7757500	1149090	76606	76606	8906590	2145872	2059640	153112	2212752	2308900	spneumo-pangenome.S_greedytigs.k_16.d_na.M_default
spneumo-pangenome	greedytigs	16	na	ones	6945327	8906590	7823999	1082591	83549	76606	8906590	2145872	2059640	184536	2244176	2318104	spneumo-pangenome.S_greedytigs.k_16.d_na.M_ones
spneumo-pangenome	greedytigs	16	na	runs	6945327	8906590	7814452	1092138	76604	76606	8906590	2145872	2059640	171828	2231468	2307028	spneumo-pangenome.S_greedytigs.k_16.d_na.M_runs
spneumo-pangenome	greedytigs	16	na	zeros	6945327	8906590	6945327	1961263	256419	76606	8906590	2145872	2059640	424516	2484156	2647016	spneumo-pangenome.S_greedytigs.k_16.d_na.M_zeros
spneumo-pangenome	matchtigs	16	na	default	6945327	8745382	7515247	1230135	82009	82009	8745382	2141432	2050128	156472	2206600	2307796	spneumo-pangenome.S_matchtigs.k_16.d_na.M_default
spneumo-pangenome	matchtigs	16	na	ones	6945327	8745382	7585719	1159663	89554	82009	8745382	2141432	2050128	190432	2240560	2318140	spneumo-pangenome.S_matchtigs.k_16.d_na.M_ones
spneumo-pangenome	matchtigs	16	na	runs	6945327	8745382	7575238	1170144	82009	82009	8745382	2141432	2050128	176476	2226604	2306740	spneumo-pangenome.S_matchtigs.k_16.d_na.M_runs
spneumo-pangenome	matchtigs	16	na	zeros	6945327	8745382	6945327	1800055	253877	82009	8745382	2141432	2050128	408964	2459092	2598376	spneumo-pangenome.S_matchtigs.k_16.d_na.M_zeros
spneumo-pangenome	eulertigs	17	na	default	7170727	10067399	7170727	2896672	181042	181042	10067399	2551012	2388432	239604	2628036	2872500	spneumo-pangenome.S_eulertigs.k_17.d_na.M_default
spneumo-pangenome	eulertigs	17	na	ones	7170727	10067399	7321101	2746298	187955	181042	10067399	2551012	2388432	302848	2691280	2886840	spneumo-pangenome.S_eulertigs.k_17.d_na.M_ones
spneumo-pangenome	eulertigs	17	na	runs	7170727	10067399	7311209	2756190	180894	181042	10067399	2551012	2388432	288756	2677188	2876140	spneumo-pangenome.S_eulertigs.k_17.d_na.M_runs
spneumo-pangenome	eulertigs	17	na	zeros	7170727	10067399	7170727	2896672	252137	181042	10067399	2551012	2388432	377972	2766404	2973128	spneumo-pangenome.S_eulertigs.k_17.d_na.M_zeros
spneumo-pangenome	greedytigs	17	na	default	7170727	9145624	7881928	1263696	78981	78981	9145624	2134344	2047044	152108	2199152	2325400	spneumo-pangenome.S_greedytigs.k_17.d_na.M_default
spneumo-pangenome	greedytigs	17	na	ones	7170727	9145624	7943401	1202223	81643	78981	9145624	2134344	2047044	177844	2224888	2328280	spneumo-pangenome.S_greedytigs.k_17.d_na.M_ones
spneumo-pangenome	greedytigs	17	na	runs	7170727	9145624	7939715	1205909	78980	78981	9145624	2134344	2047044	172192	2219236	2324028	spneumo-pangenome.S_greedytigs.k_17.d_na.M_runs
spneumo-pangenome	greedytigs	17	na	zeros	7170727	9145624	7170727	1974897	221764	78981	9145624	2134344	2047044	380780	2427824	2625532	spneumo-pangenome.S_greedytigs.k_17.d_na.M_zeros
spneumo-pangenome	matchtigs	17	na	default	7170727	9035375	7706847	1328528	83033	83033	9035375	2139948	2048596	154952	2203548	2333080	spneumo-pangenome.S_matchtigs.k_17.d_na.M_default
spneumo-pangenome	matchtigs	17	na	ones	7170727	9035375	7771653	1263722	85825	83033	9035375	2139948	2048596	181992	2230588	2336864	spneumo-pangenome.S_matchtigs.k_17.d_na.M_ones
spneumo-pangenome	matchtigs	17	na	runs	7170727	9035375	7767804	1267571	83033	83033	9035375	2139948	2048596	176044	2224640	2331964	spneumo-pangenome.S_matchtigs.k_17.d_na.M_runs
spneumo-pangenome	matchtigs	17	na	zeros	7170727	9035375	7170727	1864648	222071	83033	9035375	2139948	2048596	373556	2422152	2598344	spneumo-pangenome.S_matchtigs.k_17.d_na.M_zeros
spneumo-pangenome	eulertigs	18	na	default	7367184	10168257	7367184	2801073	164769	164769	10168257	2522948	2369100	219620	2588720	2846696	spneumo-pangenome.S_eulertigs.k_18.d_na.M_default
spneumo-pangenome	eulertigs	18	na	ones	7367184	10168257	7494491	2673766	166932	164769	10168257	2522948	2369100	270860	2639960	2854524	spneumo-pangenome.S_eulertigs.k_18.d_na.M_ones
spneumo-pangenome	eulertigs	18	na	runs	7367184	10168257	7491356	2676901	164697	164769	10168257	2522948	2369100	265948	2635048	2851164	spneumo-pangenome.S_eulertigs.k_18.d_na.M_runs
spneumo-pangenome	eulertigs	18	na	zeros	7367184	10168257	7367184	2801073	233295	164769	10168257	2522948	2369100	357624	2726724	2949624	spneumo-pangenome.S_eulertigs.k_18.d_na.M_zeros
spneumo-pangenome	greedytigs	18	na	default	7367184	9385306	8038974	1346332	79196	79196	9385306	2141952	2055664	150744	2206408	2353556	spneumo-pangenome.S_greedytigs.k_18.d_na.M_default
spneumo-pangenome	greedytigs	18	na	ones	7367184	9385306	8098666	1286640	80184	79196	9385306	2141952	2055664	174028	2229692	2355680	spneumo-pangenome.S_greedytigs.k_18.d_na.M_ones
spneumo-pangenome	greedytigs	18	na	runs	7367184	9385306	8097300	1288006	79195	79196	9385306	2141952	2055664	171596	2227260	2352844	spneumo-pangenome.S_greedytigs.k_18.d_na.M_runs
spneumo-pangenome	greedytigs	18	na	zeros	7367184	9385306	7367184	2018122	202214	79196	9385306	2141952	2055664	359468	2415132	2632744	spneumo-pangenome.S_greedytigs.k_18.d_na.M_zeros
spneumo-pangenome	matchtigs	18	na	default	7367184	9293961	7891495	1402466	82498	82498	9293961	2118340	2036720	153680	2190400	2345044	spneumo-pangenome.S_matchtigs.k_18.d_na.M_default
spneumo-pangenome	matchtigs	18	na	ones	7367184	9293961	7953003	1340958	83450	82498	9293961	2118340	2036720	177344	2214064	2347588	spneumo-pangenome.S_matchtigs.k_18.d_na.M_ones
spneumo-pangenome	matchtigs	18	na	runs	7367184	9293961	7951744	1342217	82498	82498	9293961	2118340	2036720	174984	2211704	2346140	spneumo-pangenome.S_matchtigs.k_18.d_na.M_runs
spneumo-pangenome	matchtigs	18	na	zeros	7367184	9293961	7367184	1926777	190012	82498	9293961	2118340	2036720	328328	2365048	2579520	spneumo-pangenome.S_matchtigs.k_18.d_na.M_zeros
spneumo-pangenome	eulertigs	19	na	default	7551412	10579300	7551412	3027888	168216	168216	10579300	2589324	2432160	220972	2653132	2933468	spneumo-pangenome.S_eulertigs.k_19.d_na.M_default
spneumo-pangenome	eulertigs	19	na	ones	7551412	10579300	7678601	2900699	169047	168216	10579300	2589324	2432160	270512	2702672	2942108	spneumo-pangenome.S_eulertigs.k_19.d_na.M_ones
spneumo-pangenome	eulertigs	19	na	runs	7551412	10579300	7677254	2902046	168126	168216	10579300	2589324	2432160	268432	2700592	2940636	spneumo-pangenome.S_eulertigs.k_19.d_na.M_runs
spneumo-pangenome	eulertigs	19	na	zeros	7551412	10579300	7551412	3027888	238673	168216	10579300	2589324	2432160	364352	2796512	3044352	spneumo-pangenome.S_eulertigs.k_19.d_na.M_zeros
spneumo-pangenome	greedytigs	19	na	default	7551412	9701328	8291316	1410012	78334	78334	9701328	2163324	2078404	150684	2229088	2389652	spneumo-pangenome.S_greedytigs.k_19.d_na.M_default
spneumo-pangenome	greedytigs	19	na	ones	7551412	9701328	8349015	1352313	78697	78334	9701328	2163324	2078404	172212	2250616	2390428	spneumo-pangenome.S_greedytigs.k_19.d_na.M_ones
spneumo-pangenome	greedytigs	19	na	runs	7551412	9701328	8348498	1352830	78334	78334	9701328	2163324	2078404	171252	2249656	2389960	spneumo-pangenome.S_greedytigs.k_19.d_na.M_runs
spneumo-pangenome	greedytigs	19	na	zeros	7551412	9701328	7551412	2149916	202774	78334	9701328	2163324	2078404	362188	2440592	2687984	spneumo-pangenome.S_greedytigs.k_19.d_na.M_zeros
spneumo-pangenome	matchtigs	19	na	default	7551412	9596167	8123389	1472778	81821	81821	9596167	2125604	2050320	153232	2203552	2370060	spneumo-pangenome.S_matchtigs.k_19.d_na.M_default
spneumo-pangenome	matchtigs	19	na	ones	7551412	9596167	8183614	1412553	82182	81821	9596167	2125604	2050320	175704	2226024	2370428	spneumo-pangenome.S_matchtigs.k_19.d_na.M_ones
spneumo-pangenome	matchtigs	19	na	runs	7551412	9596167	8183122	1413045	81821	81821	9596167	2125604	2050320	174680	2225000	2369184	spneumo-pangenome.S_matchtigs.k_19.d_na.M_runs
spneumo-pangenome	matchtigs	19	na	zeros	7551412	9596167	7551412	2044755	186574	81821	9596167	2125604	2050320	313988	2364308	2607260	spneumo-pangenome.S_matchtigs.k_19.d_na.M_zeros
spneumo-pangenome	eulertigs	20	na	default	7731727	10908489	7731727	3176762	167198	167198	10908489	2630312	2474232	220764	2694996	2991576	spneumo-pangenome.S_eulertigs.k_20.d_na.M_default
spneumo-pangenome	eulertigs	20	na	ones	7731727	10908489	7858013	3050476	167625	167198	10908489	2630312	2474232	270280	2744512	3001308	spneumo-pangenome.S_eulertigs.k_20.d_na.M_ones
spneumo-pangenome	eulertigs	20	na	runs	7731727	10908489	7857153	3051336	167093	167198	10908489	2630312	2474232	269204	2743436	3000384	spneumo-pangenome.S_eulertigs.k_20.d_na.M_runs
spneumo-pangenome	eulertigs	20	na	zeros	7731727	10908489	7731727	3176762	240019	167198	10908489	2630312	2474232	372104	2846336	3108816	spneumo-pangenome.S_eulertigs.k_20.d_na.M_zeros
spneumo-pangenome	greedytigs	20	na	default	7731727	9960259	8513181	1447078	76162	76162	9960259	2143136	2066888	149464	2216352	2392248	spneumo-pangenome.S_greedytigs.k_20.d_na.M_default
spneumo-pangenome	greedytigs	20	na	ones	7731727	9960259	8568965	1391294	76309	76162	9960259	2143136	2066888	170184	2237072	2392444	spneumo-pangenome.S_greedytigs.k_20.d_na.M_ones
spneumo-pangenome	greedytigs	20	na	runs	7731727	9960259	8568735	1391524	76162	76162	9960259	2143136	2066888	169784	2236672	2392540	spneumo-pangenome.S_greedytigs.k_20.d_na.M_runs
spneumo-pangenome	greedytigs	20	na	zeros	7731727	9960259	7731727	2228532	189321	76162	9960259	2143136	2066888	335880	2402768	2689116	spneumo-pangenome.S_greedytigs.k_20.d_na.M_zeros
spneumo-pangenome	matchtigs	20	na	default	7731727	9842741	8324451	1518290	79910	79910	9842741	2143892	2068168	152356	2220524	2399248	spneumo-pangenome.S_matchtigs.k_20.d_na.M_default
spneumo-pangenome	matchtigs	20	na	ones	7731727	9842741	8382792	1459949	80097	79910	9842741	2143892	2068168	173712	2241880	2397568	spneumo-pangenome.S_matchtigs.k_20.d_na.M_ones
spneumo-pangenome	matchtigs	20	na	runs	7731727	9842741	8382530	1460211	79910	79910	9842741	2143892	2068168	173204	2241372	2397180	spneumo-pangenome.S_matchtigs.k_20.d_na.M_runs
spneumo-pangenome	matchtigs	20	na	zeros	7731727	9842741	7731727	2111014	185823	79910	9842741	2143892	2068168	313056	2381224	2636472	spneumo-pangenome.S_matchtigs.k_20.d_na.M_zeros
spneumo-pangenome	eulertigs	21	na	default	7910060	11083480	7910060	3173420	158671	158671	11083480	2614336	2465588	217092	2682680	2987684	spneumo-pangenome.S_eulertigs.k_21.d_na.M_default
spneumo-pangenome	eulertigs	21	na	ones	7910060	11083480	8029167	3054313	158925	158671	11083480	2614336	2465588	264424	2730012	2997200	spneumo-pangenome.S_eulertigs.k_21.d_na.M_ones
spneumo-pangenome	eulertigs	21	na	runs	7910060	11083480	8028715	3054765	158631	158671	11083480	2614336	2465588	263728	2729316	2996584	spneumo-pangenome.S_eulertigs.k_21.d_na.M_runs
spneumo-pangenome	eulertigs	21	na	zeros	7910060	11083480	7910060	3173420	226553	158671	11083480	2614336	2465588	360112	2825700	3099340	spneumo-pangenome.S_eulertigs.k_21.d_na.M_zeros
spneumo-pangenome	greedytigs	21	na	default	7910060	10190149	8685329	1504820	75241	75241	10190149	2191320	2108996	149612	2258608	2435348	spneumo-pangenome.S_greedytigs.k_21.d_na.M_default
spneumo-pangenome	greedytigs	21	na	ones	7910060	10190149	8740175	1449974	75343	75241	10190149	2191320	2108996	169952	2278948	2436264	spneumo-pangenome.S_greedytigs.k_21.d_na.M_ones
spneumo-pangenome	greedytigs	21	na	runs	7910060	10190149	8740032	1450117	75241	75241	10190149	2191320	2108996	169624	2278620	2436048	spneumo-pangenome.S_greedytigs.k_21.d_na.M_runs
spneumo-pangenome	greedytigs	21	na	zeros	7910060	10190149	7910060	2280089	192329	75241	10190149	2191320	2108996	357276	2466272	2734784	spneumo-pangenome.S_greedytigs.k_21.d_na.M_zeros
spneumo-pangenome	matchtigs	21	na	default	7910060	10080039	8506899	1573140	78657	78657	10080039	2201792	2115744	152408	2268152	2447700	spneumo-pangenome.S_matchtigs.k_21.d_na.M_default
spneumo-pangenome	matchtigs	21	na	ones	7910060	10080039	8564297	1515742	78765	78657	10080039	2201792	2115744	173464	2289208	2449752	spneumo-pangenome.S_matchtigs.k_21.d_na.M_ones
spneumo-pangenome	matchtigs	21	na	runs	7910060	10080039	8564144	1515895	78657	78657	10080039	2201792	2115744	173152	2288896	2449544	spneumo-pangenome.S_matchtigs.k_21.d_na.M_runs
spneumo-pangenome	matchtigs	21	na	zeros	7910060	10080039	7910060	2169979	194008	78657	10080039	2201792	2115744	354432	2470176	2715024	spneumo-pangenome.S_matchtigs.k_21.d_na.M_zeros
spneumo-pangenome	eulertigs	22	na	default	8085776	11531519	8085776	3445743	164083	164083	11531519	2688384	2534900	224448	2759348	3085804	spneumo-pangenome.S_eulertigs.k_22.d_na.M_default
spneumo-pangenome	eulertigs	22	na	ones	8085776	11531519	8207343	3324176	164324	164083	11531519	2688384	2534900	274004	2808904	3094548	spneumo-pangenome.S_eulertigs.k_22.d_na.M_ones
spneumo-pangenome	eulertigs	22	na	runs	8085776	11531519	8206817	3324702	163995	164083	11531519	2688384	2534900	273408	2808308	3093968	spneumo-pangenome.S_eulertigs.k_22.d_na.M_runs
spneumo-pangenome	eulertigs	22	na	zeros	8085776	11531519	8085776	3445743	235206	164083	11531519	2688384	2534900	375188	2910088	3202412	spneumo-pangenome.S_eulertigs.k_22.d_na.M_zeros
spneumo-pangenome	greedytigs	22	na	default	8085776	10499456	8945393	1554063	74003	74003	10499456	2173264	2100684	150184	2250868	2449464	spneumo-pangenome.S_greedytigs.k_22.d_na.M_default
spneumo-pangenome	greedytigs	22	na	ones	8085776	10499456	8999221	1500235	74073	74003	10499456	2173264	2100684	170540	2271224	2449056	spneumo-pangenome.S_greedytigs.k_22.d_na.M_ones
spneumo-pangenome	greedytigs	22	na	runs	8085776	10499456	8999135	1500321	74003	74003	10499456	2173264	2100684	170352	2271036	2448780	spneumo-pangenome.S_greedytigs.k_22.d_na.M_runs
spneumo-pangenome	greedytigs	22	na	zeros	8085776	10499456	8085776	2413680	184392	74003	10499456	2173264	2100684	337132	2437816	2755688	spneumo-pangenome.S_greedytigs.k_22.d_na.M_zeros
spneumo-pangenome	eulertigs	23	na	default	8260593	11861993	8260593	3601400	163700	163700	11861993	2706384	2557940	227796	2785736	3130768	spneumo-pangenome.S_eulertigs.k_23.d_na.M_default
spneumo-pangenome	eulertigs	23	na	ones	8260593	11861993	8382777	3479216	163885	163700	11861993	2706384	2557940	280616	2838556	3138864	spneumo-pangenome.S_eulertigs.k_23.d_na.M_ones
spneumo-pangenome	eulertigs	23	na	runs	8260593	11861993	8382278	3479715	163608	163700	11861993	2706384	2557940	280164	2838104	3139488	spneumo-pangenome.S_eulertigs.k_23.d_na.M_runs
spneumo-pangenome	eulertigs	23	na	zeros	8260593	11861993	8260593	3601400	229824	163700	11861993	2706384	2557940	372000	2929940	3240936	spneumo-pangenome.S_eulertigs.k_23.d_na.M_zeros
spneumo-pangenome	greedytigs	23	na	default	8260593	10750018	9165094	1584924	72042	72042	10750018	2227948	2148580	149384	2297964	2488176	spneumo-pangenome.S_greedytigs.k_23.d_na.M_default
spneumo-pangenome	greedytigs	23	na	ones	8260593	10750018	9216991	1533027	72094	72042	10750018	2227948	2148580	170960	2319540	2488800	spneumo-pangenome.S_greedytigs.k_23.d_na.M_ones
spneumo-pangenome	greedytigs	23	na	runs	8260593	10750018	9216924	1533094	72042	72042	10750018	2227948	2148580	170828	2319408	2488576	spneumo-pangenome.S_greedytigs.k_23.d_na.M_runs
spneumo-pangenome	greedytigs	23	na	zeros	8260593	10750018	8260593	2489425	194229	72042	10750018	2227948	2148580	368960	2517540	2821356	spneumo-pangenome.S_greedytigs.k_23.d_na.M_zeros
spneumo-pangenome	eulertigs	24	na	default	8434681	12025878	8434681	3591197	156139	156139	12025878	2624484	2493132	224152	2717284	3118580	spneumo-pangenome.S_eulertigs.k_24.d_na.M_default
spneumo-pangenome	eulertigs	24	na	ones	8434681	12025878	8551095	3474783	156305	156139	12025878	2624484	2493132	275284	2768416	3127756	spneumo-pangenome.S_eulertigs.k_24.d_na.M_ones
spneumo-pangenome	eulertigs	24	na	runs	8434681	12025878	8550767	3475111	156106	156139	12025878	2624484	2493132	274884	2768016	3127468	spneumo-pangenome.S_eulertigs.k_24.d_na.M_runs
spneumo-pangenome	eulertigs	24	na	zeros	8434681	12025878	8434681	3591197	198405	156139	12025878	2624484	2493132	326224	2819356	3198144	spneumo-pangenome.S_eulertigs.k_24.d_na.M_zeros
spneumo-pangenome	greedytigs	24	na	default	8434681	10976336	9332365	1643971	71477	71477	10976336	2213308	2140192	150288	2290480	2501368	spneumo-pangenome.S_greedytigs.k_24.d_na.M_default
spneumo-pangenome	greedytigs	24	na	ones	8434681	10976336	9384292	1592044	71531	71477	10976336	2213308	2140192	172088	2312280	2501356	spneumo-pangenome.S_greedytigs.k_24.d_na.M_ones
spneumo-pangenome	greedytigs	24	na	runs	8434681	10976336	9384215	1592121	71477	71477	10976336	2213308	2140192	171920	2312112	2501184	spneumo-pangenome.S_greedytigs.k_24.d_na.M_runs
spneumo-pangenome	greedytigs	24	na	zeros	8434681	10976336	8434681	2541655	180830	71477	10976336	2213308	2140192	348552	2488744	2821760	spneumo-pangenome.S_greedytigs.k_24.d_na.M_zeros
spneumo-pangenome	eulertigs	25	na	default	8607254	12490454	8607254	3883200	161800	161800	12490454	2763932	2615868	232912	2848780	3224476	spneumo-pangenome.S_eulertigs.k_25.d_na.M_default
spneumo-pangenome	eulertigs	25	na	ones	8607254	12490454	8727212	3763242	161985	161800	12490454	2763932	2615868	285856	2901724	3232944	spneumo-pangenome.S_eulertigs.k_25.d_na.M_ones
spneumo-pangenome	eulertigs	25	na	runs	8607254	12490454	8726782	3763672	161729	161800	12490454	2763932	2615868	285496	2901364	3231380	spneumo-pangenome.S_eulertigs.k_25.d_na.M_runs
spneumo-pangenome	eulertigs	25	na	zeros	8607254	12490454	8607254	3883200	229912	161800	12490454	2763932	2615868	382660	2998528	3339324	spneumo-pangenome.S_eulertigs.k_25.d_na.M_zeros
spneumo-pangenome	greedytigs	25	na	default	8607254	11286309	9600837	1685472	70228	70228	11286309	2206900	2141312	150600	2291912	2511132	spneumo-pangenome.S_greedytigs.k_25.d_na.M_default
spneumo-pangenome	greedytigs	25	na	ones	8607254	11286309	9652061	1634248	70288	70228	11286309	2206900	2141312	172228	2313540	2511292	spneumo-pangenome.S_greedytigs.k_25.d_na.M_ones
spneumo-pangenome	greedytigs	25	na	runs	8607254	11286309	9651965	1634344	70228	70228	11286309	2206900	2141312	172036	2313348	2511432	spneumo-pangenome.S_greedytigs.k_25.d_na.M_runs
spneumo-pangenome	greedytigs	25	na	zeros	8607254	11286309	8607254	2679055	178095	70228	11286309	2206900	2141312	334908	2476220	2836852	spneumo-pangenome.S_greedytigs.k_25.d_na.M_zeros
spneumo-pangenome	eulertigs	26	na	default	8779295	12825820	8779295	4046525	161861	161861	12825820	2788808	2640612	236360	2876972	3273436	spneumo-pangenome.S_eulertigs.k_26.d_na.M_default
spneumo-pangenome	eulertigs	26	na	ones	8779295	12825820	8900422	3925398	162014	161861	12825820	2788808	2640612	290220	2930832	3282492	spneumo-pangenome.S_eulertigs.k_26.d_na.M_ones
spneumo-pangenome	eulertigs	26	na	runs	8779295	12825820	8899977	3925843	161767	161861	12825820	2788808	2640612	290008	2930620	3282276	spneumo-pangenome.S_eulertigs.k_26.d_na.M_runs
spneumo-pangenome	eulertigs	26	na	zeros	8779295	12825820	8779295	4046525	228366	161861	12825820	2788808	2640612	384224	3024836	3389260	spneumo-pangenome.S_eulertigs.k_26.d_na.M_zeros
spneumo-pangenome	greedytigs	26	na	default	8779295	11540493	9823393	1717100	68684	68684	11540493	2274408	2199948	150308	2350256	2565388	spneumo-pangenome.S_greedytigs.k_26.d_na.M_default
spneumo-pangenome	greedytigs	26	na	ones	8779295	11540493	9873214	1667279	68738	68684	11540493	2274408	2199948	171856	2371804	2564860	spneumo-pangenome.S_greedytigs.k_26.d_na.M_ones
spneumo-pangenome	greedytigs	26	na	runs	8779295	11540493	9873136	1667357	68683	68684	11540493	2274408	2199948	171692	2371640	2565196	spneumo-pangenome.S_greedytigs.k_26.d_na.M_runs
spneumo-pangenome	greedytigs	26	na	zeros	8779295	11540493	8779295	2761198	191411	68684	11540493	2274408	2199948	379740	2579688	2928368	spneumo-pangenome.S_greedytigs.k_26.d_na.M_zeros
spneumo-pangenome	eulertigs	27	na	default	8950801	12977499	8950801	4026698	154873	154873	12977499	2655988	2536224	232404	2768628	3235920	spneumo-pangenome.S_eulertigs.k_27.d_na.M_default
spneumo-pangenome	eulertigs	27	na	ones	8950801	12977499	9065144	3912355	155042	154873	12977499	2655988	2536224	284604	2820828	3246096	spneumo-pangenome.S_eulertigs.k_27.d_na.M_ones
spneumo-pangenome	eulertigs	27	na	runs	8950801	12977499	9064829	3912670	154834	154873	12977499	2655988	2536224	284168	2820392	3246612	spneumo-pangenome.S_eulertigs.k_27.d_na.M_runs
spneumo-pangenome	eulertigs	27	na	zeros	8950801	12977499	8950801	4026698	185903	154873	12977499	2655988	2536224	312808	2849032	3298568	spneumo-pangenome.S_eulertigs.k_27.d_na.M_zeros
spneumo-pangenome	greedytigs	27	na	default	8950801	11757359	9982417	1774942	68267	68267	11757359	2287216	2212716	150360	2363076	2586852	spneumo-pangenome.S_greedytigs.k_27.d_na.M_default
spneumo-pangenome	greedytigs	27	na	ones	8950801	11757359	10031478	1725881	68307	68267	11757359	2287216	2212716	171940	2384656	2587400	spneumo-pangenome.S_greedytigs.k_27.d_na.M_ones
spneumo-pangenome	greedytigs	27	na	runs	8950801	11757359	10031416	1725943	68266	68267	11757359	2287216	2212716	171812	2384528	2587508	spneumo-pangenome.S_greedytigs.k_27.d_na.M_runs
spneumo-pangenome	greedytigs	27	na	zeros	8950801	11757359	8950801	2806558	185137	68267	11757359	2287216	2212716	375780	2588496	2943128	spneumo-pangenome.S_greedytigs.k_27.d_na.M_zeros
spneumo-pangenome	eulertigs	28	na	default	9120914	13449446	9120914	4328532	160316	160316	13449446	2818252	2673972	241416	2915388	3360192	spneumo-pangenome.S_eulertigs.k_28.d_na.M_default
spneumo-pangenome	eulertigs	28	na	ones	9120914	13449446	9238784	4210662	160467	160316	13449446	2818252	2673972	295396	2969368	3368876	spneumo-pangenome.S_eulertigs.k_28.d_na.M_ones
spneumo-pangenome	eulertigs	28	na	runs	9120914	13449446	9238403	4211043	160252	160316	13449446	2818252	2673972	295076	2969048	3368376	spneumo-pangenome.S_eulertigs.k_28.d_na.M_runs
spneumo-pangenome	eulertigs	28	na	zeros	9120914	13449446	9120914	4328532	222215	160316	13449446	2818252	2673972	382432	3056404	3472592	spneumo-pangenome.S_eulertigs.k_28.d_na.M_zeros
spneumo-pangenome	greedytigs	28	na	default	9120914	12059439	10238262	1821177	67451	67451	12059439	2250596	2187656	151340	2338996	2580488	spneumo-pangenome.S_greedytigs.k_28.d_na.M_default
spneumo-pangenome	greedytigs	28	na	ones	9120914	12059439	10287071	1772368	67491	67451	12059439	2250596	2187656	172592	2360248	2580968	spneumo-pangenome.S_greedytigs.k_28.d_na.M_ones
spneumo-pangenome	greedytigs	28	na	runs	9120914	12059439	10287018	1772421	67451	67451	12059439	2250596	2187656	172484	2360140	2581140	spneumo-pangenome.S_greedytigs.k_28.d_na.M_runs
spneumo-pangenome	greedytigs	28	na	zeros	9120914	12059439	9120914	2938525	175927	67451	12059439	2250596	2187656	344116	2531772	2934272	spneumo-pangenome.S_greedytigs.k_28.d_na.M_zeros
spneumo-pangenome	eulertigs	29	na	default	9290605	13774693	9290605	4484088	160146	160146	13774693	2841516	2697712	243796	2941508	3403204	spneumo-pangenome.S_eulertigs.k_29.d_na.M_default
spneumo-pangenome	eulertigs	29	na	ones	9290605	13774693	9409807	4364886	160267	160146	13774693	2841516	2697712	298968	2996680	3411472	spneumo-pangenome.S_eulertigs.k_29.d_na.M_ones
spneumo-pangenome	eulertigs	29	na	runs	9290605	13774693	9409401	4365292	160059	160146	13774693	2841516	2697712	298776	2996488	3411380	spneumo-pangenome.S_eulertigs.k_29.d_na.M_runs
spneumo-pangenome	eulertigs	29	na	zeros	9290605	13774693	9290605	4484088	221812	160146	13774693	2841516	2697712	387136	3084848	3516864	spneumo-pangenome.S_eulertigs.k_29.d_na.M_zeros
spneumo-pangenome	greedytigs	29	na	default	9290605	12299017	10447573	1851444	66123	66123	12299017	2261008	2197052	150732	2347784	2598732	spneumo-pangenome.S_greedytigs.k_29.d_na.M_default
spneumo-pangenome	greedytigs	29	na	ones	9290605	12299017	10495487	1803530	66159	66123	12299017	2261008	2197052	171576	2368628	2599556	spneumo-pangenome.S_greedytigs.k_29.d_na.M_ones
spneumo-pangenome	greedytigs	29	na	runs	9290605	12299017	10495442	1803575	66123	66123	12299017	2261008	2197052	171468	2368520	2599652	spneumo-pangenome.S_greedytigs.k_29.d_na.M_runs
spneumo-pangenome	greedytigs	29	na	zeros	9290605	12299017	9290605	3008412	176395	66123	12299017	2261008	2197052	352752	2549804	2969388	spneumo-pangenome.S_greedytigs.k_29.d_na.M_zeros
spneumo-pangenome	eulertigs	30	na	default	9459820	13902359	9459820	4442539	153191	153191	13902359	2755700	2627956	239640	2867596	3371276	spneumo-pangenome.S_eulertigs.k_30.d_na.M_default
spneumo-pangenome	eulertigs	30	na	ones	9459820	13902359	9572973	4329386	153324	153191	13902359	2755700	2627956	292988	2920944	3381544	spneumo-pangenome.S_eulertigs.k_30.d_na.M_ones
spneumo-pangenome	eulertigs	30	na	runs	9459820	13902359	9572730	4329629	153164	153191	13902359	2755700	2627956	292700	2920656	3381436	spneumo-pangenome.S_eulertigs.k_30.d_na.M_runs
spneumo-pangenome	eulertigs	30	na	zeros	9459820	13902359	9459820	4442539	194640	153191	13902359	2755700	2627956	343340	2971296	3456560	spneumo-pangenome.S_eulertigs.k_30.d_na.M_zeros
spneumo-pangenome	greedytigs	30	na	default	9459820	12526963	10632973	1893990	65310	65310	12526963	2320964	2249612	151188	2400800	2648984	spneumo-pangenome.S_greedytigs.k_30.d_na.M_default
spneumo-pangenome	greedytigs	30	na	ones	9459820	12526963	10680475	1846488	65363	65310	12526963	2320964	2249612	172208	2421820	2647896	spneumo-pangenome.S_greedytigs.k_30.d_na.M_ones
spneumo-pangenome	greedytigs	30	na	runs	9459820	12526963	10680404	1846559	65310	65310	12526963	2320964	2249612	172068	2421680	2648088	spneumo-pangenome.S_greedytigs.k_30.d_na.M_runs
spneumo-pangenome	greedytigs	30	na	zeros	9459820	12526963	9459820	3067143	182466	65310	12526963	2320964	2249612	383024	2632636	3032864	spneumo-pangenome.S_greedytigs.k_30.d_na.M_zeros
spneumo-pangenome	eulertigs	31	na	default	9627755	14382545	9627755	4754790	158493	158493	14382545	2799912	2674828	248452	2923280	3448680	spneumo-pangenome.S_eulertigs.k_31.d_na.M_default
spneumo-pangenome	eulertigs	31	na	ones	9627755	14382545	9744603	4637942	158625	158493	14382545	2799912	2674828	303904	2978732	3461384	spneumo-pangenome.S_eulertigs.k_31.d_na.M_ones
spneumo-pangenome	eulertigs	31	na	runs	9627755	14382545	9744290	4638255	158435	158493	14382545	2799912	2674828	303588	2978416	3460368	spneumo-pangenome.S_eulertigs.k_31.d_na.M_runs
spneumo-pangenome	eulertigs	31	na	zeros	9627755	14382545	9627755	4754790	197552	158493	14382545	2799912	2674828	345384	3020212	3523912	spneumo-pangenome.S_eulertigs.k_31.d_na.M_zeros
spneumo-pangenome	greedytigs	31	na	default	9627755	12832096	10892236	1939860	64662	64662	12832096	2336044	2264524	151672	2416196	2672176	spneumo-pangenome.S_greedytigs.k_31.d_na.M_default
spneumo-pangenome	greedytigs	31	na	ones	9627755	12832096	10939246	1892850	64704	64662	12832096	2336044	2264524	172496	2437020	2671832	spneumo-pangenome.S_greedytigs.k_31.d_na.M_ones
spneumo-pangenome	greedytigs	31	na	runs	9627755	12832096	10939184	1892912	64662	64662	12832096	2336044	2264524	172384	2436908	2671768	spneumo-pangenome.S_greedytigs.k_31.d_na.M_runs
spneumo-pangenome	greedytigs	31	na	zeros	9627755	12832096	9627755	3204341	185893	64662	12832096	2336044	2264524	392380	2656904	3079788	spneumo-pangenome.S_greedytigs.k_31.d_na.M_zeros
spneumoniae	eulertigs	11	na	default	1004213	1906113	1004213	901900	90190	90190	1906113	576540	512032	74712	586744	638056	spneumoniae.S_eulertigs.k_11.d_na.M_default
spneumoniae	eulertigs	11	na	ones	1004213	1906113	1517315	388798	172099	90190	1906113	576540	512032	162616	674648	674900	spneumoniae.S_eulertigs.k_11.d_na.M_ones
spneumoniae	eulertigs	11	na	runs	1004213	1906113	1308505	597608	81775	90190	1906113	576540	512032	111168	623200	627932	spneumoniae.S_eulertigs.k_11.d_na.M_runs
spneumoniae	eulertigs	11	na	zeros	1004213	1906113	1004213	901900	323041	90190	1906113	576540	512032	241216	753248	749908	spneumoniae.S_eulertigs.k_11.d_na.M_zeros
spneumoniae	greedytigs	11	na	default	1004213	1278881	1273201	5680	568	568	1278881	344384	346484	2544	349028	345428	spneumoniae.S_greedytigs.k_11.d_na.M_default
spneumoniae	greedytigs	11	na	ones	1004213	1278881	1275046	3835	1243	568	1278881	344384	346484	3344	349828	345520	spneumoniae.S_greedytigs.k_11.d_na.M_ones
spneumoniae	greedytigs	11	na	runs	1004213	1278881	1273655	5226	568	568	1278881	344384	346484	2620	349104	345048	spneumoniae.S_greedytigs.k_11.d_na.M_runs
spneumoniae	greedytigs	11	na	zeros	1004213	1278881	1004213	274668	162648	568	1278881	344384	346484	127172	473656	471008	spneumoniae.S_greedytigs.k_11.d_na.M_zeros
spneumoniae	eulertigs	12	na	default	1585876	2992270	1585876	1406394	127854	127854	2992270	884168	789028	113532	902560	968496	spneumoniae.S_eulertigs.k_12.d_na.M_default
spneumoniae	eulertigs	12	na	ones	1585876	2992270	2143736	848534	266609	127854	2992270	884168	789028	263752	1052780	1062868	spneumoniae.S_eulertigs.k_12.d_na.M_ones
spneumoniae	eulertigs	12	na	runs	1585876	2992270	1860570	1131700	123025	127854	2992270	884168	789028	168232	957260	967964	spneumoniae.S_eulertigs.k_12.d_na.M_runs
spneumoniae	eulertigs	12	na	zeros	1585876	2992270	1585876	1406394	304096	127854	2992270	884168	789028	283676	1072704	1093200	spneumoniae.S_eulertigs.k_12.d_na.M_zeros
spneumoniae	greedytigs	12	na	default	1585876	1976482	1965493	10989	999	999	1976482	521880	520620	4260	524880	522468	spneumoniae.S_greedytigs.k_12.d_na.M_default
spneumoniae	greedytigs	12	na	ones	1585876	1976482	1967935	8547	1913	999	1976482	521880	520620	5488	526108	522568	spneumoniae.S_greedytigs.k_12.d_na.M_ones
spneumoniae	greedytigs	12	na	runs	1585876	1976482	1966458	10024	999	999	1976482	521880	520620	4464	525084	523016	spneumoniae.S_greedytigs.k_12.d_na.M_runs
spneumoniae	greedytigs	12	na	zeros	1585876	1976482	1585876	390606	186525	999	1976482	521880	520620	171900	692520	692924	spneumoniae.S_greedytigs.k_12.d_na.M_zeros
spneumoniae	eulertigs	13	na	default	1917960	2955672	1917960	1037712	86476	86476	2955672	841844	767700	99412	867112	914724	spneumoniae.S_eulertigs.k_13.d_na.M_default
spneumoniae	eulertigs	13	na	ones	1917960	2955672	2167984	787688	159939	86476	2955672	841844	767700	196080	963780	976760	spneumoniae.S_eulertigs.k_13.d_na.M_ones
spneumoniae	eulertigs	13	na	runs	1917960	2955672	2041896	913776	85196	86476	2955672	841844	767700	131636	899336	913380	spneumoniae.S_eulertigs.k_13.d_na.M_runs
spneumoniae	eulertigs	13	na	zeros	1917960	2955672	1917960	1037712	174095	86476	2955672	841844	767700	208584	976284	996628	spneumoniae.S_eulertigs.k_13.d_na.M_zeros
spneumoniae	greedytigs	13	na	default	1917960	2160295	2140723	19572	1631	1631	2160295	566648	563812	6380	570192	569084	spneumoniae.S_greedytigs.k_13.d_na.M_default
spneumoniae	greedytigs	13	na	ones	1917960	2160295	2143836	16459	2686	1631	2160295	566648	563812	8100	571912	569832	spneumoniae.S_greedytigs.k_13.d_na.M_ones
spneumoniae	greedytigs	13	na	runs	1917960	2160295	2142239	18056	1631	1631	2160295	566648	563812	6676	570488	569184	spneumoniae.S_greedytigs.k_13.d_na.M_runs
spneumoniae	greedytigs	13	na	zeros	1917960	2160295	1917960	242335	113989	1631	2160295	566648	563812	133644	697456	692224	spneumoniae.S_greedytigs.k_13.d_na.M_zeros
spneumoniae	matchtigs	13	na	default	1917960	2109714	2095290	14424	1202	1202	2109714	554984	552840	4936	557776	556648	spneumoniae.S_matchtigs.k_13.d_na.M_default
spneumoniae	matchtigs	13	na	ones	1917960	2109714	2097763	11951	1991	1202	2109714	554984	552840	6272	559112	556816	spneumoniae.S_matchtigs.k_13.d_na.M_ones
spneumoniae	matchtigs	13	na	runs	1917960	2109714	2096536	13178	1202	1202	2109714	554984	552840	5224	558064	555908	spneumoniae.S_matchtigs.k_13.d_na.M_runs
spneumoniae	matchtigs	13	na	zeros	1917960	2109714	1917960	191754	104333	1202	2109714	554984	552840	120900	673740	666592	spneumoniae.S_matchtigs.k_13.d_na.M_zeros
spneumoniae	eulertigs	14	na	default	2052085	2551493	2052085	499408	38416	38416	2551493	700444	662564	63120	725684	742916	spneumoniae.S_eulertigs.k_14.d_na.M_default
spneumoniae	eulertigs	14	na	ones	2052085	2551493	2123361	428132	56353	38416	2551493	700444	662564	96324	758888	759788	spneumoniae.S_eulertigs.k_14.d_na.M_ones
spneumoniae	eulertigs	14	na	runs	2052085	2551493	2095477	456016	38204	38416	2551493	700444	662564	74816	737380	741668	spneumoniae.S_eulertigs.k_14.d_na.M_runs
spneumoniae	eulertigs	14	na	zeros	2052085	2551493	2052085	499408	63832	38416	2551493	700444	662564	106308	768872	771920	spneumoniae.S_eulertigs.k_14.d_na.M_zeros
spneumoniae	greedytigs	14	na	default	2052085	2145521	2129765	15756	1212	1212	2145521	562140	560240	4932	565172	563968	spneumoniae.S_greedytigs.k_14.d_na.M_default
spneumoniae	greedytigs	14	na	ones	2052085	2145521	2131596	13925	1658	1212	2145521	562140	560240	5940	566180	564544	spneumoniae.S_greedytigs.k_14.d_na.M_ones
spneumoniae	greedytigs	14	na	runs	2052085	2145521	2130911	14610	1206	1212	2145521	562140	560240	5204	565444	564024	spneumoniae.S_greedytigs.k_14.d_na.M_runs
spneumoniae	greedytigs	14	na	zeros	2052085	2145521	2052085	93436	44462	1212	2145521	562140	560240	73268	633508	620304	spneumoniae.S_greedytigs.k_14.d_na.M_zeros
spneumoniae	matchtigs	14	na	default	2052085	2131759	2120124	11635	895	895	2131759	558780	557072	3784	560856	560368	spneumoniae.S_matchtigs.k_14.d_na.M_default
spneumoniae	matchtigs	14	na	ones	2052085	2131759	2121245	10514	1173	895	2131759	558780	557072	4540	561612	560796	spneumoniae.S_matchtigs.k_14.d_na.M_ones
spneumoniae	matchtigs	14	na	runs	2052085	2131759	2120855	10904	895	895	2131759	558780	557072	4012	561084	560212	spneumoniae.S_matchtigs.k_14.d_na.M_runs
spneumoniae	matchtigs	14	na	zeros	2052085	2131759	2052085	79674	42073	895	2131759	558780	557072	69504	626576	613432	spneumoniae.S_matchtigs.k_14.d_na.M_zeros
spneumoniae	eulertigs	15	na	default	2098151	2301585	2098151	203434	14531	14531	2301585	615636	598940	33536	632476	636212	spneumoniae.S_eulertigs.k_15.d_na.M_default
spneumoniae	eulertigs	15	na	ones	2098151	2301585	2117257	184328	17487	14531	2301585	615636	598940	41948	640888	638584	spneumoniae.S_eulertigs.k_15.d_na.M_ones
spneumoniae	eulertigs	15	na	runs	2098151	2301585	2112943	188642	14498	14531	2301585	615636	598940	37340	636280	635836	spneumoniae.S_eulertigs.k_15.d_na.M_runs
spneumoniae	eulertigs	15	na	zeros	2098151	2301585	2098151	203434	21025	14531	2301585	615636	598940	49088	648028	645200	spneumoniae.S_eulertigs.k_15.d_na.M_zeros
spneumoniae	greedytigs	15	na	default	2098151	2137391	2126345	11046	789	789	2137391	558892	557520	3368	560888	560760	spneumoniae.S_greedytigs.k_15.d_na.M_default
spneumoniae	greedytigs	15	na	ones	2098151	2137391	2127154	10237	872	789	2137391	558892	557520	3800	561320	560956	spneumoniae.S_greedytigs.k_15.d_na.M_ones
spneumoniae	greedytigs	15	na	runs	2098151	2137391	2127032	10359	789	789	2137391	558892	557520	3588	561108	560592	spneumoniae.S_greedytigs.k_15.d_na.M_runs
spneumoniae	greedytigs	15	na	zeros	2098151	2137391	2098151	39240	15622	789	2137391	558892	557520	37092	594612	584612	spneumoniae.S_greedytigs.k_15.d_na.M_zeros
spneumoniae	matchtigs	15	na	default	2098151	2134981	2123837	11144	796	796	2134981	558304	557204	3328	560532	560076	spneumoniae.S_matchtigs.k_15.d_na.M_default
spneumoniae	matchtigs	15	na	ones	2098151	2134981	2124592	10389	869	796	2134981	558304	557204	3724	560928	559916	spneumoniae.S_matchtigs.k_15.d_na.M_ones
spneumoniae	matchtigs	15	na	runs	2098151	2134981	2124491	10490	796	796	2134981	558304	557204	3572	560776	559592	spneumoniae.S_matchtigs.k_15.d_na.M_runs
spneumoniae	matchtigs	15	na	zeros	2098151	2134981	2098151	36830	15560	796	2134981	558304	557204	36660	593864	582836	spneumoniae.S_matchtigs.k_15.d_na.M_zeros
spneumoniae	eulertigs	16	na	default	2114070	2203590	2114070	89520	5968	5968	2203590	582824	574476	16736	591212	592824	spneumoniae.S_eulertigs.k_16.d_na.M_default
spneumoniae	eulertigs	16	na	ones	2114070	2203590	2120326	83264	6403	5968	2203590	582824	574476	19196	593672	592616	spneumoniae.S_eulertigs.k_16.d_na.M_ones
spneumoniae	eulertigs	16	na	runs	2114070	2203590	2119684	83906	5964	5968	2203590	582824	574476	18304	592780	592200	spneumoniae.S_eulertigs.k_16.d_na.M_runs
spneumoniae	eulertigs	16	na	zeros	2114070	2203590	2114070	89520	8770	5968	2203590	582824	574476	25060	599536	596592	spneumoniae.S_eulertigs.k_16.d_na.M_zeros
spneumoniae	greedytigs	16	na	default	2114070	2139103	2128543	10560	704	704	2139103	557464	557548	2972	560520	559640	spneumoniae.S_greedytigs.k_16.d_na.M_default
spneumoniae	greedytigs	16	na	ones	2114070	2139103	2129174	9929	736	704	2139103	557464	557548	3232	560780	559828	spneumoniae.S_greedytigs.k_16.d_na.M_ones
spneumoniae	greedytigs	16	na	runs	2114070	2139103	2129128	9975	704	704	2139103	557464	557548	3140	560688	560240	spneumoniae.S_greedytigs.k_16.d_na.M_runs
spneumoniae	greedytigs	16	na	zeros	2114070	2139103	2114070	25033	6457	704	2139103	557464	557548	19216	576764	570632	spneumoniae.S_greedytigs.k_16.d_na.M_zeros
spneumoniae	matchtigs	16	na	default	2114070	2137844	2126369	11475	765	765	2137844	557732	557280	3120	560400	560208	spneumoniae.S_matchtigs.k_16.d_na.M_default
spneumoniae	matchtigs	16	na	ones	2114070	2137844	2127019	10825	788	765	2137844	557732	557280	3384	560664	559800	spneumoniae.S_matchtigs.k_16.d_na.M_ones
spneumoniae	matchtigs	16	na	runs	2114070	2137844	2126985	10859	765	765	2137844	557732	557280	3332	560612	559800	spneumoniae.S_matchtigs.k_16.d_na.M_runs
spneumoniae	matchtigs	16	na	zeros	2114070	2137844	2114070	23774	6370	765	2137844	557732	557280	18884	576164	570120	spneumoniae.S_matchtigs.k_16.d_na.M_zeros
spneumoniae	eulertigs	17	na	default	2120449	2171537	2120449	51088	3193	3193	2171537	570052	565708	9520	575228	574940	spneumoniae.S_eulertigs.k_17.d_na.M_default
spneumoniae	eulertigs	17	na	ones	2120449	2171537	2123312	48225	3258	3193	2171537	570052	565708	10472	576180	575568	spneumoniae.S_eulertigs.k_17.d_na.M_ones
spneumoniae	eulertigs	17	na	runs	2120449	2171537	2123216	48321	3190	3193	2171537	570052	565708	10312	576020	575512	spneumoniae.S_eulertigs.k_17.d_na.M_runs
spneumoniae	eulertigs	17	na	zeros	2120449	2171537	2120449	51088	4046	3193	2171537	570052	565708	12296	578004	576948	spneumoniae.S_eulertigs.k_17.d_na.M_zeros
spneumoniae	greedytigs	17	na	default	2120449	2141246	2130702	10544	659	659	2141246	557768	557460	2768	560228	560464	spneumoniae.S_greedytigs.k_17.d_na.M_default
spneumoniae	greedytigs	17	na	ones	2120449	2141246	2131215	10031	667	659	2141246	557768	557460	2996	560456	559540	spneumoniae.S_greedytigs.k_17.d_na.M_ones
spneumoniae	greedytigs	17	na	runs	2120449	2141246	2131204	10042	659	659	2141246	557768	557460	2972	560432	559448	spneumoniae.S_greedytigs.k_17.d_na.M_runs
spneumoniae	greedytigs	17	na	zeros	2120449	2141246	2120449	20797	3512	659	2141246	557768	557460	11384	568844	565684	spneumoniae.S_greedytigs.k_17.d_na.M_zeros
spneumoniae	matchtigs	17	na	default	2120449	2140106	2128442	11664	729	729	2140106	557896	557224	2896	560120	560216	spneumoniae.S_matchtigs.k_17.d_na.M_default
spneumoniae	matchtigs	17	na	ones	2120449	2140106	2129019	11087	737	729	2140106	557896	557224	3136	560360	559988	spneumoniae.S_matchtigs.k_17.d_na.M_ones
spneumoniae	matchtigs	17	na	runs	2120449	2140106	2129008	11098	729	729	2140106	557896	557224	3108	560332	559940	spneumoniae.S_matchtigs.k_17.d_na.M_runs
spneumoniae	matchtigs	17	na	zeros	2120449	2140106	2120449	19657	3475	729	2140106	557896	557224	11048	568272	565476	spneumoniae.S_matchtigs.k_17.d_na.M_zeros
spneumoniae	eulertigs	18	na	default	2123906	2160405	2123906	36499	2147	2147	2160405	565444	562492	6416	568908	570344	spneumoniae.S_eulertigs.k_18.d_na.M_default
spneumoniae	eulertigs	18	na	ones	2123906	2160405	2125704	34701	2169	2147	2160405	565444	562492	7096	569588	570196	spneumoniae.S_eulertigs.k_18.d_na.M_ones
spneumoniae	eulertigs	18	na	runs	2123906	2160405	2125676	34729	2145	2147	2160405	565444	562492	7048	569540	570248	spneumoniae.S_eulertigs.k_18.d_na.M_runs
spneumoniae	eulertigs	18	na	zeros	2123906	2160405	2123906	36499	3066	2147	2160405	565444	562492	9120	571612	571812	spneumoniae.S_eulertigs.k_18.d_na.M_zeros
spneumoniae	greedytigs	18	na	default	2123906	2143437	2132761	10676	628	628	2143437	558416	556776	2656	559432	559628	spneumoniae.S_greedytigs.k_18.d_na.M_default
spneumoniae	greedytigs	18	na	ones	2123906	2143437	2133250	10187	632	628	2143437	558416	556776	2832	559608	559560	spneumoniae.S_greedytigs.k_18.d_na.M_ones
spneumoniae	greedytigs	18	na	runs	2123906	2143437	2133245	10192	628	628	2143437	558416	556776	2824	559600	559952	spneumoniae.S_greedytigs.k_18.d_na.M_runs
spneumoniae	greedytigs	18	na	zeros	2123906	2143437	2123906	19531	2412	628	2143437	558416	556776	7836	564612	563940	spneumoniae.S_greedytigs.k_18.d_na.M_zeros
spneumoniae	matchtigs	18	na	default	2123906	2142247	2130602	11645	685	685	2142247	558044	557140	2764	559904	560312	spneumoniae.S_matchtigs.k_18.d_na.M_default
spneumoniae	matchtigs	18	na	ones	2123906	2142247	2131189	11058	695	685	2142247	558044	557140	2996	560136	560220	spneumoniae.S_matchtigs.k_18.d_na.M_ones
spneumoniae	matchtigs	18	na	runs	2123906	2142247	2131176	11071	685	685	2142247	558044	557140	2972	560112	560600	spneumoniae.S_matchtigs.k_18.d_na.M_runs
spneumoniae	matchtigs	18	na	zeros	2123906	2142247	2123906	18341	2422	685	2142247	558044	557140	7820	564960	564208	spneumoniae.S_matchtigs.k_18.d_na.M_zeros
spneumoniae	eulertigs	19	na	default	2126360	2160632	2126360	34272	1904	1904	2160632	564492	562388	5432	567820	568808	spneumoniae.S_eulertigs.k_19.d_na.M_default
spneumoniae	eulertigs	19	na	ones	2126360	2160632	2127931	32701	1918	1904	2160632	564492	562388	6036	568424	568956	spneumoniae.S_eulertigs.k_19.d_na.M_ones
spneumoniae	eulertigs	19	na	runs	2126360	2160632	2127908	32724	1902	1904	2160632	564492	562388	6008	568396	568900	spneumoniae.S_eulertigs.k_19.d_na.M_runs
spneumoniae	eulertigs	19	na	zeros	2126360	2160632	2126360	34272	2506	1904	2160632	564492	562388	7216	569604	570304	spneumoniae.S_eulertigs.k_19.d_na.M_zeros
spneumoniae	greedytigs	19	na	default	2126360	2146222	2135368	10854	603	603	2146222	557696	557536	2576	560112	559568	spneumoniae.S_greedytigs.k_19.d_na.M_default
spneumoniae	greedytigs	19	na	ones	2126360	2146222	2135829	10393	610	603	2146222	557696	557536	2764	560300	559968	spneumoniae.S_greedytigs.k_19.d_na.M_ones
spneumoniae	greedytigs	19	na	runs	2126360	2146222	2135817	10405	603	603	2146222	557696	557536	2744	560280	560192	spneumoniae.S_greedytigs.k_19.d_na.M_runs
spneumoniae	greedytigs	19	na	zeros	2126360	2146222	2126360	19862	2183	603	2146222	557696	557536	6868	564404	564672	spneumoniae.S_greedytigs.k_19.d_na.M_zeros
spneumoniae	matchtigs	19	na	default	2126360	2144974	2133166	11808	656	656	2144974	557308	556332	2716	559048	559820	spneumoniae.S_matchtigs.k_19.d_na.M_default
spneumoniae	matchtigs	19	na	ones	2126360	2144974	2133695	11279	660	656	2144974	557308	556332	2936	559268	560360	spneumoniae.S_matchtigs.k_19.d_na.M_ones
spneumoniae	matchtigs	19	na	runs	2126360	2144974	2133689	11285	656	656	2144974	557308	556332	2920	559252	560108	spneumoniae.S_matchtigs.k_19.d_na.M_runs
spneumoniae	matchtigs	19	na	zeros	2126360	2144974	2126360	18614	2147	656	2144974	557308	556332	6700	563032	563476	spneumoniae.S_matchtigs.k_19.d_na.M_zeros
spneumoniae	eulertigs	20	na	default	2128471	2161949	2128471	33478	1762	1762	2161949	564200	561484	4920	566404	568668	spneumoniae.S_eulertigs.k_20.d_na.M_default
spneumoniae	eulertigs	20	na	ones	2128471	2161949	2129937	32012	1767	1762	2161949	564200	561484	5472	566956	568572	spneumoniae.S_eulertigs.k_20.d_na.M_ones
spneumoniae	eulertigs	20	na	runs	2128471	2161949	2129917	32032	1757	1762	2161949	564200	561484	5456	566940	568360	spneumoniae.S_eulertigs.k_20.d_na.M_runs
spneumoniae	eulertigs	20	na	zeros	2128471	2161949	2128471	33478	2333	1762	2161949	564200	561484	6620	568104	569616	spneumoniae.S_eulertigs.k_20.d_na.M_zeros
spneumoniae	greedytigs	20	na	default	2128471	2148298	2137563	10735	565	565	2148298	557952	556764	2468	559232	559824	spneumoniae.S_greedytigs.k_20.d_na.M_default
spneumoniae	greedytigs	20	na	ones	2128471	2148298	2137990	10308	567	565	2148298	557952	556764	2636	559400	559912	spneumoniae.S_greedytigs.k_20.d_na.M_ones
spneumoniae	greedytigs	20	na	runs	2128471	2148298	2137987	10311	565	565	2148298	557952	556764	2632	559396	559920	spneumoniae.S_greedytigs.k_20.d_na.M_runs
spneumoniae	greedytigs	20	na	zeros	2128471	2148298	2128471	19827	2026	565	2148298	557952	556764	6336	563100	563740	spneumoniae.S_greedytigs.k_20.d_na.M_zeros
spneumoniae	matchtigs	20	na	default	2128471	2147036	2135275	11761	619	619	2147036	557868	556804	2616	559420	559960	spneumoniae.S_matchtigs.k_20.d_na.M_default
spneumoniae	matchtigs	20	na	ones	2128471	2147036	2135745	11291	627	619	2147036	557868	556804	2812	559616	560020	spneumoniae.S_matchtigs.k_20.d_na.M_ones
spneumoniae	matchtigs	20	na	runs	2128471	2147036	2135736	11300	619	619	2147036	557868	556804	2792	559596	560004	spneumoniae.S_matchtigs.k_20.d_na.M_runs
spneumoniae	matchtigs	20	na	zeros	2128471	2147036	2128471	18565	2017	619	2147036	557868	556804	6176	562980	563404	spneumoniae.S_matchtigs.k_20.d_na.M_zeros
spneumoniae	eulertigs	21	na	default	2130395	2161875	2130395	31480	1574	1574	2161875	562736	560448	4504	564952	567232	spneumoniae.S_eulertigs.k_21.d_na.M_default
spneumoniae	eulertigs	21	na	ones	2130395	2161875	2131657	30218	1582	1574	2161875	562736	560448	5012	565460	567032	spneumoniae.S_eulertigs.k_21.d_na.M_ones
spneumoniae	eulertigs	21	na	runs	2130395	2161875	2131638	30237	1572	1574	2161875	562736	560448	4980	565428	567152	spneumoniae.S_eulertigs.k_21.d_na.M_runs
spneumoniae	eulertigs	21	na	zeros	2130395	2161875	2130395	31480	1942	1574	2161875	562736	560448	5660	566108	567888	spneumoniae.S_eulertigs.k_21.d_na.M_zeros
spneumoniae	greedytigs	21	na	default	2130395	2150073	2139313	10760	538	538	2150073	557296	556500	2396	558896	559376	spneumoniae.S_greedytigs.k_21.d_na.M_default
spneumoniae	greedytigs	21	na	ones	2130395	2150073	2139671	10402	538	538	2150073	557296	556500	2572	559072	559152	spneumoniae.S_greedytigs.k_21.d_na.M_ones
spneumoniae	greedytigs	21	na	runs	2130395	2150073	2139671	10402	538	538	2150073	557296	556500	2572	559072	559152	spneumoniae.S_greedytigs.k_21.d_na.M_runs
spneumoniae	greedytigs	21	na	zeros	2130395	2150073	2130395	19678	1771	538	2150073	557296	556500	5708	562208	563268	spneumoniae.S_greedytigs.k_21.d_na.M_zeros
spneumoniae	matchtigs	21	na	default	2130395	2148831	2137251	11580	579	579	2148831	558232	557152	2472	559624	560032	spneumoniae.S_matchtigs.k_21.d_na.M_default
spneumoniae	matchtigs	21	na	ones	2130395	2148831	2137678	11153	582	579	2148831	558232	557152	2656	559808	559964	spneumoniae.S_matchtigs.k_21.d_na.M_ones
spneumoniae	matchtigs	21	na	runs	2130395	2148831	2137674	11157	579	579	2148831	558232	557152	2648	559800	559900	spneumoniae.S_matchtigs.k_21.d_na.M_runs
spneumoniae	matchtigs	21	na	zeros	2130395	2148831	2130395	18436	1825	579	2148831	558232	557152	5852	563004	563156	spneumoniae.S_matchtigs.k_21.d_na.M_zeros
spneumoniae	eulertigs	22	na	default	2132198	2165063	2132198	32865	1565	1565	2165063	563168	560932	4384	565316	567236	spneumoniae.S_eulertigs.k_22.d_na.M_default
spneumoniae	eulertigs	22	na	ones	2132198	2165063	2133427	31636	1572	1565	2165063	563168	560932	4920	565852	567704	spneumoniae.S_eulertigs.k_22.d_na.M_ones
spneumoniae	eulertigs	22	na	runs	2132198	2165063	2133403	31660	1562	1565	2165063	563168	560932	4904	565836	567664	spneumoniae.S_eulertigs.k_22.d_na.M_runs
spneumoniae	eulertigs	22	na	zeros	2132198	2165063	2132198	32865	1949	1565	2165063	563168	560932	5644	566576	568308	spneumoniae.S_eulertigs.k_22.d_na.M_zeros
spneumoniae	greedytigs	22	na	default	2132198	2152279	2142157	10122	482	482	2152279	557132	556628	2252	558880	559340	spneumoniae.S_greedytigs.k_22.d_na.M_default
spneumoniae	greedytigs	22	na	ones	2132198	2152279	2142552	9727	484	482	2152279	557132	556628	2376	559004	559584	spneumoniae.S_greedytigs.k_22.d_na.M_ones
spneumoniae	greedytigs	22	na	runs	2132198	2152279	2142548	9731	482	482	2152279	557132	556628	2372	559000	559512	spneumoniae.S_greedytigs.k_22.d_na.M_runs
spneumoniae	greedytigs	22	na	zeros	2132198	2152279	2132198	20081	1787	482	2152279	557132	556628	5704	562332	563408	spneumoniae.S_greedytigs.k_22.d_na.M_zeros
spneumoniae	matchtigs	22	na	default	2132198	2150816	2139686	11130	530	530	2150816	558016	557312	2380	559692	559908	spneumoniae.S_matchtigs.k_22.d_na.M_default
spneumoniae	matchtigs	22	na	ones	2132198	2150816	2140085	10731	535	530	2150816	558016	557312	2540	559852	560096	spneumoniae.S_matchtigs.k_22.d_na.M_ones
spneumoniae	matchtigs	22	na	runs	2132198	2150816	2140080	10736	530	530	2150816	558016	557312	2528	559840	560264	spneumoniae.S_matchtigs.k_22.d_na.M_runs
spneumoniae	matchtigs	22	na	zeros	2132198	2150816	2132198	18618	1741	530	2150816	558016	557312	5496	562808	563364	spneumoniae.S_matchtigs.k_22.d_na.M_zeros
spneumoniae	eulertigs	23	na	default	2133906	2167544	2133906	33638	1529	1529	2167544	562820	561036	4388	565424	567584	spneumoniae.S_eulertigs.k_23.d_na.M_default
spneumoniae	eulertigs	23	na	ones	2133906	2167544	2135071	32473	1533	1529	2167544	562820	561036	4916	565952	567424	spneumoniae.S_eulertigs.k_23.d_na.M_ones
spneumoniae	eulertigs	23	na	runs	2133906	2167544	2135065	32479	1529	1529	2167544	562820	561036	4912	565948	567440	spneumoniae.S_eulertigs.k_23.d_na.M_runs
spneumoniae	eulertigs	23	na	zeros	2133906	2167544	2133906	33638	1841	1529	2167544	562820	561036	5384	566420	568620	spneumoniae.S_eulertigs.k_23.d_na.M_zeros
spneumoniae	greedytigs	23	na	default	2133906	2153817	2143983	9834	447	447	2153817	557616	557032	2144	559176	559304	spneumoniae.S_greedytigs.k_23.d_na.M_default
spneumoniae	greedytigs	23	na	ones	2133906	2153817	2144327	9490	449	447	2153817	557616	557032	2268	559300	559324	spneumoniae.S_greedytigs.k_23.d_na.M_ones
spneumoniae	greedytigs	23	na	runs	2133906	2153817	2144325	9492	447	447	2153817	557616	557032	2268	559300	559168	spneumoniae.S_greedytigs.k_23.d_na.M_runs
spneumoniae	greedytigs	23	na	zeros	2133906	2153817	2133906	19911	1732	447	2153817	557616	557032	5616	562648	563172	spneumoniae.S_greedytigs.k_23.d_na.M_zeros
spneumoniae	matchtigs	23	na	default	2133906	2152408	2141540	10868	494	494	2152408	558008	556788	2292	559080	559616	spneumoniae.S_matchtigs.k_23.d_na.M_default
spneumoniae	matchtigs	23	na	ones	2133906	2152408	2141916	10492	495	494	2152408	558008	556788	2448	559236	559760	spneumoniae.S_matchtigs.k_23.d_na.M_ones
spneumoniae	matchtigs	23	na	runs	2133906	2152408	2141915	10493	494	494	2152408	558008	556788	2448	559236	559812	spneumoniae.S_matchtigs.k_23.d_na.M_runs
spneumoniae	matchtigs	23	na	zeros	2133906	2152408	2133906	18502	1741	494	2152408	558008	556788	5528	562316	562868	spneumoniae.S_matchtigs.k_23.d_na.M_zeros
spneumoniae	eulertigs	24	na	default	2135557	2166768	2135557	31211	1357	1357	2166768	561748	560620	4120	564740	566844	spneumoniae.S_eulertigs.k_24.d_na.M_default
spneumoniae	eulertigs	24	na	ones	2135557	2166768	2136709	30059	1359	1357	2166768	561748	560620	4608	565228	566784	spneumoniae.S_eulertigs.k_24.d_na.M_ones
spneumoniae	eulertigs	24	na	runs	2135557	2166768	2136707	30061	1357	1357	2166768	561748	560620	4604	565224	566832	spneumoniae.S_eulertigs.k_24.d_na.M_runs
spneumoniae	eulertigs	24	na	zeros	2135557	2166768	2135557	31211	1686	1357	2166768	561748	560620	5172	565792	567552	spneumoniae.S_eulertigs.k_24.d_na.M_zeros
spneumoniae	greedytigs	24	na	default	2135557	2154880	2144806	10074	438	438	2154880	557348	556772	2128	558900	559584	spneumoniae.S_greedytigs.k_24.d_na.M_default
spneumoniae	greedytigs	24	na	ones	2135557	2154880	2145080	9800	440	438	2154880	557348	556772	2268	559040	559544	spneumoniae.S_greedytigs.k_24.d_na.M_ones
spneumoniae	greedytigs	24	na	runs	2135557	2154880	2145078	9802	438	438	2154880	557348	556772	2260	559032	559492	spneumoniae.S_greedytigs.k_24.d_na.M_runs
spneumoniae	greedytigs	24	na	zeros	2135557	2154880	2135557	19323	1553	438	2154880	557348	556772	5336	562108	562948	spneumoniae.S_greedytigs.k_24.d_na.M_zeros
spneumoniae	matchtigs	24	na	default	2135557	2153830	2142813	11017	479	479	2153830	557720	557508	2264	559772	561752	spneumoniae.S_matchtigs.k_24.d_na.M_default
spneumoniae	matchtigs	24	na	ones	2135557	2153830	2143163	10667	479	479	2153830	557720	557508	2420	559928	559716	spneumoniae.S_matchtigs.k_24.d_na.M_ones
spneumoniae	matchtigs	24	na	runs	2135557	2153830	2143163	10667	479	479	2153830	557720	557508	2420	559928	559716	spneumoniae.S_matchtigs.k_24.d_na.M_runs
spneumoniae	matchtigs	24	na	zeros	2135557	2153830	2135557	18273	1561	479	2153830	557720	557508	5188	562696	562852	spneumoniae.S_matchtigs.k_24.d_na.M_zeros
spneumoniae	eulertigs	25	na	default	2137099	2170099	2137099	33000	1375	1375	2170099	562972	561044	4140	565184	567356	spneumoniae.S_eulertigs.k_25.d_na.M_default
spneumoniae	eulertigs	25	na	ones	2137099	2170099	2138149	31950	1379	1375	2170099	562972	561044	4576	565620	567432	spneumoniae.S_eulertigs.k_25.d_na.M_ones
spneumoniae	eulertigs	25	na	runs	2137099	2170099	2138138	31961	1371	1375	2170099	562972	561044	4576	565620	567536	spneumoniae.S_eulertigs.k_25.d_na.M_runs
spneumoniae	eulertigs	25	na	zeros	2137099	2170099	2137099	33000	1705	1375	2170099	562972	561044	5132	566176	567944	spneumoniae.S_eulertigs.k_25.d_na.M_zeros
spneumoniae	greedytigs	25	na	default	2137099	2156814	2146710	10104	421	421	2156814	557380	557268	2064	559332	559608	spneumoniae.S_greedytigs.k_25.d_na.M_default
spneumoniae	greedytigs	25	na	ones	2137099	2156814	2147002	9812	423	421	2156814	557380	557268	2220	559488	559468	spneumoniae.S_greedytigs.k_25.d_na.M_ones
spneumoniae	greedytigs	25	na	runs	2137099	2156814	2147000	9814	421	421	2156814	557380	557268	2208	559476	559492	spneumoniae.S_greedytigs.k_25.d_na.M_runs
spneumoniae	greedytigs	25	na	zeros	2137099	2156814	2137099	19715	1550	421	2156814	557380	557268	5284	562552	563504	spneumoniae.S_greedytigs.k_25.d_na.M_zeros
spneumoniae	matchtigs	25	na	default	2137099	2155629	2144589	11040	460	460	2155629	558340	557320	2204	559524	559660	spneumoniae.S_matchtigs.k_25.d_na.M_default
spneumoniae	matchtigs	25	na	ones	2137099	2155629	2144915	10714	462	460	2155629	558340	557320	2316	559636	560196	spneumoniae.S_matchtigs.k_25.d_na.M_ones
spneumoniae	matchtigs	25	na	runs	2137099	2155629	2144912	10717	460	460	2155629	558340	557320	2312	559632	560224	spneumoniae.S_matchtigs.k_25.d_na.M_runs
spneumoniae	matchtigs	25	na	zeros	2137099	2155629	2137099	18530	1495	460	2155629	558340	557320	4968	562288	563044	spneumoniae.S_matchtigs.k_25.d_na.M_zeros
spneumoniae	eulertigs	26	na	default	2138599	2172399	2138599	33800	1352	1352	2172399	562904	561788	4072	565860	568336	spneumoniae.S_eulertigs.k_26.d_na.M_default
spneumoniae	eulertigs	26	na	ones	2138599	2172399	2139630	32769	1355	1352	2172399	562904	561788	4528	566316	568196	spneumoniae.S_eulertigs.k_26.d_na.M_ones
spneumoniae	eulertigs	26	na	runs	2138599	2172399	2139626	32773	1351	1352	2172399	562904	561788	4516	566304	568344	spneumoniae.S_eulertigs.k_26.d_na.M_runs
spneumoniae	eulertigs	26	na	zeros	2138599	2172399	2138599	33800	1772	1352	2172399	562904	561788	5356	567144	568836	spneumoniae.S_eulertigs.k_26.d_na.M_zeros
spneumoniae	greedytigs	26	na	default	2138599	2158290	2148315	9975	399	399	2158290	557592	556788	2024	558812	559400	spneumoniae.S_greedytigs.k_26.d_na.M_default
spneumoniae	greedytigs	26	na	ones	2138599	2158290	2148595	9695	399	399	2158290	557592	556788	2148	558936	559592	spneumoniae.S_greedytigs.k_26.d_na.M_ones
spneumoniae	greedytigs	26	na	runs	2138599	2158290	2148595	9695	399	399	2158290	557592	556788	2148	558936	559592	spneumoniae.S_greedytigs.k_26.d_na.M_runs
spneumoniae	greedytigs	26	na	zeros	2138599	2158290	2138599	19691	1522	399	2158290	557592	556788	5212	562000	563000	spneumoniae.S_greedytigs.k_26.d_na.M_zeros
spneumoniae	matchtigs	26	na	default	2138599	2156984	2146084	10900	436	436	2156984	557864	556940	2088	559028	560292	spneumoniae.S_matchtigs.k_26.d_na.M_default
spneumoniae	matchtigs	26	na	ones	2138599	2156984	2146423	10561	437	436	2156984	557864	556940	2248	559188	559568	spneumoniae.S_matchtigs.k_26.d_na.M_ones
spneumoniae	matchtigs	26	na	runs	2138599	2156984	2146422	10562	436	436	2156984	557864	556940	2244	559184	559512	spneumoniae.S_matchtigs.k_26.d_na.M_runs
spneumoniae	matchtigs	26	na	zeros	2138599	2156984	2138599	18385	1554	436	2156984	557864	556940	5180	562120	563468	spneumoniae.S_matchtigs.k_26.d_na.M_zeros
spneumoniae	eulertigs	27	na	default	2140040	2171994	2140040	31954	1229	1229	2171994	562632	560516	3896	564412	566880	spneumoniae.S_eulertigs.k_27.d_na.M_default
spneumoniae	eulertigs	27	na	ones	2140040	2171994	2140971	31023	1235	1229	2171994	562632	560516	4372	564888	567032	spneumoniae.S_eulertigs.k_27.d_na.M_ones
spneumoniae	eulertigs	27	na	runs	2140040	2171994	2140960	31034	1229	1229	2171994	562632	560516	4352	564868	567032	spneumoniae.S_eulertigs.k_27.d_na.M_runs
spneumoniae	eulertigs	27	na	zeros	2140040	2171994	2140040	31954	1507	1229	2171994	562632	560516	4832	565348	567452	spneumoniae.S_eulertigs.k_27.d_na.M_zeros
spneumoniae	greedytigs	27	na	default	2140040	2159093	2149109	9984	384	384	2159093	558032	557424	1980	559404	559272	spneumoniae.S_greedytigs.k_27.d_na.M_default
spneumoniae	greedytigs	27	na	ones	2140040	2159093	2149375	9718	386	384	2159093	558032	557424	2104	559528	559616	spneumoniae.S_greedytigs.k_27.d_na.M_ones
spneumoniae	greedytigs	27	na	runs	2140040	2159093	2149372	9721	384	384	2159093	558032	557424	2100	559524	559704	spneumoniae.S_greedytigs.k_27.d_na.M_runs
spneumoniae	greedytigs	27	na	zeros	2140040	2159093	2140040	19053	1381	384	2159093	558032	557424	4860	562284	563244	spneumoniae.S_greedytigs.k_27.d_na.M_zeros
spneumoniae	matchtigs	27	na	default	2140040	2158141	2147507	10634	409	409	2158141	558016	557196	2052	559248	560304	spneumoniae.S_matchtigs.k_27.d_na.M_default
spneumoniae	matchtigs	27	na	ones	2140040	2158141	2147809	10332	409	409	2158141	558016	557196	2176	559372	560180	spneumoniae.S_matchtigs.k_27.d_na.M_ones
spneumoniae	matchtigs	27	na	runs	2140040	2158141	2147809	10332	409	409	2158141	558016	557196	2176	559372	560180	spneumoniae.S_matchtigs.k_27.d_na.M_runs
spneumoniae	matchtigs	27	na	zeros	2140040	2158141	2140040	18101	1417	409	2158141	558016	557196	4928	562124	563192	spneumoniae.S_matchtigs.k_27.d_na.M_zeros
spneumoniae	eulertigs	28	na	default	2141411	2174459	2141411	33048	1224	1224	2174459	562780	560884	3796	564680	567492	spneumoniae.S_eulertigs.k_28.d_na.M_default
spneumoniae	eulertigs	28	na	ones	2141411	2174459	2142352	32107	1231	1224	2174459	562780	560884	4304	565188	567324	spneumoniae.S_eulertigs.k_28.d_na.M_ones
spneumoniae	eulertigs	28	na	runs	2141411	2174459	2142337	32122	1222	1224	2174459	562780	560884	4280	565164	567572	spneumoniae.S_eulertigs.k_28.d_na.M_runs
spneumoniae	eulertigs	28	na	zeros	2141411	2174459	2141411	33048	1524	1224	2174459	562780	560884	4828	565712	568232	spneumoniae.S_eulertigs.k_28.d_na.M_zeros
spneumoniae	greedytigs	28	na	default	2141411	2160558	2150811	9747	361	361	2160558	557332	556344	1860	558204	558880	spneumoniae.S_greedytigs.k_28.d_na.M_default
spneumoniae	greedytigs	28	na	ones	2141411	2160558	2151071	9487	361	361	2160558	557332	556344	1972	558316	558708	spneumoniae.S_greedytigs.k_28.d_na.M_ones
spneumoniae	greedytigs	28	na	runs	2141411	2160558	2151071	9487	361	361	2160558	557332	556344	1972	558316	558708	spneumoniae.S_greedytigs.k_28.d_na.M_runs
spneumoniae	greedytigs	28	na	zeros	2141411	2160558	2141411	19147	1324	361	2160558	557332	556344	4704	561048	562628	spneumoniae.S_greedytigs.k_28.d_na.M_zeros
spneumoniae	matchtigs	28	na	default	2141411	2159447	2148890	10557	391	391	2159447	557408	556904	1960	558864	560296	spneumoniae.S_matchtigs.k_28.d_na.M_default
spneumoniae	matchtigs	28	na	ones	2141411	2159447	2149143	10304	392	391	2159447	557408	556904	2080	558984	560376	spneumoniae.S_matchtigs.k_28.d_na.M_ones
spneumoniae	matchtigs	28	na	runs	2141411	2159447	2149142	10305	391	391	2159447	557408	556904	2076	558980	560312	spneumoniae.S_matchtigs.k_28.d_na.M_runs
spneumoniae	matchtigs	28	na	zeros	2141411	2159447	2141411	18036	1307	391	2159447	557408	556904	4636	561540	562992	spneumoniae.S_matchtigs.k_28.d_na.M_zeros
spneumoniae	eulertigs	29	na	default	2142734	2176222	2142734	33488	1196	1196	2176222	562980	561712	3796	565508	567496	spneumoniae.S_eulertigs.k_29.d_na.M_default
spneumoniae	eulertigs	29	na	ones	2142734	2176222	2143594	32628	1199	1196	2176222	562980	561712	4180	565892	567976	spneumoniae.S_eulertigs.k_29.d_na.M_ones
spneumoniae	eulertigs	29	na	runs	2142734	2176222	2143588	32634	1196	1196	2176222	562980	561712	4172	565884	568000	spneumoniae.S_eulertigs.k_29.d_na.M_runs
spneumoniae	eulertigs	29	na	zeros	2142734	2176222	2142734	33488	1519	1196	2176222	562980	561712	4820	566532	568260	spneumoniae.S_eulertigs.k_29.d_na.M_zeros
spneumoniae	greedytigs	29	na	default	2142734	2161770	2152082	9688	346	346	2161770	557688	557188	1800	558988	560164	spneumoniae.S_greedytigs.k_29.d_na.M_default
spneumoniae	greedytigs	29	na	ones	2142734	2161770	2152337	9433	348	346	2161770	557688	557188	1912	559100	560264	spneumoniae.S_greedytigs.k_29.d_na.M_ones
spneumoniae	greedytigs	29	na	runs	2142734	2161770	2152334	9436	346	346	2161770	557688	557188	1912	559100	560484	spneumoniae.S_greedytigs.k_29.d_na.M_runs
spneumoniae	greedytigs	29	na	zeros	2142734	2161770	2142734	19036	1374	346	2161770	557688	557188	4892	562080	563672	spneumoniae.S_greedytigs.k_29.d_na.M_zeros
spneumoniae	matchtigs	29	na	default	2142734	2160543	2150043	10500	375	375	2160543	557368	558424	1940	560364	559892	spneumoniae.S_matchtigs.k_29.d_na.M_default
spneumoniae	matchtigs	29	na	ones	2142734	2160543	2150272	10271	376	375	2160543	557368	558424	2040	560464	559804	spneumoniae.S_matchtigs.k_29.d_na.M_ones
spneumoniae	matchtigs	29	na	runs	2142734	2160543	2150270	10273	375	375	2160543	557368	558424	2036	560460	559988	spneumoniae.S_matchtigs.k_29.d_na.M_runs
spneumoniae	matchtigs	29	na	zeros	2142734	2160543	2142734	17809	1319	375	2160543	557368	558424	4676	563100	562712	spneumoniae.S_matchtigs.k_29.d_na.M_zeros
spneumoniae	eulertigs	30	na	default	2144020	2175717	2144020	31697	1093	1093	2175717	562628	561164	3600	564764	566976	spneumoniae.S_eulertigs.k_30.d_na.M_default
spneumoniae	eulertigs	30	na	ones	2144020	2175717	2144835	30882	1100	1093	2175717	562628	561164	3980	565144	567360	spneumoniae.S_eulertigs.k_30.d_na.M_ones
spneumoniae	eulertigs	30	na	runs	2144020	2175717	2144828	30889	1093	1093	2175717	562628	561164	3972	565136	567352	spneumoniae.S_eulertigs.k_30.d_na.M_runs
spneumoniae	eulertigs	30	na	zeros	2144020	2175717	2144020	31697	1425	1093	2175717	562628	561164	4764	565928	568200	spneumoniae.S_eulertigs.k_30.d_na.M_zeros
spneumoniae	greedytigs	30	na	default	2144020	2162688	2153089	9599	331	331	2162688	557308	556540	1796	558336	558968	spneumoniae.S_greedytigs.k_30.d_na.M_default
spneumoniae	greedytigs	30	na	ones	2144020	2162688	2153325	9363	331	331	2162688	557308	556540	1892	558432	559076	spneumoniae.S_greedytigs.k_30.d_na.M_ones
spneumoniae	greedytigs	30	na	runs	2144020	2162688	2153325	9363	331	331	2162688	557308	556540	1892	558432	559076	spneumoniae.S_greedytigs.k_30.d_na.M_runs
spneumoniae	greedytigs	30	na	zeros	2144020	2162688	2144020	18668	1195	331	2162688	557308	556540	4528	561068	562504	spneumoniae.S_greedytigs.k_30.d_na.M_zeros
spneumoniae	matchtigs	30	na	default	2144020	2161568	2151244	10324	356	356	2161568	557696	557696	1888	559584	559420	spneumoniae.S_matchtigs.k_30.d_na.M_default
spneumoniae	matchtigs	30	na	ones	2144020	2161568	2151480	10088	356	356	2161568	557696	557696	1984	559680	559920	spneumoniae.S_matchtigs.k_30.d_na.M_ones
spneumoniae	matchtigs	30	na	runs	2144020	2161568	2151480	10088	356	356	2161568	557696	557696	1984	559680	559920	spneumoniae.S_matchtigs.k_30.d_na.M_runs
spneumoniae	matchtigs	30	na	zeros	2144020	2161568	2144020	17548	1217	356	2161568	557696	557696	4512	562208	562728	spneumoniae.S_matchtigs.k_30.d_na.M_zeros
spneumoniae	eulertigs	31	na	default	2145215	2177435	2145215	32220	1074	1074	2177435	561884	560396	3604	564000	566636	spneumoniae.S_eulertigs.k_31.d_na.M_default
spneumoniae	eulertigs	31	na	ones	2145215	2177435	2146046	31389	1079	1074	2177435	561884	560396	3988	564384	566832	spneumoniae.S_eulertigs.k_31.d_na.M_ones
spneumoniae	eulertigs	31	na	runs	2145215	2177435	2146041	31394	1074	1074	2177435	561884	560396	3976	564372	567280	spneumoniae.S_eulertigs.k_31.d_na.M_runs
spneumoniae	eulertigs	31	na	zeros	2145215	2177435	2145215	32220	1317	1074	2177435	561884	560396	4432	564828	567192	spneumoniae.S_eulertigs.k_31.d_na.M_zeros
spneumoniae	greedytigs	31	na	default	2145215	2163669	2154489	9180	306	306	2163669	557300	557404	1704	559108	559420	spneumoniae.S_greedytigs.k_31.d_na.M_default
spneumoniae	greedytigs	31	na	ones	2145215	2163669	2154706	8963	309	306	2163669	557300	557404	1800	559204	560284	spneumoniae.S_greedytigs.k_31.d_na.M_ones
spneumoniae	greedytigs	31	na	runs	2145215	2163669	2154702	8967	306	306	2163669	557300	557404	1792	559196	559940	spneumoniae.S_greedytigs.k_31.d_na.M_runs
spneumoniae	greedytigs	31	na	zeros	2145215	2163669	2145215	18454	1207	306	2163669	557300	557404	4516	561920	563320	spneumoniae.S_greedytigs.k_31.d_na.M_zeros
spneumoniae	matchtigs	31	na	default	2145215	2162693	2152373	10320	344	344	2162693	557624	557180	1812	558992	559928	spneumoniae.S_matchtigs.k_31.d_na.M_default
spneumoniae	matchtigs	31	na	ones	2145215	2162693	2152623	10070	346	344	2162693	557624	557180	1940	559120	559756	spneumoniae.S_matchtigs.k_31.d_na.M_ones
spneumoniae	matchtigs	31	na	runs	2145215	2162693	2152618	10075	344	344	2162693	557624	557180	1936	559116	559644	spneumoniae.S_matchtigs.k_31.d_na.M_runs
spneumoniae	matchtigs	31	na	zeros	2145215	2162693	2145215	17478	1218	344	2162693	557624	557180	4544	561724	562924	spneumoniae.S_matchtigs.k_31.d_na.M_zeros
