genome	S_alg	k	d	M_alg	kmer_count	l	o	z	r	tigs_ns	tigs_cl	tigs_xz_bytes	S_xz_bytes	M_xz_bytes	enc1_xz_bytes	enc2_xz_bytes	pref
spneumo-pangenome	eulertigs	11	na	default	1545282	2529652	1545282	984370	98437	98437	2628089	756496	691004	91236	782240	821412	spneumo-pangenome.S_eulertigs.k_11.d_na.M_default
spneumo-pangenome	eulertigs	11	na	ones	1545282	2529652	2200774	328878	171132	98437	2628089	756496	691004	174124	865128	839416	spneumo-pangenome.S_eulertigs.k_11.d_na.M_ones
spneumo-pangenome	eulertigs	11	na	runs	1545282	2529652	1978074	551578	84400	98437	2628089	756496	691004	129404	820408	808064	spneumo-pangenome.S_eulertigs.k_11.d_na.M_runs
spneumo-pangenome	eulertigs	11	na	zeros	1545282	2529652	1545282	984370	289299	98437	2628089	756496	691004	250400	941404	930072	spneumo-pangenome.S_eulertigs.k_11.d_na.M_zeros
spneumo-pangenome	greedytigs	11	na	default	1545282	1861118	1852348	8770	877	877	1861995	503304	509176	3716	512892	510164	spneumo-pangenome.S_greedytigs.k_11.d_na.M_default
spneumo-pangenome	greedytigs	11	na	ones	1545282	1861118	1855052	6066	1934	877	1861995	503304	509176	4872	514048	511116	spneumo-pangenome.S_greedytigs.k_11.d_na.M_ones
spneumo-pangenome	greedytigs	11	na	runs	1545282	1861118	1853102	8016	877	877	1861995	503304	509176	3904	513080	510724	spneumo-pangenome.S_greedytigs.k_11.d_na.M_runs
spneumo-pangenome	greedytigs	11	na	zeros	1545282	1861118	1545282	315836	164818	877	1861995	503304	509176	148384	657560	644740	spneumo-pangenome.S_greedytigs.k_11.d_na.M_zeros
spneumo-pangenome	eulertigs	12	na	default	3336895	6813225	3336895	3476330	316030	316030	7129255	2035828	1808668	255108	2063776	2223232	spneumo-pangenome.S_eulertigs.k_12.d_na.M_default
spneumo-pangenome	eulertigs	12	na	ones	3336895	6813225	5176736	1636489	659045	316030	7129255	2035828	1808668	608112	2416780	2410164	spneumo-pangenome.S_eulertigs.k_12.d_na.M_ones
spneumo-pangenome	eulertigs	12	na	runs	3336895	6813225	4331000	2482225	292734	316030	7129255	2035828	1808668	398312	2206980	2220016	spneumo-pangenome.S_eulertigs.k_12.d_na.M_runs
spneumo-pangenome	eulertigs	12	na	zeros	3336895	6813225	3336895	3476330	874486	316030	7129255	2035828	1808668	722568	2531236	2537188	spneumo-pangenome.S_eulertigs.k_12.d_na.M_zeros
spneumo-pangenome	greedytigs	12	na	default	3336895	4398137	4360759	37378	3398	3398	4401535	1166376	1165972	12584	1178556	1172896	spneumo-pangenome.S_greedytigs.k_12.d_na.M_default
spneumo-pangenome	greedytigs	12	na	ones	3336895	4398137	4368944	29193	6819	3398	4401535	1166376	1165972	16664	1182636	1178220	spneumo-pangenome.S_greedytigs.k_12.d_na.M_ones
spneumo-pangenome	greedytigs	12	na	runs	3336895	4398137	4363089	35048	3398	3398	4401535	1166376	1165972	13264	1179236	1174108	spneumo-pangenome.S_greedytigs.k_12.d_na.M_runs
spneumo-pangenome	greedytigs	12	na	zeros	3336895	4398137	3336895	1061242	500670	3398	4401535	1166376	1165972	415424	1581396	1577204	spneumo-pangenome.S_greedytigs.k_12.d_na.M_zeros
spneumo-pangenome	eulertigs	13	na	default	5038555	10244419	5038555	5205864	433822	433822	10678241	2993344	2661464	379128	3040592	3285684	spneumo-pangenome.S_eulertigs.k_13.d_na.M_default
spneumo-pangenome	eulertigs	13	na	ones	5038555	10244419	6874480	3369939	931975	433822	10678241	2993344	2661464	915188	3576652	3628092	spneumo-pangenome.S_eulertigs.k_13.d_na.M_ones
spneumo-pangenome	eulertigs	13	na	runs	5038555	10244419	5878359	4366060	420809	433822	10678241	2993344	2661464	568144	3229608	3280404	spneumo-pangenome.S_eulertigs.k_13.d_na.M_runs
spneumo-pangenome	eulertigs	13	na	zeros	5038555	10244419	5038555	5205864	1022247	433822	10678241	2993344	2661464	957392	3618856	3699288	spneumo-pangenome.S_eulertigs.k_13.d_na.M_zeros
spneumo-pangenome	greedytigs	13	na	default	5038555	6801307	6644359	156948	13079	13079	6814386	1772900	1752348	40836	1793184	1789244	spneumo-pangenome.S_greedytigs.k_13.d_na.M_default
spneumo-pangenome	greedytigs	13	na	ones	5038555	6801307	6667207	134100	21684	13079	6814386	1772900	1752348	53260	1805608	1794872	spneumo-pangenome.S_greedytigs.k_13.d_na.M_ones
spneumo-pangenome	greedytigs	13	na	runs	5038555	6801307	6654197	147110	13078	13079	6814386	1772900	1752348	43668	1796016	1788368	spneumo-pangenome.S_greedytigs.k_13.d_na.M_runs
spneumo-pangenome	greedytigs	13	na	zeros	5038555	6801307	5038555	1762752	647019	13079	6814386	1772900	1752348	618832	2371180	2397040	spneumo-pangenome.S_greedytigs.k_13.d_na.M_zeros
spneumo-pangenome	eulertigs	14	na	default	6089164	10737262	6089164	4648098	357546	357546	11094808	3044916	2751064	371580	3122644	3329512	spneumo-pangenome.S_eulertigs.k_14.d_na.M_default
spneumo-pangenome	eulertigs	14	na	ones	6089164	10737262	7031037	3706225	640060	357546	11094808	3044916	2751064	755208	3506272	3580952	spneumo-pangenome.S_eulertigs.k_14.d_na.M_ones
spneumo-pangenome	eulertigs	14	na	runs	6089164	10737262	6547724	4189538	353301	357546	11094808	3044916	2751064	494380	3245444	3327216	spneumo-pangenome.S_eulertigs.k_14.d_na.M_runs
spneumo-pangenome	eulertigs	14	na	zeros	6089164	10737262	6089164	4648098	736507	357546	11094808	3044916	2751064	816364	3567428	3664384	spneumo-pangenome.S_eulertigs.k_14.d_na.M_zeros
spneumo-pangenome	greedytigs	14	na	default	6089164	8090537	7615465	475072	36544	36544	8127081	2070992	2021796	94276	2116072	2126416	spneumo-pangenome.S_greedytigs.k_14.d_na.M_default
spneumo-pangenome	greedytigs	14	na	ones	6089164	8090537	7664871	425666	51434	36544	8127081	2070992	2021796	121956	2143752	2138936	spneumo-pangenome.S_greedytigs.k_14.d_na.M_ones
spneumo-pangenome	greedytigs	14	na	runs	6089164	8090537	7643380	447157	36541	36544	8127081	2070992	2021796	102064	2123860	2126484	spneumo-pangenome.S_greedytigs.k_14.d_na.M_runs
spneumo-pangenome	greedytigs	14	na	zeros	6089164	8090537	6089164	2001373	533038	36544	8127081	2070992	2021796	623656	2645452	2716548	spneumo-pangenome.S_greedytigs.k_14.d_na.M_zeros
spneumo-pangenome	eulertigs	15	na	default	6634628	10112774	6634628	3478146	248439	248439	10361213	2748860	2531744	308828	2840572	3019940	spneumo-pangenome.S_eulertigs.k_15.d_na.M_default
spneumo-pangenome	eulertigs	15	na	ones	6634628	10112774	7014715	3098059	340057	248439	10361213	2748860	2531744	493304	3025048	3125244	spneumo-pangenome.S_eulertigs.k_15.d_na.M_ones
spneumo-pangenome	eulertigs	15	na	runs	6634628	10112774	6874095	3238679	247460	248439	10361213	2748860	2531744	377700	2909444	3020184	spneumo-pangenome.S_eulertigs.k_15.d_na.M_runs
spneumo-pangenome	eulertigs	15	na	zeros	6634628	10112774	6634628	3478146	424534	248439	10361213	2748860	2531744	568016	3099760	3217548	spneumo-pangenome.S_eulertigs.k_15.d_na.M_zeros
spneumo-pangenome	greedytigs	15	na	default	6634628	8594150	7708930	885220	63230	63230	8657380	2145472	2070524	138628	2209152	2258168	spneumo-pangenome.S_greedytigs.k_15.d_na.M_default
spneumo-pangenome	greedytigs	15	na	ones	6634628	8594150	7775557	818593	76669	63230	8657380	2145472	2070524	174064	2244588	2275380	spneumo-pangenome.S_greedytigs.k_15.d_na.M_ones
spneumo-pangenome	greedytigs	15	na	runs	6634628	8594150	7756587	837563	63224	63230	8657380	2145472	2070524	153340	2223864	2257736	spneumo-pangenome.S_greedytigs.k_15.d_na.M_runs
spneumo-pangenome	greedytigs	15	na	zeros	6634628	8594150	6634628	1959522	341884	63230	8657380	2145472	2070524	505036	2575560	2686316	spneumo-pangenome.S_greedytigs.k_15.d_na.M_zeros
spneumo-pangenome	eulertigs	16	na	default	6945327	9972762	6945327	3027435	201829	201829	10174591	2617672	2432020	266512	2698532	2905336	spneumo-pangenome.S_eulertigs.k_16.d_na.M_default
spneumo-pangenome	eulertigs	16	na	ones	6945327	9972762	7146174	2826588	226952	201829	10174591	2617672	2432020	360588	2792608	2942128	spneumo-pangenome.S_eulertigs.k_16.d_na.M_ones
spneumo-pangenome	eulertigs	16	na	runs	6945327	9972762	7109854	2862908	201508	201829	10174591	2617672	2432020	319324	2751344	2907008	spneumo-pangenome.S_eulertigs.k_16.d_na.M_runs
spneumo-pangenome	eulertigs	16	na	zeros	6945327	9972762	6945327	3027435	317098	201829	10174591	2617672	2432020	462672	2894692	3054332	spneumo-pangenome.S_eulertigs.k_16.d_na.M_zeros
spneumo-pangenome	greedytigs	16	na	default	6945327	8906590	7757500	1149090	76606	76606	8983196	2145872	2059640	153112	2212752	2308900	spneumo-pangenome.S_greedytigs.k_16.d_na.M_default
spneumo-pangenome	greedytigs	16	na	ones	6945327	8906590	7823999	1082591	83549	76606	8983196	2145872	2059640	184536	2244176	2318104	spneumo-pangenome.S_greedytigs.k_16.d_na.M_ones
spneumo-pangenome	greedytigs	16	na	runs	6945327	8906590	7814452	1092138	76604	76606	8983196	2145872	2059640	171828	2231468	2307028	spneumo-pangenome.S_greedytigs.k_16.d_na.M_runs
spneumo-pangenome	greedytigs	16	na	zeros	6945327	8906590	6945327	1961263	256419	76606	8983196	2145872	2059640	424516	2484156	2647016	spneumo-pangenome.S_greedytigs.k_16.d_na.M_zeros
spneumo-pangenome	matchtigs	16	na	default	6945327	8745382	7515247	1230135	82009	82009	8827391	2141432	2050128	156472	2206600	2307796	spneumo-pangenome.S_matchtigs.k_16.d_na.M_default
spneumo-pangenome	matchtigs	16	na	ones	6945327	8745382	7585719	1159663	89554	82009	8827391	2141432	2050128	190432	2240560	2318140	spneumo-pangenome.S_matchtigs.k_16.d_na.M_ones
spneumo-pangenome	matchtigs	16	na	runs	6945327	8745382	7575238	1170144	82009	82009	8827391	2141432	2050128	176476	2226604	2306740	spneumo-pangenome.S_matchtigs.k_16.d_na.M_runs
spneumo-pangenome	matchtigs	16	na	zeros	6945327	8745382	6945327	1800055	253877	82009	8827391	2141432	2050128	408964	2459092	2598376	spneumo-pangenome.S_matchtigs.k_16.d_na.M_zeros
spneumo-pangenome	eulertigs	17	na	default	7170727	10067399	7170727	2896672	181042	181042	10248441	2551012	2388432	239604	2628036	2872500	spneumo-pangenome.S_eulertigs.k_17.d_na.M_default
spneumo-pangenome	eulertigs	17	na	ones	7170727	10067399	7321101	2746298	187955	181042	10248441	2551012	2388432	302848	2691280	2886840	spneumo-pangenome.S_eulertigs.k_17.d_na.M_ones
spneumo-pangenome	eulertigs	17	na	runs	7170727	10067399	7311208	2756191	180894	181042	10248441	2551012	2388432	288740	2677172	2876124	spneumo-pangenome.S_eulertigs.k_17.d_na.M_runs
spneumo-pangenome	eulertigs	17	na	zeros	7170727	10067399	7170727	2896672	252137	181042	10248441	2551012	2388432	377972	2766404	2973128	spneumo-pangenome.S_eulertigs.k_17.d_na.M_zeros
spneumo-pangenome	greedytigs	17	na	default	7170727	9145624	7881928	1263696	78981	78981	9224605	2134344	2047044	152108	2199152	2325400	spneumo-pangenome.S_greedytigs.k_17.d_na.M_default
spneumo-pangenome	greedytigs	17	na	ones	7170727	9145624	7943401	1202223	81643	78981	9224605	2134344	2047044	177844	2224888	2328280	spneumo-pangenome.S_greedytigs.k_17.d_na.M_ones
spneumo-pangenome	greedytigs	17	na	runs	7170727	9145624	7939715	1205909	78980	78981	9224605	2134344	2047044	172192	2219236	2324028	spneumo-pangenome.S_greedytigs.k_17.d_na.M_runs
spneumo-pangenome	greedytigs	17	na	zeros	7170727	9145624	7170727	1974897	221764	78981	9224605	2134344	2047044	380780	2427824	2625532	spneumo-pangenome.S_greedytigs.k_17.d_na.M_zeros
spneumo-pangenome	matchtigs	17	na	default	7170727	9035375	7706847	1328528	83033	83033	9118408	2139948	2048596	154952	2203548	2333080	spneumo-pangenome.S_matchtigs.k_17.d_na.M_default
spneumo-pangenome	matchtigs	17	na	ones	7170727	9035375	7771653	1263722	85825	83033	9118408	2139948	2048596	181992	2230588	2336864	spneumo-pangenome.S_matchtigs.k_17.d_na.M_ones
spneumo-pangenome	matchtigs	17	na	runs	7170727	9035375	7767804	1267571	83033	83033	9118408	2139948	2048596	176044	2224640	2331964	spneumo-pangenome.S_matchtigs.k_17.d_na.M_runs
spneumo-pangenome	matchtigs	17	na	zeros	7170727	9035375	7170727	1864648	222071	83033	9118408	2139948	2048596	373556	2422152	2598344	spneumo-pangenome.S_matchtigs.k_17.d_na.M_zeros
spneumo-pangenome	eulertigs	18	na	default	7367184	10168257	7367184	2801073	164769	164769	10333026	2522948	2369100	219620	2588720	2846696	spneumo-pangenome.S_eulertigs.k_18.d_na.M_default
spneumo-pangenome	eulertigs	18	na	ones	7367184	10168257	7494491	2673766	166932	164769	10333026	2522948	2369100	270860	2639960	2854524	spneumo-pangenome.S_eulertigs.k_18.d_na.M_ones
spneumo-pangenome	eulertigs	18	na	runs	7367184	10168257	7491356	2676901	164697	164769	10333026	2522948	2369100	265948	2635048	2851164	spneumo-pangenome.S_eulertigs.k_18.d_na.M_runs
spneumo-pangenome	eulertigs	18	na	zeros	7367184	10168257	7367184	2801073	233295	164769	10333026	2522948	2369100	357624	2726724	2949624	spneumo-pangenome.S_eulertigs.k_18.d_na.M_zeros
spneumo-pangenome	greedytigs	18	na	default	7367184	9385306	8038974	1346332	79196	79196	9464502	2141952	2055664	150744	2206408	2353556	spneumo-pangenome.S_greedytigs.k_18.d_na.M_default
spneumo-pangenome	greedytigs	18	na	ones	7367184	9385306	8098666	1286640	80184	79196	9464502	2141952	2055664	174028	2229692	2355680	spneumo-pangenome.S_greedytigs.k_18.d_na.M_ones
spneumo-pangenome	greedytigs	18	na	runs	7367184	9385306	8097300	1288006	79195	79196	9464502	2141952	2055664	171596	2227260	2352844	spneumo-pangenome.S_greedytigs.k_18.d_na.M_runs
spneumo-pangenome	greedytigs	18	na	zeros	7367184	9385306	7367184	2018122	202214	79196	9464502	2141952	2055664	359468	2415132	2632744	spneumo-pangenome.S_greedytigs.k_18.d_na.M_zeros
spneumo-pangenome	matchtigs	18	na	default	7367184	9293961	7891495	1402466	82498	82498	9376459	2118340	2036720	153680	2190400	2345044	spneumo-pangenome.S_matchtigs.k_18.d_na.M_default
spneumo-pangenome	matchtigs	18	na	ones	7367184	9293961	7953003	1340958	83450	82498	9376459	2118340	2036720	177344	2214064	2347588	spneumo-pangenome.S_matchtigs.k_18.d_na.M_ones
spneumo-pangenome	matchtigs	18	na	runs	7367184	9293961	7951744	1342217	82498	82498	9376459	2118340	2036720	174984	2211704	2346140	spneumo-pangenome.S_matchtigs.k_18.d_na.M_runs
spneumo-pangenome	matchtigs	18	na	zeros	7367184	9293961	7367184	1926777	190012	82498	9376459	2118340	2036720	328328	2365048	2579520	spneumo-pangenome.S_matchtigs.k_18.d_na.M_zeros
spneumo-pangenome	eulertigs	19	na	default	7551412	10579300	7551412	3027888	168216	168216	10747516	2589324	2432160	220972	2653132	2933468	spneumo-pangenome.S_eulertigs.k_19.d_na.M_default
spneumo-pangenome	eulertigs	19	na	ones	7551412	10579300	7678601	2900699	169047	168216	10747516	2589324	2432160	270512	2702672	2942108	spneumo-pangenome.S_eulertigs.k_19.d_na.M_ones
spneumo-pangenome	eulertigs	19	na	runs	7551412	10579300	7677254	2902046	168126	168216	10747516	2589324	2432160	268432	2700592	2940636	spneumo-pangenome.S_eulertigs.k_19.d_na.M_runs
spneumo-pangenome	eulertigs	19	na	zeros	7551412	10579300	7551412	3027888	238673	168216	10747516	2589324	2432160	364352	2796512	3044352	spneumo-pangenome.S_eulertigs.k_19.d_na.M_zeros
spneumo-pangenome	greedytigs	19	na	default	7551412	9701328	8291316	1410012	78334	78334	9779662	2163324	2078404	150684	2229088	2389652	spneumo-pangenome.S_greedytigs.k_19.d_na.M_default
spneumo-pangenome	greedytigs	19	na	ones	7551412	9701328	8349015	1352313	78697	78334	9779662	2163324	2078404	172212	2250616	2390428	spneumo-pangenome.S_greedytigs.k_19.d_na.M_ones
spneumo-pangenome	greedytigs	19	na	runs	7551412	9701328	8348498	1352830	78334	78334	9779662	2163324	2078404	171252	2249656	2389960	spneumo-pangenome.S_greedytigs.k_19.d_na.M_runs
spneumo-pangenome	greedytigs	19	na	zeros	7551412	9701328	7551412	2149916	202774	78334	9779662	2163324	2078404	362188	2440592	2687984	spneumo-pangenome.S_greedytigs.k_19.d_na.M_zeros
spneumo-pangenome	matchtigs	19	na	default	7551412	9596167	8123389	1472778	81821	81821	9677988	2125604	2050320	153232	2203552	2370060	spneumo-pangenome.S_matchtigs.k_19.d_na.M_default
spneumo-pangenome	matchtigs	19	na	ones	7551412	9596167	8183614	1412553	82182	81821	9677988	2125604	2050320	175704	2226024	2370428	spneumo-pangenome.S_matchtigs.k_19.d_na.M_ones
spneumo-pangenome	matchtigs	19	na	runs	7551412	9596167	8183122	1413045	81821	81821	9677988	2125604	2050320	174680	2225000	2369184	spneumo-pangenome.S_matchtigs.k_19.d_na.M_runs
spneumo-pangenome	matchtigs	19	na	zeros	7551412	9596167	7551412	2044755	186574	81821	9677988	2125604	2050320	313988	2364308	2607260	spneumo-pangenome.S_matchtigs.k_19.d_na.M_zeros
spneumo-pangenome	eulertigs	20	na	default	7731727	10908489	7731727	3176762	167198	167198	11075687	2630312	2474232	220764	2694996	2991576	spneumo-pangenome.S_eulertigs.k_20.d_na.M_default
spneumo-pangenome	eulertigs	20	na	ones	7731727	10908489	7858013	3050476	167625	167198	11075687	2630312	2474232	270280	2744512	3001308	spneumo-pangenome.S_eulertigs.k_20.d_na.M_ones
spneumo-pangenome	eulertigs	20	na	runs	7731727	10908489	7857153	3051336	167093	167198	11075687	2630312	2474232	269204	2743436	3000384	spneumo-pangenome.S_eulertigs.k_20.d_na.M_runs
spneumo-pangenome	eulertigs	20	na	zeros	7731727	10908489	7731727	3176762	240019	167198	11075687	2630312	2474232	372104	2846336	3108816	spneumo-pangenome.S_eulertigs.k_20.d_na.M_zeros
spneumo-pangenome	greedytigs	20	na	default	7731727	9960259	8513181	1447078	76162	76162	10036421	2143136	2066888	149464	2216352	2392248	spneumo-pangenome.S_greedytigs.k_20.d_na.M_default
spneumo-pangenome	greedytigs	20	na	ones	7731727	9960259	8568965	1391294	76309	76162	10036421	2143136	2066888	170184	2237072	2392444	spneumo-pangenome.S_greedytigs.k_20.d_na.M_ones
spneumo-pangenome	greedytigs	20	na	runs	7731727	9960259	8568735	1391524	76162	76162	10036421	2143136	2066888	169784	2236672	2392540	spneumo-pangenome.S_greedytigs.k_20.d_na.M_runs
spneumo-pangenome	greedytigs	20	na	zeros	7731727	9960259	7731727	2228532	189321	76162	10036421	2143136	2066888	335880	2402768	2689116	spneumo-pangenome.S_greedytigs.k_20.d_na.M_zeros
spneumo-pangenome	matchtigs	20	na	default	7731727	9842741	8324451	1518290	79910	79910	9922651	2143892	2068168	152356	2220524	2399248	spneumo-pangenome.S_matchtigs.k_20.d_na.M_default
spneumo-pangenome	matchtigs	20	na	ones	7731727	9842741	8382792	1459949	80097	79910	9922651	2143892	2068168	173712	2241880	2397568	spneumo-pangenome.S_matchtigs.k_20.d_na.M_ones
spneumo-pangenome	matchtigs	20	na	runs	7731727	9842741	8382530	1460211	79910	79910	9922651	2143892	2068168	173204	2241372	2397180	spneumo-pangenome.S_matchtigs.k_20.d_na.M_runs
spneumo-pangenome	matchtigs	20	na	zeros	7731727	9842741	7731727	2111014	185823	79910	9922651	2143892	2068168	313056	2381224	2636472	spneumo-pangenome.S_matchtigs.k_20.d_na.M_zeros
spneumo-pangenome	eulertigs	21	na	default	7910060	11083480	7910060	3173420	158671	158671	11242151	2614336	2465588	217092	2682680	2987684	spneumo-pangenome.S_eulertigs.k_21.d_na.M_default
spneumo-pangenome	eulertigs	21	na	ones	7910060	11083480	8029167	3054313	158925	158671	11242151	2614336	2465588	264424	2730012	2997200	spneumo-pangenome.S_eulertigs.k_21.d_na.M_ones
spneumo-pangenome	eulertigs	21	na	runs	7910060	11083480	8028715	3054765	158631	158671	11242151	2614336	2465588	263728	2729316	2996584	spneumo-pangenome.S_eulertigs.k_21.d_na.M_runs
spneumo-pangenome	eulertigs	21	na	zeros	7910060	11083480	7910060	3173420	226553	158671	11242151	2614336	2465588	360112	2825700	3099340	spneumo-pangenome.S_eulertigs.k_21.d_na.M_zeros
spneumo-pangenome	greedytigs	21	na	default	7910060	10190149	8685329	1504820	75241	75241	10265390	2191320	2108996	149612	2258608	2435348	spneumo-pangenome.S_greedytigs.k_21.d_na.M_default
spneumo-pangenome	greedytigs	21	na	ones	7910060	10190149	8740175	1449974	75343	75241	10265390	2191320	2108996	169952	2278948	2436264	spneumo-pangenome.S_greedytigs.k_21.d_na.M_ones
spneumo-pangenome	greedytigs	21	na	runs	7910060	10190149	8740032	1450117	75241	75241	10265390	2191320	2108996	169624	2278620	2436048	spneumo-pangenome.S_greedytigs.k_21.d_na.M_runs
spneumo-pangenome	greedytigs	21	na	zeros	7910060	10190149	7910060	2280089	192329	75241	10265390	2191320	2108996	357276	2466272	2734784	spneumo-pangenome.S_greedytigs.k_21.d_na.M_zeros
spneumo-pangenome	matchtigs	21	na	default	7910060	10080039	8506899	1573140	78657	78657	10158696	2201792	2115744	152408	2268152	2447700	spneumo-pangenome.S_matchtigs.k_21.d_na.M_default
spneumo-pangenome	matchtigs	21	na	ones	7910060	10080039	8564297	1515742	78765	78657	10158696	2201792	2115744	173464	2289208	2449752	spneumo-pangenome.S_matchtigs.k_21.d_na.M_ones
spneumo-pangenome	matchtigs	21	na	runs	7910060	10080039	8564144	1515895	78657	78657	10158696	2201792	2115744	173152	2288896	2449544	spneumo-pangenome.S_matchtigs.k_21.d_na.M_runs
spneumo-pangenome	matchtigs	21	na	zeros	7910060	10080039	7910060	2169979	194008	78657	10158696	2201792	2115744	354432	2470176	2715024	spneumo-pangenome.S_matchtigs.k_21.d_na.M_zeros
spneumo-pangenome	eulertigs	22	na	default	8085776	11531519	8085776	3445743	164083	164083	11695602	2688384	2534900	224448	2759348	3085804	spneumo-pangenome.S_eulertigs.k_22.d_na.M_default
spneumo-pangenome	eulertigs	22	na	ones	8085776	11531519	8207343	3324176	164324	164083	11695602	2688384	2534900	274004	2808904	3094548	spneumo-pangenome.S_eulertigs.k_22.d_na.M_ones
spneumo-pangenome	eulertigs	22	na	runs	8085776	11531519	8206817	3324702	163995	164083	11695602	2688384	2534900	273408	2808308	3093968	spneumo-pangenome.S_eulertigs.k_22.d_na.M_runs
spneumo-pangenome	eulertigs	22	na	zeros	8085776	11531519	8085776	3445743	235206	164083	11695602	2688384	2534900	375188	2910088	3202412	spneumo-pangenome.S_eulertigs.k_22.d_na.M_zeros
spneumo-pangenome	greedytigs	22	na	default	8085776	10499456	8945393	1554063	74003	74003	10573459	2173264	2100684	150184	2250868	2449464	spneumo-pangenome.S_greedytigs.k_22.d_na.M_default
spneumo-pangenome	greedytigs	22	na	ones	8085776	10499456	8999221	1500235	74073	74003	10573459	2173264	2100684	170540	2271224	2449056	spneumo-pangenome.S_greedytigs.k_22.d_na.M_ones
spneumo-pangenome	greedytigs	22	na	runs	8085776	10499456	8999135	1500321	74003	74003	10573459	2173264	2100684	170352	2271036	2448780	spneumo-pangenome.S_greedytigs.k_22.d_na.M_runs
spneumo-pangenome	greedytigs	22	na	zeros	8085776	10499456	8085776	2413680	184392	74003	10573459	2173264	2100684	337132	2437816	2755688	spneumo-pangenome.S_greedytigs.k_22.d_na.M_zeros
spneumo-pangenome	eulertigs	23	na	default	8260593	11861993	8260593	3601400	163700	163700	12025693	2706384	2557940	227796	2785736	3130768	spneumo-pangenome.S_eulertigs.k_23.d_na.M_default
spneumo-pangenome	eulertigs	23	na	ones	8260593	11861993	8382777	3479216	163885	163700	12025693	2706384	2557940	280616	2838556	3138864	spneumo-pangenome.S_eulertigs.k_23.d_na.M_ones
spneumo-pangenome	eulertigs	23	na	runs	8260593	11861993	8382278	3479715	163608	163700	12025693	2706384	2557940	280164	2838104	3139488	spneumo-pangenome.S_eulertigs.k_23.d_na.M_runs
spneumo-pangenome	eulertigs	23	na	zeros	8260593	11861993	8260593	3601400	229824	163700	12025693	2706384	2557940	372000	2929940	3240936	spneumo-pangenome.S_eulertigs.k_23.d_na.M_zeros
spneumo-pangenome	greedytigs	23	na	default	8260593	10750018	9165094	1584924	72042	72042	10822060	2227948	2148580	149384	2297964	2488176	spneumo-pangenome.S_greedytigs.k_23.d_na.M_default
spneumo-pangenome	greedytigs	23	na	ones	8260593	10750018	9216991	1533027	72094	72042	10822060	2227948	2148580	170960	2319540	2488800	spneumo-pangenome.S_greedytigs.k_23.d_na.M_ones
spneumo-pangenome	greedytigs	23	na	runs	8260593	10750018	9216924	1533094	72042	72042	10822060	2227948	2148580	170828	2319408	2488576	spneumo-pangenome.S_greedytigs.k_23.d_na.M_runs
spneumo-pangenome	greedytigs	23	na	zeros	8260593	10750018	8260593	2489425	194229	72042	10822060	2227948	2148580	368960	2517540	2821356	spneumo-pangenome.S_greedytigs.k_23.d_na.M_zeros
spneumo-pangenome	eulertigs	24	na	default	8434681	12025878	8434681	3591197	156139	156139	12182017	2624484	2493132	224152	2717284	3118580	spneumo-pangenome.S_eulertigs.k_24.d_na.M_default
spneumo-pangenome	eulertigs	24	na	ones	8434681	12025878	8551095	3474783	156305	156139	12182017	2624484	2493132	275284	2768416	3127756	spneumo-pangenome.S_eulertigs.k_24.d_na.M_ones
spneumo-pangenome	eulertigs	24	na	runs	8434681	12025878	8550767	3475111	156106	156139	12182017	2624484	2493132	274884	2768016	3127468	spneumo-pangenome.S_eulertigs.k_24.d_na.M_runs
spneumo-pangenome	eulertigs	24	na	zeros	8434681	12025878	8434681	3591197	198405	156139	12182017	2624484	2493132	326224	2819356	3198144	spneumo-pangenome.S_eulertigs.k_24.d_na.M_zeros
spneumo-pangenome	greedytigs	24	na	default	8434681	10976336	9332365	1643971	71477	71477	11047813	2213308	2140192	150288	2290480	2501368	spneumo-pangenome.S_greedytigs.k_24.d_na.M_default
spneumo-pangenome	greedytigs	24	na	ones	8434681	10976336	9384292	1592044	71531	71477	11047813	2213308	2140192	172088	2312280	2501356	spneumo-pangenome.S_greedytigs.k_24.d_na.M_ones
spneumo-pangenome	greedytigs	24	na	runs	8434681	10976336	9384215	1592121	71477	71477	11047813	2213308	2140192	171920	2312112	2501184	spneumo-pangenome.S_greedytigs.k_24.d_na.M_runs
spneumo-pangenome	greedytigs	24	na	zeros	8434681	10976336	8434681	2541655	180830	71477	11047813	2213308	2140192	348552	2488744	2821760	spneumo-pangenome.S_greedytigs.k_24.d_na.M_zeros
spneumo-pangenome	eulertigs	25	na	default	8607254	12490454	8607254	3883200	161800	161800	12652254	2763932	2615868	232912	2848780	3224476	spneumo-pangenome.S_eulertigs.k_25.d_na.M_default
spneumo-pangenome	eulertigs	25	na	ones	8607254	12490454	8727212	3763242	161985	161800	12652254	2763932	2615868	285856	2901724	3232944	spneumo-pangenome.S_eulertigs.k_25.d_na.M_ones
spneumo-pangenome	eulertigs	25	na	runs	8607254	12490454	8726782	3763672	161729	161800	12652254	2763932	2615868	285496	2901364	3231380	spneumo-pangenome.S_eulertigs.k_25.d_na.M_runs
spneumo-pangenome	eulertigs	25	na	zeros	8607254	12490454	8607254	3883200	229912	161800	12652254	2763932	2615868	382660	2998528	3339324	spneumo-pangenome.S_eulertigs.k_25.d_na.M_zeros
spneumo-pangenome	greedytigs	25	na	default	8607254	11286309	9600837	1685472	70228	70228	11356537	2206900	2141312	150600	2291912	2511132	spneumo-pangenome.S_greedytigs.k_25.d_na.M_default
spneumo-pangenome	greedytigs	25	na	ones	8607254	11286309	9652061	1634248	70288	70228	11356537	2206900	2141312	172228	2313540	2511292	spneumo-pangenome.S_greedytigs.k_25.d_na.M_ones
spneumo-pangenome	greedytigs	25	na	runs	8607254	11286309	9651965	1634344	70228	70228	11356537	2206900	2141312	172036	2313348	2511432	spneumo-pangenome.S_greedytigs.k_25.d_na.M_runs
spneumo-pangenome	greedytigs	25	na	zeros	8607254	11286309	8607254	2679055	178095	70228	11356537	2206900	2141312	334908	2476220	2836852	spneumo-pangenome.S_greedytigs.k_25.d_na.M_zeros
spneumo-pangenome	eulertigs	26	na	default	8779295	12825820	8779295	4046525	161861	161861	12987681	2788808	2640612	236360	2876972	3273436	spneumo-pangenome.S_eulertigs.k_26.d_na.M_default
spneumo-pangenome	eulertigs	26	na	ones	8779295	12825820	8900422	3925398	162014	161861	12987681	2788808	2640612	290220	2930832	3282492	spneumo-pangenome.S_eulertigs.k_26.d_na.M_ones
spneumo-pangenome	eulertigs	26	na	runs	8779295	12825820	8899977	3925843	161767	161861	12987681	2788808	2640612	290008	2930620	3282276	spneumo-pangenome.S_eulertigs.k_26.d_na.M_runs
spneumo-pangenome	eulertigs	26	na	zeros	8779295	12825820	8779295	4046525	228366	161861	12987681	2788808	2640612	384224	3024836	3389260	spneumo-pangenome.S_eulertigs.k_26.d_na.M_zeros
spneumo-pangenome	greedytigs	26	na	default	8779295	11540493	9823393	1717100	68684	68684	11609177	2274408	2199948	150308	2350256	2565388	spneumo-pangenome.S_greedytigs.k_26.d_na.M_default
spneumo-pangenome	greedytigs	26	na	ones	8779295	11540493	9873214	1667279	68738	68684	11609177	2274408	2199948	171856	2371804	2564860	spneumo-pangenome.S_greedytigs.k_26.d_na.M_ones
spneumo-pangenome	greedytigs	26	na	runs	8779295	11540493	9873136	1667357	68683	68684	11609177	2274408	2199948	171692	2371640	2565196	spneumo-pangenome.S_greedytigs.k_26.d_na.M_runs
spneumo-pangenome	greedytigs	26	na	zeros	8779295	11540493	8779295	2761198	191411	68684	11609177	2274408	2199948	379740	2579688	2928368	spneumo-pangenome.S_greedytigs.k_26.d_na.M_zeros
spneumo-pangenome	eulertigs	27	na	default	8950801	12977499	8950801	4026698	154873	154873	13132372	2655988	2536224	232404	2768628	3235920	spneumo-pangenome.S_eulertigs.k_27.d_na.M_default
spneumo-pangenome	eulertigs	27	na	ones	8950801	12977499	9065144	3912355	155042	154873	13132372	2655988	2536224	284604	2820828	3246096	spneumo-pangenome.S_eulertigs.k_27.d_na.M_ones
spneumo-pangenome	eulertigs	27	na	runs	8950801	12977499	9064829	3912670	154834	154873	13132372	2655988	2536224	284168	2820392	3246612	spneumo-pangenome.S_eulertigs.k_27.d_na.M_runs
spneumo-pangenome	eulertigs	27	na	zeros	8950801	12977499	8950801	4026698	185903	154873	13132372	2655988	2536224	312808	2849032	3298568	spneumo-pangenome.S_eulertigs.k_27.d_na.M_zeros
spneumo-pangenome	greedytigs	27	na	default	8950801	11757359	9982417	1774942	68267	68267	11825626	2287216	2212716	150360	2363076	2586852	spneumo-pangenome.S_greedytigs.k_27.d_na.M_default
spneumo-pangenome	greedytigs	27	na	ones	8950801	11757359	10031478	1725881	68307	68267	11825626	2287216	2212716	171940	2384656	2587400	spneumo-pangenome.S_greedytigs.k_27.d_na.M_ones
spneumo-pangenome	greedytigs	27	na	runs	8950801	11757359	10031416	1725943	68266	68267	11825626	2287216	2212716	171812	2384528	2587508	spneumo-pangenome.S_greedytigs.k_27.d_na.M_runs
spneumo-pangenome	greedytigs	27	na	zeros	8950801	11757359	8950801	2806558	185137	68267	11825626	2287216	2212716	375780	2588496	2943128	spneumo-pangenome.S_greedytigs.k_27.d_na.M_zeros
spneumo-pangenome	eulertigs	28	na	default	9120914	13449446	9120914	4328532	160316	160316	13609762	2818252	2673972	241416	2915388	3360192	spneumo-pangenome.S_eulertigs.k_28.d_na.M_default
spneumo-pangenome	eulertigs	28	na	ones	9120914	13449446	9238784	4210662	160467	160316	13609762	2818252	2673972	295396	2969368	3368876	spneumo-pangenome.S_eulertigs.k_28.d_na.M_ones
spneumo-pangenome	eulertigs	28	na	runs	9120914	13449446	9238403	4211043	160252	160316	13609762	2818252	2673972	295076	2969048	3368376	spneumo-pangenome.S_eulertigs.k_28.d_na.M_runs
spneumo-pangenome	eulertigs	28	na	zeros	9120914	13449446	9120914	4328532	222215	160316	13609762	2818252	2673972	382432	3056404	3472592	spneumo-pangenome.S_eulertigs.k_28.d_na.M_zeros
spneumo-pangenome	greedytigs	28	na	default	9120914	12059439	10238262	1821177	67451	67451	12126890	2250596	2187656	151340	2338996	2580488	spneumo-pangenome.S_greedytigs.k_28.d_na.M_default
spneumo-pangenome	greedytigs	28	na	ones	9120914	12059439	10287071	1772368	67491	67451	12126890	2250596	2187656	172592	2360248	2580968	spneumo-pangenome.S_greedytigs.k_28.d_na.M_ones
spneumo-pangenome	greedytigs	28	na	runs	9120914	12059439	10287018	1772421	67451	67451	12126890	2250596	2187656	172484	2360140	2581140	spneumo-pangenome.S_greedytigs.k_28.d_na.M_runs
spneumo-pangenome	greedytigs	28	na	zeros	9120914	12059439	9120914	2938525	175927	67451	12126890	2250596	2187656	344116	2531772	2934272	spneumo-pangenome.S_greedytigs.k_28.d_na.M_zeros
spneumo-pangenome	eulertigs	29	na	default	9290605	13774693	9290605	4484088	160146	160146	13934839	2841516	2697712	243796	2941508	3403204	spneumo-pangenome.S_eulertigs.k_29.d_na.M_default
spneumo-pangenome	eulertigs	29	na	ones	9290605	13774693	9409807	4364886	160267	160146	13934839	2841516	2697712	298968	2996680	3411472	spneumo-pangenome.S_eulertigs.k_29.d_na.M_ones
spneumo-pangenome	eulertigs	29	na	runs	9290605	13774693	9409401	4365292	160059	160146	13934839	2841516	2697712	298776	2996488	3411380	spneumo-pangenome.S_eulertigs.k_29.d_na.M_runs
spneumo-pangenome	eulertigs	29	na	zeros	9290605	13774693	9290605	4484088	221812	160146	13934839	2841516	2697712	387136	3084848	3516864	spneumo-pangenome.S_eulertigs.k_29.d_na.M_zeros
spneumo-pangenome	greedytigs	29	na	default	9290605	12299017	10447573	1851444	66123	66123	12365140	2261008	2197052	150732	2347784	2598732	spneumo-pangenome.S_greedytigs.k_29.d_na.M_default
spneumo-pangenome	greedytigs	29	na	ones	9290605	12299017	10495487	1803530	66159	66123	12365140	2261008	2197052	171576	2368628	2599556	spneumo-pangenome.S_greedytigs.k_29.d_na.M_ones
spneumo-pangenome	greedytigs	29	na	runs	9290605	12299017	10495442	1803575	66123	66123	12365140	2261008	2197052	171468	2368520	2599652	spneumo-pangenome.S_greedytigs.k_29.d_na.M_runs
spneumo-pangenome	greedytigs	29	na	zeros	9290605	12299017	9290605	3008412	176395	66123	12365140	2261008	2197052	352752	2549804	2969388	spneumo-pangenome.S_greedytigs.k_29.d_na.M_zeros
spneumo-pangenome	eulertigs	30	na	default	9459820	13902359	9459820	4442539	153191	153191	14055550	2755700	2627956	239640	2867596	3371276	spneumo-pangenome.S_eulertigs.k_30.d_na.M_default
spneumo-pangenome	eulertigs	30	na	ones	9459820	13902359	9572973	4329386	153324	153191	14055550	2755700	2627956	292988	2920944	3381544	spneumo-pangenome.S_eulertigs.k_30.d_na.M_ones
spneumo-pangenome	eulertigs	30	na	runs	9459820	13902359	9572730	4329629	153164	153191	14055550	2755700	2627956	292700	2920656	3381436	spneumo-pangenome.S_eulertigs.k_30.d_na.M_runs
spneumo-pangenome	eulertigs	30	na	zeros	9459820	13902359	9459820	4442539	194640	153191	14055550	2755700	2627956	343340	2971296	3456560	spneumo-pangenome.S_eulertigs.k_30.d_na.M_zeros
spneumo-pangenome	greedytigs	30	na	default	9459820	12526963	10632973	1893990	65310	65310	12592273	2320964	2249612	151188	2400800	2648984	spneumo-pangenome.S_greedytigs.k_30.d_na.M_default
spneumo-pangenome	greedytigs	30	na	ones	9459820	12526963	10680475	1846488	65363	65310	12592273	2320964	2249612	172208	2421820	2647896	spneumo-pangenome.S_greedytigs.k_30.d_na.M_ones
spneumo-pangenome	greedytigs	30	na	runs	9459820	12526963	10680404	1846559	65310	65310	12592273	2320964	2249612	172068	2421680	2648088	spneumo-pangenome.S_greedytigs.k_30.d_na.M_runs
spneumo-pangenome	greedytigs	30	na	zeros	9459820	12526963	9459820	3067143	182466	65310	12592273	2320964	2249612	383024	2632636	3032864	spneumo-pangenome.S_greedytigs.k_30.d_na.M_zeros
spneumo-pangenome	eulertigs	31	na	default	9627755	14382545	9627755	4754790	158493	158493	14541038	2799912	2674828	248452	2923280	3448680	spneumo-pangenome.S_eulertigs.k_31.d_na.M_default
spneumo-pangenome	eulertigs	31	na	ones	9627755	14382545	9744603	4637942	158625	158493	14541038	2799912	2674828	303904	2978732	3461384	spneumo-pangenome.S_eulertigs.k_31.d_na.M_ones
spneumo-pangenome	eulertigs	31	na	runs	9627755	14382545	9744290	4638255	158435	158493	14541038	2799912	2674828	303588	2978416	3460368	spneumo-pangenome.S_eulertigs.k_31.d_na.M_runs
spneumo-pangenome	eulertigs	31	na	zeros	9627755	14382545	9627755	4754790	197552	158493	14541038	2799912	2674828	345384	3020212	3523912	spneumo-pangenome.S_eulertigs.k_31.d_na.M_zeros
spneumo-pangenome	greedytigs	31	na	default	9627755	12832096	10892236	1939860	64662	64662	12896758	2336044	2264524	151672	2416196	2672176	spneumo-pangenome.S_greedytigs.k_31.d_na.M_default
spneumo-pangenome	greedytigs	31	na	ones	9627755	12832096	10939246	1892850	64704	64662	12896758	2336044	2264524	172496	2437020	2671832	spneumo-pangenome.S_greedytigs.k_31.d_na.M_ones
spneumo-pangenome	greedytigs	31	na	runs	9627755	12832096	10939184	1892912	64662	64662	12896758	2336044	2264524	172384	2436908	2671768	spneumo-pangenome.S_greedytigs.k_31.d_na.M_runs
spneumo-pangenome	greedytigs	31	na	zeros	9627755	12832096	9627755	3204341	185893	64662	12896758	2336044	2264524	392380	2656904	3079788	spneumo-pangenome.S_greedytigs.k_31.d_na.M_zeros
spneumoniae	eulertigs	11	na	default	1004213	1906113	1004213	901900	90190	90190	1996303	576540	512032	74712	586744	638056	spneumoniae.S_eulertigs.k_11.d_na.M_default
spneumoniae	eulertigs	11	na	ones	1004213	1906113	1517315	388798	172099	90190	1996303	576540	512032	162616	674648	674900	spneumoniae.S_eulertigs.k_11.d_na.M_ones
spneumoniae	eulertigs	11	na	runs	1004213	1906113	1308325	597788	81775	90190	1996303	576540	512032	111184	623216	628016	spneumoniae.S_eulertigs.k_11.d_na.M_runs
spneumoniae	eulertigs	11	na	zeros	1004213	1906113	1004213	901900	323041	90190	1996303	576540	512032	241216	753248	749908	spneumoniae.S_eulertigs.k_11.d_na.M_zeros
spneumoniae	greedytigs	11	na	default	1004213	1278881	1273201	5680	568	568	1279449	344384	346484	2544	349028	345428	spneumoniae.S_greedytigs.k_11.d_na.M_default
spneumoniae	greedytigs	11	na	ones	1004213	1278881	1275046	3835	1243	568	1279449	344384	346484	3344	349828	345520	spneumoniae.S_greedytigs.k_11.d_na.M_ones
spneumoniae	greedytigs	11	na	runs	1004213	1278881	1273655	5226	568	568	1279449	344384	346484	2620	349104	345048	spneumoniae.S_greedytigs.k_11.d_na.M_runs
spneumoniae	greedytigs	11	na	zeros	1004213	1278881	1004213	274668	162648	568	1279449	344384	346484	127172	473656	471008	spneumoniae.S_greedytigs.k_11.d_na.M_zeros
spneumoniae	eulertigs	12	na	default	1585876	2992270	1585876	1406394	127854	127854	3120124	884168	789028	113532	902560	968496	spneumoniae.S_eulertigs.k_12.d_na.M_default
spneumoniae	eulertigs	12	na	ones	1585876	2992270	2143736	848534	266609	127854	3120124	884168	789028	263752	1052780	1062868	spneumoniae.S_eulertigs.k_12.d_na.M_ones
spneumoniae	eulertigs	12	na	runs	1585876	2992270	1860434	1131836	123025	127854	3120124	884168	789028	168416	957444	967600	spneumoniae.S_eulertigs.k_12.d_na.M_runs
spneumoniae	eulertigs	12	na	zeros	1585876	2992270	1585876	1406394	304096	127854	3120124	884168	789028	283676	1072704	1093200	spneumoniae.S_eulertigs.k_12.d_na.M_zeros
spneumoniae	greedytigs	12	na	default	1585876	1976482	1965493	10989	999	999	1977481	521880	520620	4260	524880	522468	spneumoniae.S_greedytigs.k_12.d_na.M_default
spneumoniae	greedytigs	12	na	ones	1585876	1976482	1967935	8547	1913	999	1977481	521880	520620	5488	526108	522568	spneumoniae.S_greedytigs.k_12.d_na.M_ones
spneumoniae	greedytigs	12	na	runs	1585876	1976482	1966458	10024	999	999	1977481	521880	520620	4464	525084	523016	spneumoniae.S_greedytigs.k_12.d_na.M_runs
spneumoniae	greedytigs	12	na	zeros	1585876	1976482	1585876	390606	186525	999	1977481	521880	520620	171900	692520	692924	spneumoniae.S_greedytigs.k_12.d_na.M_zeros
spneumoniae	eulertigs	13	na	default	1917960	2955672	1917960	1037712	86476	86476	3042148	841844	767700	99412	867112	914724	spneumoniae.S_eulertigs.k_13.d_na.M_default
spneumoniae	eulertigs	13	na	ones	1917960	2955672	2167984	787688	159939	86476	3042148	841844	767700	196080	963780	976760	spneumoniae.S_eulertigs.k_13.d_na.M_ones
spneumoniae	eulertigs	13	na	runs	1917960	2955672	2041879	913793	85196	86476	3042148	841844	767700	131668	899368	912824	spneumoniae.S_eulertigs.k_13.d_na.M_runs
spneumoniae	eulertigs	13	na	zeros	1917960	2955672	1917960	1037712	174095	86476	3042148	841844	767700	208584	976284	996628	spneumoniae.S_eulertigs.k_13.d_na.M_zeros
spneumoniae	greedytigs	13	na	default	1917960	2160295	2140723	19572	1631	1631	2161926	566648	563812	6380	570192	569084	spneumoniae.S_greedytigs.k_13.d_na.M_default
spneumoniae	greedytigs	13	na	ones	1917960	2160295	2143836	16459	2686	1631	2161926	566648	563812	8100	571912	569832	spneumoniae.S_greedytigs.k_13.d_na.M_ones
spneumoniae	greedytigs	13	na	runs	1917960	2160295	2142239	18056	1631	1631	2161926	566648	563812	6676	570488	569184	spneumoniae.S_greedytigs.k_13.d_na.M_runs
spneumoniae	greedytigs	13	na	zeros	1917960	2160295	1917960	242335	113989	1631	2161926	566648	563812	133644	697456	692224	spneumoniae.S_greedytigs.k_13.d_na.M_zeros
spneumoniae	matchtigs	13	na	default	1917960	2109714	2095290	14424	1202	1202	2110916	554984	552840	4936	557776	556648	spneumoniae.S_matchtigs.k_13.d_na.M_default
spneumoniae	matchtigs	13	na	ones	1917960	2109714	2097763	11951	1991	1202	2110916	554984	552840	6272	559112	556816	spneumoniae.S_matchtigs.k_13.d_na.M_ones
spneumoniae	matchtigs	13	na	runs	1917960	2109714	2096536	13178	1202	1202	2110916	554984	552840	5224	558064	555908	spneumoniae.S_matchtigs.k_13.d_na.M_runs
spneumoniae	matchtigs	13	na	zeros	1917960	2109714	1917960	191754	104333	1202	2110916	554984	552840	120900	673740	666592	spneumoniae.S_matchtigs.k_13.d_na.M_zeros
spneumoniae	eulertigs	14	na	default	2052085	2551493	2052085	499408	38416	38416	2589909	700444	662564	63120	725684	742916	spneumoniae.S_eulertigs.k_14.d_na.M_default
spneumoniae	eulertigs	14	na	ones	2052085	2551493	2123361	428132	56353	38416	2589909	700444	662564	96324	758888	759788	spneumoniae.S_eulertigs.k_14.d_na.M_ones
spneumoniae	eulertigs	14	na	runs	2052085	2551493	2095496	455997	38204	38416	2589909	700444	662564	74820	737384	741876	spneumoniae.S_eulertigs.k_14.d_na.M_runs
spneumoniae	eulertigs	14	na	zeros	2052085	2551493	2052085	499408	63832	38416	2589909	700444	662564	106308	768872	771920	spneumoniae.S_eulertigs.k_14.d_na.M_zeros
spneumoniae	greedytigs	14	na	default	2052085	2145521	2129765	15756	1212	1212	2146733	562140	560240	4932	565172	563968	spneumoniae.S_greedytigs.k_14.d_na.M_default
spneumoniae	greedytigs	14	na	ones	2052085	2145521	2131596	13925	1658	1212	2146733	562140	560240	5940	566180	564544	spneumoniae.S_greedytigs.k_14.d_na.M_ones
spneumoniae	greedytigs	14	na	runs	2052085	2145521	2130911	14610	1206	1212	2146733	562140	560240	5204	565444	564024	spneumoniae.S_greedytigs.k_14.d_na.M_runs
spneumoniae	greedytigs	14	na	zeros	2052085	2145521	2052085	93436	44462	1212	2146733	562140	560240	73268	633508	620304	spneumoniae.S_greedytigs.k_14.d_na.M_zeros
spneumoniae	matchtigs	14	na	default	2052085	2131759	2120124	11635	895	895	2132654	558780	557072	3784	560856	560368	spneumoniae.S_matchtigs.k_14.d_na.M_default
spneumoniae	matchtigs	14	na	ones	2052085	2131759	2121245	10514	1173	895	2132654	558780	557072	4540	561612	560796	spneumoniae.S_matchtigs.k_14.d_na.M_ones
spneumoniae	matchtigs	14	na	runs	2052085	2131759	2120855	10904	895	895	2132654	558780	557072	4012	561084	560212	spneumoniae.S_matchtigs.k_14.d_na.M_runs
spneumoniae	matchtigs	14	na	zeros	2052085	2131759	2052085	79674	42073	895	2132654	558780	557072	69504	626576	613432	spneumoniae.S_matchtigs.k_14.d_na.M_zeros
spneumoniae	eulertigs	15	na	default	2098151	2301585	2098151	203434	14531	14531	2316116	615636	598940	33536	632476	636212	spneumoniae.S_eulertigs.k_15.d_na.M_default
spneumoniae	eulertigs	15	na	ones	2098151	2301585	2117257	184328	17487	14531	2316116	615636	598940	41948	640888	638584	spneumoniae.S_eulertigs.k_15.d_na.M_ones
spneumoniae	eulertigs	15	na	runs	2098151	2301585	2112943	188642	14498	14531	2316116	615636	598940	37340	636280	635836	spneumoniae.S_eulertigs.k_15.d_na.M_runs
spneumoniae	eulertigs	15	na	zeros	2098151	2301585	2098151	203434	21025	14531	2316116	615636	598940	49088	648028	645200	spneumoniae.S_eulertigs.k_15.d_na.M_zeros
spneumoniae	greedytigs	15	na	default	2098151	2137391	2126345	11046	789	789	2138180	558892	557520	3368	560888	560760	spneumoniae.S_greedytigs.k_15.d_na.M_default
spneumoniae	greedytigs	15	na	ones	2098151	2137391	2127154	10237	872	789	2138180	558892	557520	3800	561320	560956	spneumoniae.S_greedytigs.k_15.d_na.M_ones
spneumoniae	greedytigs	15	na	runs	2098151	2137391	2127032	10359	789	789	2138180	558892	557520	3588	561108	560592	spneumoniae.S_greedytigs.k_15.d_na.M_runs
spneumoniae	greedytigs	15	na	zeros	2098151	2137391	2098151	39240	15622	789	2138180	558892	557520	37092	594612	584612	spneumoniae.S_greedytigs.k_15.d_na.M_zeros
spneumoniae	matchtigs	15	na	default	2098151	2134981	2123837	11144	796	796	2135777	558304	557204	3328	560532	560076	spneumoniae.S_matchtigs.k_15.d_na.M_default
spneumoniae	matchtigs	15	na	ones	2098151	2134981	2124592	10389	869	796	2135777	558304	557204	3724	560928	559916	spneumoniae.S_matchtigs.k_15.d_na.M_ones
spneumoniae	matchtigs	15	na	runs	2098151	2134981	2124491	10490	796	796	2135777	558304	557204	3572	560776	559592	spneumoniae.S_matchtigs.k_15.d_na.M_runs
spneumoniae	matchtigs	15	na	zeros	2098151	2134981	2098151	36830	15560	796	2135777	558304	557204	36660	593864	582836	spneumoniae.S_matchtigs.k_15.d_na.M_zeros
spneumoniae	eulertigs	16	na	default	2114070	2203590	2114070	89520	5968	5968	2209558	582824	574476	16736	591212	592824	spneumoniae.S_eulertigs.k_16.d_na.M_default
spneumoniae	eulertigs	16	na	ones	2114070	2203590	2120326	83264	6403	5968	2209558	582824	574476	19196	593672	592616	spneumoniae.S_eulertigs.k_16.d_na.M_ones
spneumoniae	eulertigs	16	na	runs	2114070	2203590	2119684	83906	5964	5968	2209558	582824	574476	18304	592780	592200	spneumoniae.S_eulertigs.k_16.d_na.M_runs
spneumoniae	eulertigs	16	na	zeros	2114070	2203590	2114070	89520	8770	5968	2209558	582824	574476	25060	599536	596592	spneumoniae.S_eulertigs.k_16.d_na.M_zeros
spneumoniae	greedytigs	16	na	default	2114070	2139103	2128543	10560	704	704	2139807	557464	557548	2972	560520	559640	spneumoniae.S_greedytigs.k_16.d_na.M_default
spneumoniae	greedytigs	16	na	ones	2114070	2139103	2129174	9929	736	704	2139807	557464	557548	3232	560780	559828	spneumoniae.S_greedytigs.k_16.d_na.M_ones
spneumoniae	greedytigs	16	na	runs	2114070	2139103	2129128	9975	704	704	2139807	557464	557548	3140	560688	560240	spneumoniae.S_greedytigs.k_16.d_na.M_runs
spneumoniae	greedytigs	16	na	zeros	2114070	2139103	2114070	25033	6457	704	2139807	557464	557548	19216	576764	570632	spneumoniae.S_greedytigs.k_16.d_na.M_zeros
spneumoniae	matchtigs	16	na	default	2114070	2137844	2126369	11475	765	765	2138609	557732	557280	3120	560400	560208	spneumoniae.S_matchtigs.k_16.d_na.M_default
spneumoniae	matchtigs	16	na	ones	2114070	2137844	2127019	10825	788	765	2138609	557732	557280	3384	560664	559800	spneumoniae.S_matchtigs.k_16.d_na.M_ones
spneumoniae	matchtigs	16	na	runs	2114070	2137844	2126985	10859	765	765	2138609	557732	557280	3332	560612	559800	spneumoniae.S_matchtigs.k_16.d_na.M_runs
spneumoniae	matchtigs	16	na	zeros	2114070	2137844	2114070	23774	6370	765	2138609	557732	557280	18884	576164	570120	spneumoniae.S_matchtigs.k_16.d_na.M_zeros
spneumoniae	eulertigs	17	na	default	2120449	2171537	2120449	51088	3193	3193	2174730	570052	565708	9520	575228	574940	spneumoniae.S_eulertigs.k_17.d_na.M_default
spneumoniae	eulertigs	17	na	ones	2120449	2171537	2123312	48225	3258	3193	2174730	570052	565708	10472	576180	575568	spneumoniae.S_eulertigs.k_17.d_na.M_ones
spneumoniae	eulertigs	17	na	runs	2120449	2171537	2123216	48321	3190	3193	2174730	570052	565708	10312	576020	575512	spneumoniae.S_eulertigs.k_17.d_na.M_runs
spneumoniae	eulertigs	17	na	zeros	2120449	2171537	2120449	51088	4046	3193	2174730	570052	565708	12296	578004	576948	spneumoniae.S_eulertigs.k_17.d_na.M_zeros
spneumoniae	greedytigs	17	na	default	2120449	2141246	2130702	10544	659	659	2141905	557768	557460	2768	560228	560464	spneumoniae.S_greedytigs.k_17.d_na.M_default
spneumoniae	greedytigs	17	na	ones	2120449	2141246	2131215	10031	667	659	2141905	557768	557460	2996	560456	559540	spneumoniae.S_greedytigs.k_17.d_na.M_ones
spneumoniae	greedytigs	17	na	runs	2120449	2141246	2131204	10042	659	659	2141905	557768	557460	2972	560432	559448	spneumoniae.S_greedytigs.k_17.d_na.M_runs
spneumoniae	greedytigs	17	na	zeros	2120449	2141246	2120449	20797	3512	659	2141905	557768	557460	11384	568844	565684	spneumoniae.S_greedytigs.k_17.d_na.M_zeros
spneumoniae	matchtigs	17	na	default	2120449	2140106	2128442	11664	729	729	2140835	557896	557224	2896	560120	560216	spneumoniae.S_matchtigs.k_17.d_na.M_default
spneumoniae	matchtigs	17	na	ones	2120449	2140106	2129019	11087	737	729	2140835	557896	557224	3136	560360	559988	spneumoniae.S_matchtigs.k_17.d_na.M_ones
spneumoniae	matchtigs	17	na	runs	2120449	2140106	2129008	11098	729	729	2140835	557896	557224	3108	560332	559940	spneumoniae.S_matchtigs.k_17.d_na.M_runs
spneumoniae	matchtigs	17	na	zeros	2120449	2140106	2120449	19657	3475	729	2140835	557896	557224	11048	568272	565476	spneumoniae.S_matchtigs.k_17.d_na.M_zeros
spneumoniae	eulertigs	18	na	default	2123906	2160405	2123906	36499	2147	2147	2162552	565444	562492	6416	568908	570344	spneumoniae.S_eulertigs.k_18.d_na.M_default
spneumoniae	eulertigs	18	na	ones	2123906	2160405	2125704	34701	2169	2147	2162552	565444	562492	7096	569588	570196	spneumoniae.S_eulertigs.k_18.d_na.M_ones
spneumoniae	eulertigs	18	na	runs	2123906	2160405	2125676	34729	2145	2147	2162552	565444	562492	7048	569540	570248	spneumoniae.S_eulertigs.k_18.d_na.M_runs
spneumoniae	eulertigs	18	na	zeros	2123906	2160405	2123906	36499	3066	2147	2162552	565444	562492	9120	571612	571812	spneumoniae.S_eulertigs.k_18.d_na.M_zeros
spneumoniae	greedytigs	18	na	default	2123906	2143437	2132761	10676	628	628	2144065	558416	556776	2656	559432	559628	spneumoniae.S_greedytigs.k_18.d_na.M_default
spneumoniae	greedytigs	18	na	ones	2123906	2143437	2133250	10187	632	628	2144065	558416	556776	2832	559608	559560	spneumoniae.S_greedytigs.k_18.d_na.M_ones
spneumoniae	greedytigs	18	na	runs	2123906	2143437	2133245	10192	628	628	2144065	558416	556776	2824	559600	559952	spneumoniae.S_greedytigs.k_18.d_na.M_runs
spneumoniae	greedytigs	18	na	zeros	2123906	2143437	2123906	19531	2412	628	2144065	558416	556776	7836	564612	563940	spneumoniae.S_greedytigs.k_18.d_na.M_zeros
spneumoniae	matchtigs	18	na	default	2123906	2142247	2130602	11645	685	685	2142932	558044	557140	2764	559904	560312	spneumoniae.S_matchtigs.k_18.d_na.M_default
spneumoniae	matchtigs	18	na	ones	2123906	2142247	2131189	11058	695	685	2142932	558044	557140	2996	560136	560220	spneumoniae.S_matchtigs.k_18.d_na.M_ones
spneumoniae	matchtigs	18	na	runs	2123906	2142247	2131176	11071	685	685	2142932	558044	557140	2972	560112	560600	spneumoniae.S_matchtigs.k_18.d_na.M_runs
spneumoniae	matchtigs	18	na	zeros	2123906	2142247	2123906	18341	2422	685	2142932	558044	557140	7820	564960	564208	spneumoniae.S_matchtigs.k_18.d_na.M_zeros
spneumoniae	eulertigs	19	na	default	2126360	2160632	2126360	34272	1904	1904	2162536	564492	562388	5432	567820	568808	spneumoniae.S_eulertigs.k_19.d_na.M_default
spneumoniae	eulertigs	19	na	ones	2126360	2160632	2127931	32701	1918	1904	2162536	564492	562388	6036	568424	568956	spneumoniae.S_eulertigs.k_19.d_na.M_ones
spneumoniae	eulertigs	19	na	runs	2126360	2160632	2127908	32724	1902	1904	2162536	564492	562388	6008	568396	568900	spneumoniae.S_eulertigs.k_19.d_na.M_runs
spneumoniae	eulertigs	19	na	zeros	2126360	2160632	2126360	34272	2506	1904	2162536	564492	562388	7216	569604	570304	spneumoniae.S_eulertigs.k_19.d_na.M_zeros
spneumoniae	greedytigs	19	na	default	2126360	2146222	2135368	10854	603	603	2146825	557696	557536	2576	560112	559568	spneumoniae.S_greedytigs.k_19.d_na.M_default
spneumoniae	greedytigs	19	na	ones	2126360	2146222	2135829	10393	610	603	2146825	557696	557536	2764	560300	559968	spneumoniae.S_greedytigs.k_19.d_na.M_ones
spneumoniae	greedytigs	19	na	runs	2126360	2146222	2135817	10405	603	603	2146825	557696	557536	2744	560280	560192	spneumoniae.S_greedytigs.k_19.d_na.M_runs
spneumoniae	greedytigs	19	na	zeros	2126360	2146222	2126360	19862	2183	603	2146825	557696	557536	6868	564404	564672	spneumoniae.S_greedytigs.k_19.d_na.M_zeros
spneumoniae	matchtigs	19	na	default	2126360	2144974	2133166	11808	656	656	2145630	557308	556332	2716	559048	559820	spneumoniae.S_matchtigs.k_19.d_na.M_default
spneumoniae	matchtigs	19	na	ones	2126360	2144974	2133695	11279	660	656	2145630	557308	556332	2936	559268	560360	spneumoniae.S_matchtigs.k_19.d_na.M_ones
spneumoniae	matchtigs	19	na	runs	2126360	2144974	2133689	11285	656	656	2145630	557308	556332	2920	559252	560108	spneumoniae.S_matchtigs.k_19.d_na.M_runs
spneumoniae	matchtigs	19	na	zeros	2126360	2144974	2126360	18614	2147	656	2145630	557308	556332	6700	563032	563476	spneumoniae.S_matchtigs.k_19.d_na.M_zeros
spneumoniae	eulertigs	20	na	default	2128471	2161949	2128471	33478	1762	1762	2163711	564200	561484	4920	566404	568668	spneumoniae.S_eulertigs.k_20.d_na.M_default
spneumoniae	eulertigs	20	na	ones	2128471	2161949	2129937	32012	1767	1762	2163711	564200	561484	5472	566956	568572	spneumoniae.S_eulertigs.k_20.d_na.M_ones
spneumoniae	eulertigs	20	na	runs	2128471	2161949	2129917	32032	1757	1762	2163711	564200	561484	5456	566940	568360	spneumoniae.S_eulertigs.k_20.d_na.M_runs
spneumoniae	eulertigs	20	na	zeros	2128471	2161949	2128471	33478	2333	1762	2163711	564200	561484	6620	568104	569616	spneumoniae.S_eulertigs.k_20.d_na.M_zeros
spneumoniae	greedytigs	20	na	default	2128471	2148298	2137563	10735	565	565	2148863	557952	556764	2468	559232	559824	spneumoniae.S_greedytigs.k_20.d_na.M_default
spneumoniae	greedytigs	20	na	ones	2128471	2148298	2137990	10308	567	565	2148863	557952	556764	2636	559400	559912	spneumoniae.S_greedytigs.k_20.d_na.M_ones
spneumoniae	greedytigs	20	na	runs	2128471	2148298	2137987	10311	565	565	2148863	557952	556764	2632	559396	559920	spneumoniae.S_greedytigs.k_20.d_na.M_runs
spneumoniae	greedytigs	20	na	zeros	2128471	2148298	2128471	19827	2026	565	2148863	557952	556764	6336	563100	563740	spneumoniae.S_greedytigs.k_20.d_na.M_zeros
spneumoniae	matchtigs	20	na	default	2128471	2147036	2135275	11761	619	619	2147655	557868	556804	2616	559420	559960	spneumoniae.S_matchtigs.k_20.d_na.M_default
spneumoniae	matchtigs	20	na	ones	2128471	2147036	2135745	11291	627	619	2147655	557868	556804	2812	559616	560020	spneumoniae.S_matchtigs.k_20.d_na.M_ones
spneumoniae	matchtigs	20	na	runs	2128471	2147036	2135736	11300	619	619	2147655	557868	556804	2792	559596	560004	spneumoniae.S_matchtigs.k_20.d_na.M_runs
spneumoniae	matchtigs	20	na	zeros	2128471	2147036	2128471	18565	2017	619	2147655	557868	556804	6176	562980	563404	spneumoniae.S_matchtigs.k_20.d_na.M_zeros
spneumoniae	eulertigs	21	na	default	2130395	2161875	2130395	31480	1574	1574	2163449	562736	560448	4504	564952	567232	spneumoniae.S_eulertigs.k_21.d_na.M_default
spneumoniae	eulertigs	21	na	ones	2130395	2161875	2131657	30218	1582	1574	2163449	562736	560448	5012	565460	567032	spneumoniae.S_eulertigs.k_21.d_na.M_ones
spneumoniae	eulertigs	21	na	runs	2130395	2161875	2131638	30237	1572	1574	2163449	562736	560448	4980	565428	567152	spneumoniae.S_eulertigs.k_21.d_na.M_runs
spneumoniae	eulertigs	21	na	zeros	2130395	2161875	2130395	31480	1942	1574	2163449	562736	560448	5660	566108	567888	spneumoniae.S_eulertigs.k_21.d_na.M_zeros
spneumoniae	greedytigs	21	na	default	2130395	2150073	2139313	10760	538	538	2150611	557296	556500	2396	558896	559376	spneumoniae.S_greedytigs.k_21.d_na.M_default
spneumoniae	greedytigs	21	na	ones	2130395	2150073	2139671	10402	538	538	2150611	557296	556500	2572	559072	559152	spneumoniae.S_greedytigs.k_21.d_na.M_ones
spneumoniae	greedytigs	21	na	runs	2130395	2150073	2139671	10402	538	538	2150611	557296	556500	2572	559072	559152	spneumoniae.S_greedytigs.k_21.d_na.M_runs
spneumoniae	greedytigs	21	na	zeros	2130395	2150073	2130395	19678	1771	538	2150611	557296	556500	5708	562208	563268	spneumoniae.S_greedytigs.k_21.d_na.M_zeros
spneumoniae	matchtigs	21	na	default	2130395	2148831	2137251	11580	579	579	2149410	558232	557152	2472	559624	560032	spneumoniae.S_matchtigs.k_21.d_na.M_default
spneumoniae	matchtigs	21	na	ones	2130395	2148831	2137678	11153	582	579	2149410	558232	557152	2656	559808	559964	spneumoniae.S_matchtigs.k_21.d_na.M_ones
spneumoniae	matchtigs	21	na	runs	2130395	2148831	2137674	11157	579	579	2149410	558232	557152	2648	559800	559900	spneumoniae.S_matchtigs.k_21.d_na.M_runs
spneumoniae	matchtigs	21	na	zeros	2130395	2148831	2130395	18436	1825	579	2149410	558232	557152	5852	563004	563156	spneumoniae.S_matchtigs.k_21.d_na.M_zeros
spneumoniae	eulertigs	22	na	default	2132198	2165063	2132198	32865	1565	1565	2166628	563168	560932	4384	565316	567236	spneumoniae.S_eulertigs.k_22.d_na.M_default
spneumoniae	eulertigs	22	na	ones	2132198	2165063	2133427	31636	1572	1565	2166628	563168	560932	4920	565852	567704	spneumoniae.S_eulertigs.k_22.d_na.M_ones
spneumoniae	eulertigs	22	na	runs	2132198	2165063	2133403	31660	1562	1565	2166628	563168	560932	4904	565836	567664	spneumoniae.S_eulertigs.k_22.d_na.M_runs
spneumoniae	eulertigs	22	na	zeros	2132198	2165063	2132198	32865	1949	1565	2166628	563168	560932	5644	566576	568308	spneumoniae.S_eulertigs.k_22.d_na.M_zeros
spneumoniae	greedytigs	22	na	default	2132198	2152279	2142157	10122	482	482	2152761	557132	556628	2252	558880	559340	spneumoniae.S_greedytigs.k_22.d_na.M_default
spneumoniae	greedytigs	22	na	ones	2132198	2152279	2142552	9727	484	482	2152761	557132	556628	2376	559004	559584	spneumoniae.S_greedytigs.k_22.d_na.M_ones
spneumoniae	greedytigs	22	na	runs	2132198	2152279	2142548	9731	482	482	2152761	557132	556628	2372	559000	559512	spneumoniae.S_greedytigs.k_22.d_na.M_runs
spneumoniae	greedytigs	22	na	zeros	2132198	2152279	2132198	20081	1787	482	2152761	557132	556628	5704	562332	563408	spneumoniae.S_greedytigs.k_22.d_na.M_zeros
spneumoniae	matchtigs	22	na	default	2132198	2150816	2139686	11130	530	530	2151346	558016	557312	2380	559692	559908	spneumoniae.S_matchtigs.k_22.d_na.M_default
spneumoniae	matchtigs	22	na	ones	2132198	2150816	2140085	10731	535	530	2151346	558016	557312	2540	559852	560096	spneumoniae.S_matchtigs.k_22.d_na.M_ones
spneumoniae	matchtigs	22	na	runs	2132198	2150816	2140080	10736	530	530	2151346	558016	557312	2528	559840	560264	spneumoniae.S_matchtigs.k_22.d_na.M_runs
spneumoniae	matchtigs	22	na	zeros	2132198	2150816	2132198	18618	1741	530	2151346	558016	557312	5496	562808	563364	spneumoniae.S_matchtigs.k_22.d_na.M_zeros
spneumoniae	eulertigs	23	na	default	2133906	2167544	2133906	33638	1529	1529	2169073	562820	561036	4388	565424	567584	spneumoniae.S_eulertigs.k_23.d_na.M_default
spneumoniae	eulertigs	23	na	ones	2133906	2167544	2135071	32473	1533	1529	2169073	562820	561036	4916	565952	567424	spneumoniae.S_eulertigs.k_23.d_na.M_ones
spneumoniae	eulertigs	23	na	runs	2133906	2167544	2135065	32479	1529	1529	2169073	562820	561036	4912	565948	567440	spneumoniae.S_eulertigs.k_23.d_na.M_runs
spneumoniae	eulertigs	23	na	zeros	2133906	2167544	2133906	33638	1841	1529	2169073	562820	561036	5384	566420	568620	spneumoniae.S_eulertigs.k_23.d_na.M_zeros
spneumoniae	greedytigs	23	na	default	2133906	2153817	2143983	9834	447	447	2154264	557616	557032	2144	559176	559304	spneumoniae.S_greedytigs.k_23.d_na.M_default
spneumoniae	greedytigs	23	na	ones	2133906	2153817	2144327	9490	449	447	2154264	557616	557032	2268	559300	559324	spneumoniae.S_greedytigs.k_23.d_na.M_ones
spneumoniae	greedytigs	23	na	runs	2133906	2153817	2144325	9492	447	447	2154264	557616	557032	2268	559300	559168	spneumoniae.S_greedytigs.k_23.d_na.M_runs
spneumoniae	greedytigs	23	na	zeros	2133906	2153817	2133906	19911	1732	447	2154264	557616	557032	5616	562648	563172	spneumoniae.S_greedytigs.k_23.d_na.M_zeros
spneumoniae	matchtigs	23	na	default	2133906	2152408	2141540	10868	494	494	2152902	558008	556788	2292	559080	559616	spneumoniae.S_matchtigs.k_23.d_na.M_default
spneumoniae	matchtigs	23	na	ones	2133906	2152408	2141916	10492	495	494	2152902	558008	556788	2448	559236	559760	spneumoniae.S_matchtigs.k_23.d_na.M_ones
spneumoniae	matchtigs	23	na	runs	2133906	2152408	2141915	10493	494	494	2152902	558008	556788	2448	559236	559812	spneumoniae.S_matchtigs.k_23.d_na.M_runs
spneumoniae	matchtigs	23	na	zeros	2133906	2152408	2133906	18502	1741	494	2152902	558008	556788	5528	562316	562868	spneumoniae.S_matchtigs.k_23.d_na.M_zeros
spneumoniae	eulertigs	24	na	default	2135557	2166768	2135557	31211	1357	1357	2168125	561748	560620	4120	564740	566844	spneumoniae.S_eulertigs.k_24.d_na.M_default
spneumoniae	eulertigs	24	na	ones	2135557	2166768	2136709	30059	1359	1357	2168125	561748	560620	4608	565228	566784	spneumoniae.S_eulertigs.k_24.d_na.M_ones
spneumoniae	eulertigs	24	na	runs	2135557	2166768	2136707	30061	1357	1357	2168125	561748	560620	4604	565224	566832	spneumoniae.S_eulertigs.k_24.d_na.M_runs
spneumoniae	eulertigs	24	na	zeros	2135557	2166768	2135557	31211	1686	1357	2168125	561748	560620	5172	565792	567552	spneumoniae.S_eulertigs.k_24.d_na.M_zeros
spneumoniae	greedytigs	24	na	default	2135557	2154880	2144806	10074	438	438	2155318	557348	556772	2128	558900	559584	spneumoniae.S_greedytigs.k_24.d_na.M_default
spneumoniae	greedytigs	24	na	ones	2135557	2154880	2145080	9800	440	438	2155318	557348	556772	2268	559040	559544	spneumoniae.S_greedytigs.k_24.d_na.M_ones
spneumoniae	greedytigs	24	na	runs	2135557	2154880	2145078	9802	438	438	2155318	557348	556772	2260	559032	559492	spneumoniae.S_greedytigs.k_24.d_na.M_runs
spneumoniae	greedytigs	24	na	zeros	2135557	2154880	2135557	19323	1553	438	2155318	557348	556772	5336	562108	562948	spneumoniae.S_greedytigs.k_24.d_na.M_zeros
spneumoniae	matchtigs	24	na	default	2135557	2153830	2142813	11017	479	479	2154309	557720	557508	2264	559772	561752	spneumoniae.S_matchtigs.k_24.d_na.M_default
spneumoniae	matchtigs	24	na	ones	2135557	2153830	2143163	10667	479	479	2154309	557720	557508	2420	559928	559716	spneumoniae.S_matchtigs.k_24.d_na.M_ones
spneumoniae	matchtigs	24	na	runs	2135557	2153830	2143163	10667	479	479	2154309	557720	557508	2420	559928	559716	spneumoniae.S_matchtigs.k_24.d_na.M_runs
spneumoniae	matchtigs	24	na	zeros	2135557	2153830	2135557	18273	1561	479	2154309	557720	557508	5188	562696	562852	spneumoniae.S_matchtigs.k_24.d_na.M_zeros
spneumoniae	eulertigs	25	na	default	2137099	2170099	2137099	33000	1375	1375	2171474	562972	561044	4140	565184	567356	spneumoniae.S_eulertigs.k_25.d_na.M_default
spneumoniae	eulertigs	25	na	ones	2137099	2170099	2138149	31950	1379	1375	2171474	562972	561044	4576	565620	567432	spneumoniae.S_eulertigs.k_25.d_na.M_ones
spneumoniae	eulertigs	25	na	runs	2137099	2170099	2138138	31961	1371	1375	2171474	562972	561044	4576	565620	567536	spneumoniae.S_eulertigs.k_25.d_na.M_runs
spneumoniae	eulertigs	25	na	zeros	2137099	2170099	2137099	33000	1705	1375	2171474	562972	561044	5132	566176	567944	spneumoniae.S_eulertigs.k_25.d_na.M_zeros
spneumoniae	greedytigs	25	na	default	2137099	2156814	2146710	10104	421	421	2157235	557380	557268	2064	559332	559608	spneumoniae.S_greedytigs.k_25.d_na.M_default
spneumoniae	greedytigs	25	na	ones	2137099	2156814	2147002	9812	423	421	2157235	557380	557268	2220	559488	559468	spneumoniae.S_greedytigs.k_25.d_na.M_ones
spneumoniae	greedytigs	25	na	runs	2137099	2156814	2147000	9814	421	421	2157235	557380	557268	2208	559476	559492	spneumoniae.S_greedytigs.k_25.d_na.M_runs
spneumoniae	greedytigs	25	na	zeros	2137099	2156814	2137099	19715	1550	421	2157235	557380	557268	5284	562552	563504	spneumoniae.S_greedytigs.k_25.d_na.M_zeros
spneumoniae	matchtigs	25	na	default	2137099	2155629	2144589	11040	460	460	2156089	558340	557320	2204	559524	559660	spneumoniae.S_matchtigs.k_25.d_na.M_default
spneumoniae	matchtigs	25	na	ones	2137099	2155629	2144915	10714	462	460	2156089	558340	557320	2316	559636	560196	spneumoniae.S_matchtigs.k_25.d_na.M_ones
spneumoniae	matchtigs	25	na	runs	2137099	2155629	2144912	10717	460	460	2156089	558340	557320	2312	559632	560224	spneumoniae.S_matchtigs.k_25.d_na.M_runs
spneumoniae	matchtigs	25	na	zeros	2137099	2155629	2137099	18530	1495	460	2156089	558340	557320	4968	562288	563044	spneumoniae.S_matchtigs.k_25.d_na.M_zeros
spneumoniae	eulertigs	26	na	default	2138599	2172399	2138599	33800	1352	1352	2173751	562904	561788	4072	565860	568336	spneumoniae.S_eulertigs.k_26.d_na.M_default
spneumoniae	eulertigs	26	na	ones	2138599	2172399	2139630	32769	1355	1352	2173751	562904	561788	4528	566316	568196	spneumoniae.S_eulertigs.k_26.d_na.M_ones
spneumoniae	eulertigs	26	na	runs	2138599	2172399	2139626	32773	1351	1352	2173751	562904	561788	4516	566304	568344	spneumoniae.S_eulertigs.k_26.d_na.M_runs
spneumoniae	eulertigs	26	na	zeros	2138599	2172399	2138599	33800	1772	1352	2173751	562904	561788	5356	567144	568836	spneumoniae.S_eulertigs.k_26.d_na.M_zeros
spneumoniae	greedytigs	26	na	default	2138599	2158290	2148315	9975	399	399	2158689	557592	556788	2024	558812	559400	spneumoniae.S_greedytigs.k_26.d_na.M_default
spneumoniae	greedytigs	26	na	ones	2138599	2158290	2148595	9695	399	399	2158689	557592	556788	2148	558936	559592	spneumoniae.S_greedytigs.k_26.d_na.M_ones
spneumoniae	greedytigs	26	na	runs	2138599	2158290	2148595	9695	399	399	2158689	557592	556788	2148	558936	559592	spneumoniae.S_greedytigs.k_26.d_na.M_runs
spneumoniae	greedytigs	26	na	zeros	2138599	2158290	2138599	19691	1522	399	2158689	557592	556788	5212	562000	563000	spneumoniae.S_greedytigs.k_26.d_na.M_zeros
spneumoniae	matchtigs	26	na	default	2138599	2156984	2146084	10900	436	436	2157420	557864	556940	2088	559028	560292	spneumoniae.S_matchtigs.k_26.d_na.M_default
spneumoniae	matchtigs	26	na	ones	2138599	2156984	2146423	10561	437	436	2157420	557864	556940	2248	559188	559568	spneumoniae.S_matchtigs.k_26.d_na.M_ones
spneumoniae	matchtigs	26	na	runs	2138599	2156984	2146422	10562	436	436	2157420	557864	556940	2244	559184	559512	spneumoniae.S_matchtigs.k_26.d_na.M_runs
spneumoniae	matchtigs	26	na	zeros	2138599	2156984	2138599	18385	1554	436	2157420	557864	556940	5180	562120	563468	spneumoniae.S_matchtigs.k_26.d_na.M_zeros
spneumoniae	eulertigs	27	na	default	2140040	2171994	2140040	31954	1229	1229	2173223	562632	560516	3896	564412	566880	spneumoniae.S_eulertigs.k_27.d_na.M_default
spneumoniae	eulertigs	27	na	ones	2140040	2171994	2140971	31023	1235	1229	2173223	562632	560516	4372	564888	567032	spneumoniae.S_eulertigs.k_27.d_na.M_ones
spneumoniae	eulertigs	27	na	runs	2140040	2171994	2140960	31034	1229	1229	2173223	562632	560516	4352	564868	567032	spneumoniae.S_eulertigs.k_27.d_na.M_runs
spneumoniae	eulertigs	27	na	zeros	2140040	2171994	2140040	31954	1507	1229	2173223	562632	560516	4832	565348	567452	spneumoniae.S_eulertigs.k_27.d_na.M_zeros
spneumoniae	greedytigs	27	na	default	2140040	2159093	2149109	9984	384	384	2159477	558032	557424	1980	559404	559272	spneumoniae.S_greedytigs.k_27.d_na.M_default
spneumoniae	greedytigs	27	na	ones	2140040	2159093	2149375	9718	386	384	2159477	558032	557424	2104	559528	559616	spneumoniae.S_greedytigs.k_27.d_na.M_ones
spneumoniae	greedytigs	27	na	runs	2140040	2159093	2149372	9721	384	384	2159477	558032	557424	2100	559524	559704	spneumoniae.S_greedytigs.k_27.d_na.M_runs
spneumoniae	greedytigs	27	na	zeros	2140040	2159093	2140040	19053	1381	384	2159477	558032	557424	4860	562284	563244	spneumoniae.S_greedytigs.k_27.d_na.M_zeros
spneumoniae	matchtigs	27	na	default	2140040	2158141	2147507	10634	409	409	2158550	558016	557196	2052	559248	560304	spneumoniae.S_matchtigs.k_27.d_na.M_default
spneumoniae	matchtigs	27	na	ones	2140040	2158141	2147809	10332	409	409	2158550	558016	557196	2176	559372	560180	spneumoniae.S_matchtigs.k_27.d_na.M_ones
spneumoniae	matchtigs	27	na	runs	2140040	2158141	2147809	10332	409	409	2158550	558016	557196	2176	559372	560180	spneumoniae.S_matchtigs.k_27.d_na.M_runs
spneumoniae	matchtigs	27	na	zeros	2140040	2158141	2140040	18101	1417	409	2158550	558016	557196	4928	562124	563192	spneumoniae.S_matchtigs.k_27.d_na.M_zeros
spneumoniae	eulertigs	28	na	default	2141411	2174459	2141411	33048	1224	1224	2175683	562780	560884	3796	564680	567492	spneumoniae.S_eulertigs.k_28.d_na.M_default
spneumoniae	eulertigs	28	na	ones	2141411	2174459	2142352	32107	1231	1224	2175683	562780	560884	4304	565188	567324	spneumoniae.S_eulertigs.k_28.d_na.M_ones
spneumoniae	eulertigs	28	na	runs	2141411	2174459	2142337	32122	1222	1224	2175683	562780	560884	4280	565164	567572	spneumoniae.S_eulertigs.k_28.d_na.M_runs
spneumoniae	eulertigs	28	na	zeros	2141411	2174459	2141411	33048	1524	1224	2175683	562780	560884	4828	565712	568232	spneumoniae.S_eulertigs.k_28.d_na.M_zeros
spneumoniae	greedytigs	28	na	default	2141411	2160558	2150811	9747	361	361	2160919	557332	556344	1860	558204	558880	spneumoniae.S_greedytigs.k_28.d_na.M_default
spneumoniae	greedytigs	28	na	ones	2141411	2160558	2151071	9487	361	361	2160919	557332	556344	1972	558316	558708	spneumoniae.S_greedytigs.k_28.d_na.M_ones
spneumoniae	greedytigs	28	na	runs	2141411	2160558	2151071	9487	361	361	2160919	557332	556344	1972	558316	558708	spneumoniae.S_greedytigs.k_28.d_na.M_runs
spneumoniae	greedytigs	28	na	zeros	2141411	2160558	2141411	19147	1324	361	2160919	557332	556344	4704	561048	562628	spneumoniae.S_greedytigs.k_28.d_na.M_zeros
spneumoniae	matchtigs	28	na	default	2141411	2159447	2148890	10557	391	391	2159838	557408	556904	1960	558864	560296	spneumoniae.S_matchtigs.k_28.d_na.M_default
spneumoniae	matchtigs	28	na	ones	2141411	2159447	2149143	10304	392	391	2159838	557408	556904	2080	558984	560376	spneumoniae.S_matchtigs.k_28.d_na.M_ones
spneumoniae	matchtigs	28	na	runs	2141411	2159447	2149142	10305	391	391	2159838	557408	556904	2076	558980	560312	spneumoniae.S_matchtigs.k_28.d_na.M_runs
spneumoniae	matchtigs	28	na	zeros	2141411	2159447	2141411	18036	1307	391	2159838	557408	556904	4636	561540	562992	spneumoniae.S_matchtigs.k_28.d_na.M_zeros
spneumoniae	eulertigs	29	na	default	2142734	2176222	2142734	33488	1196	1196	2177418	562980	561712	3796	565508	567496	spneumoniae.S_eulertigs.k_29.d_na.M_default
spneumoniae	eulertigs	29	na	ones	2142734	2176222	2143594	32628	1199	1196	2177418	562980	561712	4180	565892	567976	spneumoniae.S_eulertigs.k_29.d_na.M_ones
spneumoniae	eulertigs	29	na	runs	2142734	2176222	2143588	32634	1196	1196	2177418	562980	561712	4172	565884	568000	spneumoniae.S_eulertigs.k_29.d_na.M_runs
spneumoniae	eulertigs	29	na	zeros	2142734	2176222	2142734	33488	1519	1196	2177418	562980	561712	4820	566532	568260	spneumoniae.S_eulertigs.k_29.d_na.M_zeros
spneumoniae	greedytigs	29	na	default	2142734	2161770	2152082	9688	346	346	2162116	557688	557188	1800	558988	560164	spneumoniae.S_greedytigs.k_29.d_na.M_default
spneumoniae	greedytigs	29	na	ones	2142734	2161770	2152337	9433	348	346	2162116	557688	557188	1912	559100	560264	spneumoniae.S_greedytigs.k_29.d_na.M_ones
spneumoniae	greedytigs	29	na	runs	2142734	2161770	2152334	9436	346	346	2162116	557688	557188	1912	559100	560484	spneumoniae.S_greedytigs.k_29.d_na.M_runs
spneumoniae	greedytigs	29	na	zeros	2142734	2161770	2142734	19036	1374	346	2162116	557688	557188	4892	562080	563672	spneumoniae.S_greedytigs.k_29.d_na.M_zeros
spneumoniae	matchtigs	29	na	default	2142734	2160543	2150043	10500	375	375	2160918	557368	558424	1940	560364	559892	spneumoniae.S_matchtigs.k_29.d_na.M_default
spneumoniae	matchtigs	29	na	ones	2142734	2160543	2150272	10271	376	375	2160918	557368	558424	2040	560464	559804	spneumoniae.S_matchtigs.k_29.d_na.M_ones
spneumoniae	matchtigs	29	na	runs	2142734	2160543	2150270	10273	375	375	2160918	557368	558424	2036	560460	559988	spneumoniae.S_matchtigs.k_29.d_na.M_runs
spneumoniae	matchtigs	29	na	zeros	2142734	2160543	2142734	17809	1319	375	2160918	557368	558424	4676	563100	562712	spneumoniae.S_matchtigs.k_29.d_na.M_zeros
spneumoniae	eulertigs	30	na	default	2144020	2175717	2144020	31697	1093	1093	2176810	562628	561164	3600	564764	566976	spneumoniae.S_eulertigs.k_30.d_na.M_default
spneumoniae	eulertigs	30	na	ones	2144020	2175717	2144835	30882	1100	1093	2176810	562628	561164	3980	565144	567360	spneumoniae.S_eulertigs.k_30.d_na.M_ones
spneumoniae	eulertigs	30	na	runs	2144020	2175717	2144828	30889	1093	1093	2176810	562628	561164	3972	565136	567352	spneumoniae.S_eulertigs.k_30.d_na.M_runs
spneumoniae	eulertigs	30	na	zeros	2144020	2175717	2144020	31697	1425	1093	2176810	562628	561164	4764	565928	568200	spneumoniae.S_eulertigs.k_30.d_na.M_zeros
spneumoniae	greedytigs	30	na	default	2144020	2162688	2153089	9599	331	331	2163019	557308	556540	1796	558336	558968	spneumoniae.S_greedytigs.k_30.d_na.M_default
spneumoniae	greedytigs	30	na	ones	2144020	2162688	2153325	9363	331	331	2163019	557308	556540	1892	558432	559076	spneumoniae.S_greedytigs.k_30.d_na.M_ones
spneumoniae	greedytigs	30	na	runs	2144020	2162688	2153325	9363	331	331	2163019	557308	556540	1892	558432	559076	spneumoniae.S_greedytigs.k_30.d_na.M_runs
spneumoniae	greedytigs	30	na	zeros	2144020	2162688	2144020	18668	1195	331	2163019	557308	556540	4528	561068	562504	spneumoniae.S_greedytigs.k_30.d_na.M_zeros
spneumoniae	matchtigs	30	na	default	2144020	2161568	2151244	10324	356	356	2161924	557696	557696	1888	559584	559420	spneumoniae.S_matchtigs.k_30.d_na.M_default
spneumoniae	matchtigs	30	na	ones	2144020	2161568	2151480	10088	356	356	2161924	557696	557696	1984	559680	559920	spneumoniae.S_matchtigs.k_30.d_na.M_ones
spneumoniae	matchtigs	30	na	runs	2144020	2161568	2151480	10088	356	356	2161924	557696	557696	1984	559680	559920	spneumoniae.S_matchtigs.k_30.d_na.M_runs
spneumoniae	matchtigs	30	na	zeros	2144020	2161568	2144020	17548	1217	356	2161924	557696	557696	4512	562208	562728	spneumoniae.S_matchtigs.k_30.d_na.M_zeros
spneumoniae	eulertigs	31	na	default	2145215	2177435	2145215	32220	1074	1074	2178509	561884	560396	3604	564000	566636	spneumoniae.S_eulertigs.k_31.d_na.M_default
spneumoniae	eulertigs	31	na	ones	2145215	2177435	2146046	31389	1079	1074	2178509	561884	560396	3988	564384	566832	spneumoniae.S_eulertigs.k_31.d_na.M_ones
spneumoniae	eulertigs	31	na	runs	2145215	2177435	2146041	31394	1074	1074	2178509	561884	560396	3976	564372	567280	spneumoniae.S_eulertigs.k_31.d_na.M_runs
spneumoniae	eulertigs	31	na	zeros	2145215	2177435	2145215	32220	1317	1074	2178509	561884	560396	4432	564828	567192	spneumoniae.S_eulertigs.k_31.d_na.M_zeros
spneumoniae	greedytigs	31	na	default	2145215	2163669	2154489	9180	306	306	2163975	557300	557404	1704	559108	559420	spneumoniae.S_greedytigs.k_31.d_na.M_default
spneumoniae	greedytigs	31	na	ones	2145215	2163669	2154706	8963	309	306	2163975	557300	557404	1800	559204	560284	spneumoniae.S_greedytigs.k_31.d_na.M_ones
spneumoniae	greedytigs	31	na	runs	2145215	2163669	2154702	8967	306	306	2163975	557300	557404	1792	559196	559940	spneumoniae.S_greedytigs.k_31.d_na.M_runs
spneumoniae	greedytigs	31	na	zeros	2145215	2163669	2145215	18454	1207	306	2163975	557300	557404	4516	561920	563320	spneumoniae.S_greedytigs.k_31.d_na.M_zeros
spneumoniae	matchtigs	31	na	default	2145215	2162693	2152373	10320	344	344	2163037	557624	557180	1812	558992	559928	spneumoniae.S_matchtigs.k_31.d_na.M_default
spneumoniae	matchtigs	31	na	ones	2145215	2162693	2152623	10070	346	344	2163037	557624	557180	1940	559120	559756	spneumoniae.S_matchtigs.k_31.d_na.M_ones
spneumoniae	matchtigs	31	na	runs	2145215	2162693	2152618	10075	344	344	2163037	557624	557180	1936	559116	559644	spneumoniae.S_matchtigs.k_31.d_na.M_runs
spneumoniae	matchtigs	31	na	zeros	2145215	2162693	2145215	17478	1218	344	2163037	557624	557180	4544	561724	562924	spneumoniae.S_matchtigs.k_31.d_na.M_zeros
yeast	eulertigs	11	na	default	1865531	2579781	1865531	714250	71425	71425	2651206	754584	697464	80952	778416	810948	yeast.S_eulertigs.k_11.d_na.M_default
yeast	eulertigs	11	na	ones	1865531	2579781	2399143	180638	114293	71425	2651206	754584	697464	127792	825256	804156	yeast.S_eulertigs.k_11.d_na.M_ones
yeast	eulertigs	11	na	runs	1865531	2579781	2239411	340370	58437	71425	2651206	754584	697464	102796	800260	787976	yeast.S_eulertigs.k_11.d_na.M_runs
yeast	eulertigs	11	na	zeros	1865531	2579781	1865531	714250	232178	71425	2651206	754584	697464	224180	921644	925476	yeast.S_eulertigs.k_11.d_na.M_zeros
yeast	greedytigs	11	na	default	1865531	2086085	2083515	2570	257	257	2086342	570536	569668	1560	571228	570396	yeast.S_greedytigs.k_11.d_na.M_default
yeast	greedytigs	11	na	ones	1865531	2086085	2084813	1272	681	257	2086342	570536	569668	2092	571760	567740	yeast.S_greedytigs.k_11.d_na.M_ones
yeast	greedytigs	11	na	runs	1865531	2086085	2083740	2345	257	257	2086342	570536	569668	1620	571288	569748	yeast.S_greedytigs.k_11.d_na.M_runs
yeast	greedytigs	11	na	zeros	1865531	2086085	1865531	220554	128715	257	2086342	570536	569668	134464	704132	692232	yeast.S_greedytigs.k_11.d_na.M_zeros
yeast	eulertigs	12	na	default	4774876	9131932	4774876	4357056	396096	396096	9528028	2729676	2459204	331432	2790636	2973992	yeast.S_eulertigs.k_12.d_na.M_default
yeast	eulertigs	12	na	ones	4774876	9131932	7433290	1698642	811408	396096	9528028	2729676	2459204	753304	3212508	3182736	yeast.S_eulertigs.k_12.d_na.M_ones
yeast	eulertigs	12	na	runs	4774876	9131932	6301003	2830929	357315	396096	9528028	2729676	2459204	514592	2973796	2963620	yeast.S_eulertigs.k_12.d_na.M_runs
yeast	eulertigs	12	na	zeros	4774876	9131932	4774876	4357056	1096146	396096	9528028	2729676	2459204	927364	3386568	3403240	yeast.S_eulertigs.k_12.d_na.M_zeros
yeast	greedytigs	12	na	default	4774876	5968183	5955533	12650	1150	1150	5969333	1598076	1594688	5872	1600560	1603572	yeast.S_greedytigs.k_12.d_na.M_default
yeast	greedytigs	12	na	ones	4774876	5968183	5958747	9436	2665	1150	5969333	1598076	1594688	7560	1602248	1600572	yeast.S_greedytigs.k_12.d_na.M_ones
yeast	greedytigs	12	na	runs	4774876	5968183	5956173	12010	1150	1150	5969333	1598076	1594688	6032	1600720	1597492	yeast.S_greedytigs.k_12.d_na.M_runs
yeast	greedytigs	12	na	zeros	4774876	5968183	4774876	1193307	597604	1150	5969333	1598076	1594688	513556	2108244	2100732	yeast.S_greedytigs.k_12.d_na.M_zeros
yeast	eulertigs	13	na	default	8043635	16052639	8043635	8009004	667417	667417	16720056	4703720	4194144	584392	4778536	5148028	yeast.S_eulertigs.k_13.d_na.M_default
yeast	eulertigs	13	na	ones	8043635	16052639	11592588	4460051	1533064	667417	16720056	4703720	4194144	1444660	5638804	5692216	yeast.S_eulertigs.k_13.d_na.M_ones
yeast	eulertigs	13	na	runs	8043635	16052639	9688308	6364331	638616	667417	16720056	4703720	4194144	895364	5089508	5147332	yeast.S_eulertigs.k_13.d_na.M_runs
yeast	eulertigs	13	na	zeros	8043635	16052639	8043635	8009004	1766232	667417	16720056	4703720	4194144	1580568	5774712	5865724	yeast.S_eulertigs.k_13.d_na.M_zeros
yeast	greedytigs	13	na	default	8043635	10065367	10027987	37380	3115	3115	10068482	2639488	2632752	14008	2646760	2643360	yeast.S_greedytigs.k_13.d_na.M_default
yeast	greedytigs	13	na	ones	8043635	10065367	10035224	30143	6180	3115	10068482	2639488	2632752	17788	2650540	2645592	yeast.S_greedytigs.k_13.d_na.M_ones
yeast	greedytigs	13	na	runs	8043635	10065367	10030503	34864	3115	3115	10068482	2639488	2632752	14576	2647328	2642784	yeast.S_greedytigs.k_13.d_na.M_runs
yeast	greedytigs	13	na	zeros	8043635	10065367	8043635	2021732	1015844	3115	10068482	2639488	2632752	890300	3523052	3533012	yeast.S_greedytigs.k_13.d_na.M_zeros
yeast	eulertigs	14	na	default	10095869	16634388	10095869	6538519	502963	502963	17137351	4716060	4302072	555688	4857760	5115444	yeast.S_eulertigs.k_14.d_na.M_default
yeast	eulertigs	14	na	ones	10095869	16634388	11985214	4649174	1059591	502963	17137351	4716060	4302072	1204072	5506144	5558172	yeast.S_eulertigs.k_14.d_na.M_ones
yeast	eulertigs	14	na	runs	10095869	16634388	10944288	5690100	492579	502963	17137351	4716060	4302072	749452	5051524	5106920	yeast.S_eulertigs.k_14.d_na.M_runs
yeast	eulertigs	14	na	zeros	10095869	16634388	10095869	6538519	1240308	502963	17137351	4716060	4302072	1341340	5643412	5713316	yeast.S_eulertigs.k_14.d_na.M_zeros
yeast	greedytigs	14	na	default	10095869	11535739	11458922	76817	5909	5909	11541648	3006048	2992928	23900	3016828	3014964	yeast.S_greedytigs.k_14.d_na.M_default
yeast	greedytigs	14	na	ones	10095869	11535739	11470565	65174	10094	5909	11541648	3006048	2992928	30172	3023100	3017012	yeast.S_greedytigs.k_14.d_na.M_ones
yeast	greedytigs	14	na	runs	10095869	11535739	11464271	71468	5907	5909	11541648	3006048	2992928	25128	3018056	3014592	yeast.S_greedytigs.k_14.d_na.M_runs
yeast	greedytigs	14	na	zeros	10095869	11535739	10095869	1439870	713506	5909	11541648	3006048	2992928	770440	3763368	3739364	yeast.S_greedytigs.k_14.d_na.M_zeros
yeast	eulertigs	15	na	default	10976114	14288178	10976114	3312064	236576	236576	14524754	3910020	3690112	368148	4058260	4151784	yeast.S_eulertigs.k_15.d_na.M_default
yeast	eulertigs	15	na	ones	10976114	14288178	11581537	2706641	405235	236576	14524754	3910020	3690112	625136	4315248	4323196	yeast.S_eulertigs.k_15.d_na.M_ones
yeast	eulertigs	15	na	runs	10976114	14288178	11296732	2991446	234203	236576	14524754	3910020	3690112	444092	4134204	4146928	yeast.S_eulertigs.k_15.d_na.M_runs
yeast	eulertigs	15	na	zeros	10976114	14288178	10976114	3312064	511051	236576	14524754	3910020	3690112	749352	4439464	4442932	yeast.S_eulertigs.k_15.d_na.M_zeros
yeast	greedytigs	15	na	default	10976114	11589441	11518209	71232	5088	5088	11594529	3018412	3007512	21188	3028700	3027136	yeast.S_greedytigs.k_15.d_na.M_default
yeast	greedytigs	15	na	ones	10976114	11589441	11525976	63465	7227	5088	11594529	3018412	3007512	25372	3032884	3028404	yeast.S_greedytigs.k_15.d_na.M_ones
yeast	greedytigs	15	na	runs	10976114	11589441	11522793	66648	5081	5088	11594529	3018412	3007512	22388	3029900	3026160	yeast.S_greedytigs.k_15.d_na.M_runs
yeast	greedytigs	15	na	zeros	10976114	11589441	10976114	613327	288950	5088	11594529	3018412	3007512	443200	3450712	3384980	yeast.S_greedytigs.k_15.d_na.M_zeros
yeast	matchtigs	15	na	default	10976114	11463047	11416903	46144	3296	3296	11466343	2986004	2979292	14452	2993744	2991568	yeast.S_matchtigs.k_15.d_na.M_default
yeast	matchtigs	15	na	ones	10976114	11463047	11421510	41537	4532	3296	11466343	2986004	2979292	17336	2996628	2992256	yeast.S_matchtigs.k_15.d_na.M_ones
yeast	matchtigs	15	na	runs	10976114	11463047	11419694	43353	3296	3296	11466343	2986004	2979292	15312	2994604	2990468	yeast.S_matchtigs.k_15.d_na.M_runs
yeast	matchtigs	15	na	zeros	10976114	11463047	10976114	486933	278187	3296	11466343	2986004	2979292	412452	3391744	3323912	yeast.S_matchtigs.k_15.d_na.M_zeros
yeast	eulertigs	16	na	default	11294786	12692201	11294786	1397415	93161	93161	12785362	3385404	3284636	202408	3487044	3507052	yeast.S_eulertigs.k_16.d_na.M_default
yeast	eulertigs	16	na	ones	11294786	12692201	11471513	1220688	129770	93161	12785362	3385404	3284636	279256	3563892	3549004	yeast.S_eulertigs.k_16.d_na.M_ones
yeast	eulertigs	16	na	runs	11294786	12692201	11410500	1281701	92608	93161	12785362	3385404	3284636	229344	3513980	3504316	yeast.S_eulertigs.k_16.d_na.M_runs
yeast	eulertigs	16	na	zeros	11294786	12692201	11294786	1397415	179642	93161	12785362	3385404	3284636	365792	3650428	3617128	yeast.S_eulertigs.k_16.d_na.M_zeros
yeast	greedytigs	16	na	default	11294786	11538377	11488817	49560	3304	3304	11541681	2999420	2993936	14256	3008192	3006532	yeast.S_greedytigs.k_16.d_na.M_default
yeast	greedytigs	16	na	ones	11294786	11538377	11492509	45868	3954	3304	11541681	2999420	2993936	16304	3010240	3007284	yeast.S_greedytigs.k_16.d_na.M_ones
yeast	greedytigs	16	na	runs	11294786	11538377	11491505	46872	3301	3304	11541681	2999420	2993936	15148	3009084	3006584	yeast.S_greedytigs.k_16.d_na.M_runs
yeast	greedytigs	16	na	zeros	11294786	11538377	11294786	243591	102938	3304	11541681	2999420	2993936	228224	3222160	3157996	yeast.S_greedytigs.k_16.d_na.M_zeros
yeast	matchtigs	16	na	default	11294786	11513227	11468302	44925	2995	2995	11516222	2994764	2988644	12896	3001540	3001592	yeast.S_matchtigs.k_16.d_na.M_default
yeast	matchtigs	16	na	ones	11294786	11513227	11471261	41966	3412	2995	11516222	2994764	2988644	14476	3003120	3001344	yeast.S_matchtigs.k_16.d_na.M_ones
yeast	matchtigs	16	na	runs	11294786	11513227	11470671	42556	2995	2995	11516222	2994764	2988644	13660	3002304	3000804	yeast.S_matchtigs.k_16.d_na.M_runs
yeast	matchtigs	16	na	zeros	11294786	11513227	11294786	218441	104194	2995	11516222	2994764	2988644	221800	3210444	3147780	yeast.S_matchtigs.k_16.d_na.M_zeros
yeast	eulertigs	17	na	default	11409525	12024069	11409525	614544	38409	38409	12062478	3161868	3114368	103796	3218164	3223520	yeast.S_eulertigs.k_17.d_na.M_default
yeast	eulertigs	17	na	ones	11409525	12024069	11472570	551499	47343	38409	12062478	3161868	3114368	128440	3242808	3231664	yeast.S_eulertigs.k_17.d_na.M_ones
yeast	eulertigs	17	na	runs	11409525	12024069	11456728	567341	38201	38409	12062478	3161868	3114368	114488	3228856	3221944	yeast.S_eulertigs.k_17.d_na.M_runs
yeast	eulertigs	17	na	zeros	11409525	12024069	11409525	614544	68365	38409	12062478	3161868	3114368	177284	3291652	3264332	yeast.S_eulertigs.k_17.d_na.M_zeros
yeast	greedytigs	17	na	default	11409525	11546010	11501722	44288	2768	2768	11548778	2997932	2991056	11684	3002740	3003384	yeast.S_greedytigs.k_17.d_na.M_default
yeast	greedytigs	17	na	ones	11409525	11546010	11504037	41973	2942	2768	11548778	2997932	2991056	12820	3003876	3002196	yeast.S_greedytigs.k_17.d_na.M_ones
yeast	greedytigs	17	na	runs	11409525	11546010	11503784	42226	2768	2768	11548778	2997932	2991056	12452	3003508	3003392	yeast.S_greedytigs.k_17.d_na.M_runs
yeast	greedytigs	17	na	zeros	11409525	11546010	11409525	136485	42120	2768	11548778	2997932	2991056	117708	3108764	3072164	yeast.S_greedytigs.k_17.d_na.M_zeros
yeast	matchtigs	17	na	default	11409525	11535580	11491356	44224	2764	2764	11538344	2993428	2990160	11452	3001612	3001868	yeast.S_matchtigs.k_17.d_na.M_default
yeast	matchtigs	17	na	ones	11409525	11535580	11493551	42029	2901	2764	11538344	2993428	2990160	12452	3002612	3001448	yeast.S_matchtigs.k_17.d_na.M_ones
yeast	matchtigs	17	na	runs	11409525	11535580	11493354	42226	2764	2764	11538344	2993428	2990160	12128	3002288	3001996	yeast.S_matchtigs.k_17.d_na.M_runs
yeast	matchtigs	17	na	zeros	11409525	11535580	11409525	126055	42019	2764	11538344	2993428	2990160	116444	3106604	3070324	yeast.S_matchtigs.k_17.d_na.M_zeros
yeast	eulertigs	18	na	default	11456651	11769485	11456651	312834	18402	18402	11787887	3072504	3047636	54780	3102416	3106552	yeast.S_eulertigs.k_18.d_na.M_default
yeast	eulertigs	18	na	ones	11456651	11769485	11485740	283745	21676	18402	11787887	3072504	3047636	65532	3113168	3109132	yeast.S_eulertigs.k_18.d_na.M_ones
yeast	eulertigs	18	na	runs	11456651	11769485	11479034	290451	18288	18402	11787887	3072504	3047636	60104	3107740	3105068	yeast.S_eulertigs.k_18.d_na.M_runs
yeast	eulertigs	18	na	zeros	11456651	11769485	11456651	312834	31777	18402	11787887	3072504	3047636	91420	3139056	3126404	yeast.S_eulertigs.k_18.d_na.M_zeros
yeast	greedytigs	18	na	default	11456651	11556223	11511632	44591	2623	2623	11558846	2992856	2988520	10648	2999168	3001324	yeast.S_greedytigs.k_18.d_na.M_default
yeast	greedytigs	18	na	ones	11456651	11556223	11513584	42639	2702	2623	11558846	2992856	2988520	11560	3000080	3000376	yeast.S_greedytigs.k_18.d_na.M_ones
yeast	greedytigs	18	na	runs	11456651	11556223	11513479	42744	2623	2623	11558846	2992856	2988520	11360	2999880	3000664	yeast.S_greedytigs.k_18.d_na.M_runs
yeast	greedytigs	18	na	zeros	11456651	11556223	11456651	99572	20480	2623	11558846	2992856	2988520	64180	3052700	3038876	yeast.S_greedytigs.k_18.d_na.M_zeros
yeast	matchtigs	18	na	default	11456651	11549699	11504598	45101	2653	2653	11552352	2992488	2988284	10504	2998788	3000544	yeast.S_matchtigs.k_18.d_na.M_default
yeast	matchtigs	18	na	ones	11456651	11549699	11506621	43078	2728	2653	11552352	2992488	2988284	11460	2999744	3000320	yeast.S_matchtigs.k_18.d_na.M_ones
yeast	matchtigs	18	na	runs	11456651	11549699	11506523	43176	2653	2653	11552352	2992488	2988284	11280	2999564	3000840	yeast.S_matchtigs.k_18.d_na.M_runs
yeast	matchtigs	18	na	zeros	11456651	11549699	11456651	93048	20483	2653	11552352	2992488	2988284	63700	3051984	3036156	yeast.S_matchtigs.k_18.d_na.M_zeros
yeast	eulertigs	19	na	default	11479729	11691607	11479729	211878	11771	11771	11703378	3042532	3025380	35788	3061168	3067344	yeast.S_eulertigs.k_19.d_na.M_default
yeast	eulertigs	19	na	ones	11479729	11691607	11496118	195489	13290	11771	11703378	3042532	3025380	41988	3067368	3068652	yeast.S_eulertigs.k_19.d_na.M_ones
yeast	eulertigs	19	na	runs	11479729	11691607	11492763	198844	11708	11771	11703378	3042532	3025380	39104	3064484	3066900	yeast.S_eulertigs.k_19.d_na.M_runs
yeast	eulertigs	19	na	zeros	11479729	11691607	11479729	211878	19062	11771	11703378	3042532	3025380	56484	3081864	3078560	yeast.S_eulertigs.k_19.d_na.M_zeros
yeast	greedytigs	19	na	default	11479729	11566124	11522114	44010	2445	2445	11568569	2992816	2988620	9760	2998380	2999464	yeast.S_greedytigs.k_19.d_na.M_default
yeast	greedytigs	19	na	ones	11479729	11566124	11523846	42278	2484	2445	11568569	2992816	2988620	10548	2999168	3001992	yeast.S_greedytigs.k_19.d_na.M_ones
yeast	greedytigs	19	na	runs	11479729	11566124	11523792	42332	2445	2445	11568569	2992816	2988620	10436	2999056	3000244	yeast.S_greedytigs.k_19.d_na.M_runs
yeast	greedytigs	19	na	zeros	11479729	11566124	11479729	86395	13419	2445	11568569	2992816	2988620	43632	3032252	3026352	yeast.S_greedytigs.k_19.d_na.M_zeros
yeast	matchtigs	19	na	default	11479729	11561377	11515981	45396	2522	2522	11563899	2992276	2988432	9840	2998272	3000544	yeast.S_matchtigs.k_19.d_na.M_default
yeast	matchtigs	19	na	ones	11479729	11561377	11517820	43557	2555	2522	11563899	2992276	2988432	10724	2999156	3000500	yeast.S_matchtigs.k_19.d_na.M_ones
yeast	matchtigs	19	na	runs	11479729	11561377	11517768	43609	2522	2522	11563899	2992276	2988432	10592	2999024	3000592	yeast.S_matchtigs.k_19.d_na.M_runs
yeast	matchtigs	19	na	zeros	11479729	11561377	11479729	81648	13267	2522	11563899	2992276	2988432	42644	3031076	3024880	yeast.S_matchtigs.k_19.d_na.M_zeros
yeast	eulertigs	20	na	default	11494358	11666061	11494358	171703	9037	9037	11675098	3028876	3015248	27492	3042740	3050156	yeast.S_eulertigs.k_20.d_na.M_default
yeast	eulertigs	20	na	ones	11494358	11666061	11505322	160739	9904	9037	11675098	3028876	3015248	31684	3046932	3050292	yeast.S_eulertigs.k_20.d_na.M_ones
yeast	eulertigs	20	na	runs	11494358	11666061	11503527	162534	8992	9037	11675098	3028876	3015248	30024	3045272	3050096	yeast.S_eulertigs.k_20.d_na.M_runs
yeast	eulertigs	20	na	zeros	11494358	11666061	11494358	171703	13486	9037	11675098	3028876	3015248	40528	3055776	3056840	yeast.S_eulertigs.k_20.d_na.M_zeros
yeast	greedytigs	20	na	default	11494358	11574455	11530888	43567	2293	2293	11576748	2993464	2988476	9156	2997632	3001192	yeast.S_greedytigs.k_20.d_na.M_default
yeast	greedytigs	20	na	ones	11494358	11574455	11532572	41883	2314	2293	11576748	2993464	2988476	9876	2998352	3000600	yeast.S_greedytigs.k_20.d_na.M_ones
yeast	greedytigs	20	na	runs	11494358	11574455	11532547	41908	2293	2293	11576748	2993464	2988476	9816	2998292	3000884	yeast.S_greedytigs.k_20.d_na.M_runs
yeast	greedytigs	20	na	zeros	11494358	11574455	11494358	80097	10707	2293	11576748	2993464	2988476	34804	3023280	3022240	yeast.S_greedytigs.k_20.d_na.M_zeros
yeast	matchtigs	20	na	default	11494358	11570556	11525355	45201	2379	2379	11572935	2989848	2986968	9324	2996292	3001196	yeast.S_matchtigs.k_20.d_na.M_default
yeast	matchtigs	20	na	ones	11494358	11570556	11527027	43529	2394	2379	11572935	2989848	2986968	10080	2997048	2998940	yeast.S_matchtigs.k_20.d_na.M_ones
yeast	matchtigs	20	na	runs	11494358	11570556	11527009	43547	2379	2379	11572935	2989848	2986968	10032	2997000	2999112	yeast.S_matchtigs.k_20.d_na.M_runs
yeast	matchtigs	20	na	zeros	11494358	11570556	11494358	76198	10108	2379	11572935	2989848	2986968	32876	3019844	3018248	yeast.S_matchtigs.k_20.d_na.M_zeros
yeast	eulertigs	21	na	default	11505228	11649928	11505228	144700	7235	7235	11657163	3021488	3011188	22224	3033412	3041676	yeast.S_eulertigs.k_21.d_na.M_default
yeast	eulertigs	21	na	ones	11505228	11649928	11513387	136541	7773	7235	11657163	3021488	3011188	25532	3036720	3041888	yeast.S_eulertigs.k_21.d_na.M_ones
yeast	eulertigs	21	na	runs	11505228	11649928	11512276	137652	7214	7235	11657163	3021488	3011188	24412	3035600	3040348	yeast.S_eulertigs.k_21.d_na.M_runs
yeast	eulertigs	21	na	zeros	11505228	11649928	11505228	144700	10788	7235	11657163	3021488	3011188	32828	3044016	3047652	yeast.S_eulertigs.k_21.d_na.M_zeros
yeast	greedytigs	21	na	default	11505228	11581667	11537407	44260	2213	2213	11583880	2992240	2987756	8916	2996672	2999600	yeast.S_greedytigs.k_21.d_na.M_default
yeast	greedytigs	21	na	ones	11505228	11581667	11539029	42638	2226	2213	11583880	2992240	2987756	9640	2997396	2998932	yeast.S_greedytigs.k_21.d_na.M_ones
yeast	greedytigs	21	na	runs	11505228	11581667	11539002	42665	2212	2213	11583880	2992240	2987756	9608	2997364	2999152	yeast.S_greedytigs.k_21.d_na.M_runs
yeast	greedytigs	21	na	zeros	11505228	11581667	11505228	76439	8259	2213	11583880	2992240	2987756	27684	3015440	3017660	yeast.S_greedytigs.k_21.d_na.M_zeros
yeast	matchtigs	21	na	default	11505228	11578180	11532660	45520	2276	2276	11580456	2991764	2987288	9036	2996324	2999736	yeast.S_matchtigs.k_21.d_na.M_default
yeast	matchtigs	21	na	ones	11505228	11578180	11534271	43909	2283	2276	11580456	2991764	2987288	9756	2997044	2998852	yeast.S_matchtigs.k_21.d_na.M_ones
yeast	matchtigs	21	na	runs	11505228	11578180	11534258	43922	2276	2276	11580456	2991764	2987288	9740	2997028	2999252	yeast.S_matchtigs.k_21.d_na.M_runs
yeast	matchtigs	21	na	zeros	11505228	11578180	11505228	72952	8081	2276	11580456	2991764	2987288	26944	3014232	3014940	yeast.S_matchtigs.k_21.d_na.M_zeros
yeast	eulertigs	22	na	default	11514013	11650828	11514013	136815	6515	6515	11657343	3019068	3008716	19804	3028520	3038124	yeast.S_eulertigs.k_22.d_na.M_default
yeast	eulertigs	22	na	ones	11514013	11650828	11520678	130150	6883	6515	11657343	3019068	3008716	22700	3031416	3039392	yeast.S_eulertigs.k_22.d_na.M_ones
yeast	eulertigs	22	na	runs	11514013	11650828	11519903	130925	6503	6515	11657343	3019068	3008716	21896	3030612	3037804	yeast.S_eulertigs.k_22.d_na.M_runs
yeast	eulertigs	22	na	zeros	11514013	11650828	11514013	136815	9854	6515	11657343	3019068	3008716	29992	3038708	3044576	yeast.S_eulertigs.k_22.d_na.M_zeros
yeast	greedytigs	22	na	default	11514013	11589377	11545088	44289	2109	2109	11591486	2991216	2987912	8508	2996420	2999748	yeast.S_greedytigs.k_22.d_na.M_default
yeast	greedytigs	22	na	ones	11514013	11589377	11546562	42815	2116	2109	11591486	2991216	2987912	9188	2997100	2999164	yeast.S_greedytigs.k_22.d_na.M_ones
yeast	greedytigs	22	na	runs	11514013	11589377	11546553	42824	2109	2109	11591486	2991216	2987912	9168	2997080	2999140	yeast.S_greedytigs.k_22.d_na.M_runs
yeast	greedytigs	22	na	zeros	11514013	11589377	11514013	75364	7659	2109	11591486	2991216	2987912	25720	3013632	3015604	yeast.S_greedytigs.k_22.d_na.M_zeros
yeast	matchtigs	22	na	default	11514013	11585976	11540049	45927	2187	2187	11588163	2993672	2990912	8716	2999628	3003204	yeast.S_matchtigs.k_22.d_na.M_default
yeast	matchtigs	22	na	ones	11514013	11585976	11541708	44268	2193	2187	11588163	2993672	2990912	9436	3000348	3001612	yeast.S_matchtigs.k_22.d_na.M_ones
yeast	matchtigs	22	na	runs	11514013	11585976	11541699	44277	2187	2187	11588163	2993672	2990912	9412	3000324	3001888	yeast.S_matchtigs.k_22.d_na.M_runs
yeast	matchtigs	22	na	zeros	11514013	11585976	11514013	71963	7746	2187	11588163	2993672	2990912	25644	3016556	3019804	yeast.S_matchtigs.k_22.d_na.M_zeros
yeast	eulertigs	23	na	default	11521601	11654569	11521601	132968	6044	6044	11660613	3015264	3006192	18484	3024676	3033576	yeast.S_eulertigs.k_23.d_na.M_default
yeast	eulertigs	23	na	ones	11521601	11654569	11527361	127208	6285	6044	11660613	3015264	3006192	21056	3027248	3033376	yeast.S_eulertigs.k_23.d_na.M_ones
yeast	eulertigs	23	na	runs	11521601	11654569	11526850	127719	6027	6044	11660613	3015264	3006192	20540	3026732	3032712	yeast.S_eulertigs.k_23.d_na.M_runs
yeast	eulertigs	23	na	zeros	11521601	11654569	11521601	132968	7520	6044	11660613	3015264	3006192	23644	3029836	3035992	yeast.S_eulertigs.k_23.d_na.M_zeros
yeast	greedytigs	23	na	default	11521601	11595803	11551825	43978	1999	1999	11597802	2993724	2990532	8316	2998848	3001264	yeast.S_greedytigs.k_23.d_na.M_default
yeast	greedytigs	23	na	ones	11521601	11595803	11553238	42565	2004	1999	11597802	2993724	2990532	9044	2999576	3000644	yeast.S_greedytigs.k_23.d_na.M_ones
yeast	greedytigs	23	na	runs	11521601	11595803	11553233	42570	1999	1999	11597802	2993724	2990532	9024	2999556	3000492	yeast.S_greedytigs.k_23.d_na.M_runs
yeast	greedytigs	23	na	zeros	11521601	11595803	11521601	74202	6953	1999	11597802	2993724	2990532	23556	3014088	3015980	yeast.S_greedytigs.k_23.d_na.M_zeros
yeast	matchtigs	23	na	default	11521601	11592498	11547156	45342	2061	2061	11594559	2992676	2989000	8468	2997468	3000300	yeast.S_matchtigs.k_23.d_na.M_default
yeast	matchtigs	23	na	ones	11521601	11592498	11548646	43852	2062	2061	11594559	2992676	2989000	9188	2998188	2999880	yeast.S_matchtigs.k_23.d_na.M_ones
yeast	matchtigs	23	na	runs	11521601	11592498	11548644	43854	2061	2061	11594559	2992676	2989000	9188	2998188	2999928	yeast.S_matchtigs.k_23.d_na.M_runs
yeast	matchtigs	23	na	zeros	11521601	11592498	11521601	70897	6640	2061	11594559	2992676	2989000	22552	3011552	3014644	yeast.S_matchtigs.k_23.d_na.M_zeros
yeast	eulertigs	24	na	default	11528520	11652260	11528520	123740	5380	5380	11657640	3011328	3004236	16636	3020872	3029004	yeast.S_eulertigs.k_24.d_na.M_default
yeast	eulertigs	24	na	ones	11528520	11652260	11533423	118837	5589	5380	11657640	3011328	3004236	19112	3023348	3029448	yeast.S_eulertigs.k_24.d_na.M_ones
yeast	eulertigs	24	na	runs	11528520	11652260	11532973	119287	5367	5380	11657640	3011328	3004236	18640	3022876	3029532	yeast.S_eulertigs.k_24.d_na.M_runs
yeast	eulertigs	24	na	zeros	11528520	11652260	11528520	123740	6744	5380	11657640	3011328	3004236	21448	3025684	3032316	yeast.S_eulertigs.k_24.d_na.M_zeros
yeast	greedytigs	24	na	default	11528520	11601783	11557278	44505	1935	1935	11603718	2992248	2989124	8120	2997244	3000216	yeast.S_greedytigs.k_24.d_na.M_default
yeast	greedytigs	24	na	ones	11528520	11601783	11558685	43098	1938	1935	11603718	2992248	2989124	8800	2997924	3000460	yeast.S_greedytigs.k_24.d_na.M_ones
yeast	greedytigs	24	na	runs	11528520	11601783	11558681	43102	1935	1935	11603718	2992248	2989124	8784	2997908	3001228	yeast.S_greedytigs.k_24.d_na.M_runs
yeast	greedytigs	24	na	zeros	11528520	11601783	11528520	73263	6188	1935	11603718	2992248	2989124	21508	3010632	3014208	yeast.S_greedytigs.k_24.d_na.M_zeros
yeast	matchtigs	24	na	default	11528520	11598749	11552496	46253	2011	2011	11600760	2993576	2988340	8240	2996580	3000376	yeast.S_matchtigs.k_24.d_na.M_default
yeast	matchtigs	24	na	ones	11528520	11598749	11553900	44849	2014	2011	11600760	2993576	2988340	9012	2997352	2999280	yeast.S_matchtigs.k_24.d_na.M_ones
yeast	matchtigs	24	na	runs	11528520	11598749	11553896	44853	2011	2011	11600760	2993576	2988340	9008	2997348	2999524	yeast.S_matchtigs.k_24.d_na.M_runs
yeast	matchtigs	24	na	zeros	11528520	11598749	11528520	70229	6264	2011	11600760	2993576	2988340	21624	3009964	3012764	yeast.S_matchtigs.k_24.d_na.M_zeros
yeast	eulertigs	25	na	default	11534681	11658905	11534681	124224	5176	5176	11664081	3014176	3006024	16056	3022080	3032016	yeast.S_eulertigs.k_25.d_na.M_default
yeast	eulertigs	25	na	ones	11534681	11658905	11539253	119652	5326	5176	11664081	3014176	3006024	18164	3024188	3031688	yeast.S_eulertigs.k_25.d_na.M_ones
yeast	eulertigs	25	na	runs	11534681	11658905	11538947	119958	5169	5176	11664081	3014176	3006024	17812	3023836	3031768	yeast.S_eulertigs.k_25.d_na.M_runs
yeast	eulertigs	25	na	zeros	11534681	11658905	11534681	124224	7413	5176	11664081	3014176	3006024	23280	3029304	3036256	yeast.S_eulertigs.k_25.d_na.M_zeros
yeast	greedytigs	25	na	default	11534681	11607836	11563220	44616	1859	1859	11609695	2992516	2988792	7940	2996732	3001024	yeast.S_greedytigs.k_25.d_na.M_default
yeast	greedytigs	25	na	ones	11534681	11607836	11564516	43320	1864	1859	11609695	2992516	2988792	8604	2997396	3000220	yeast.S_greedytigs.k_25.d_na.M_ones
yeast	greedytigs	25	na	runs	11534681	11607836	11564509	43327	1859	1859	11609695	2992516	2988792	8592	2997384	2999888	yeast.S_greedytigs.k_25.d_na.M_runs
yeast	greedytigs	25	na	zeros	11534681	11607836	11534681	73155	5913	1859	11609695	2992516	2988792	20468	3009260	3014596	yeast.S_greedytigs.k_25.d_na.M_zeros
yeast	matchtigs	25	na	default	11534681	11604943	11558719	46224	1926	1926	11606869	2991112	2988808	8076	2996884	3000380	yeast.S_matchtigs.k_25.d_na.M_default
yeast	matchtigs	25	na	ones	11534681	11604943	11560004	44939	1928	1926	11606869	2991112	2988808	8764	2997572	3000536	yeast.S_matchtigs.k_25.d_na.M_ones
yeast	matchtigs	25	na	runs	11534681	11604943	11560002	44941	1926	1926	11606869	2991112	2988808	8760	2997568	2999792	yeast.S_matchtigs.k_25.d_na.M_runs
yeast	matchtigs	25	na	zeros	11534681	11604943	11534681	70262	5669	1926	11606869	2991112	2988808	19584	3008392	3012504	yeast.S_matchtigs.k_25.d_na.M_zeros
yeast	eulertigs	26	na	default	11540441	11663091	11540441	122650	4906	4906	11667997	3012820	3006124	15232	3021356	3031056	yeast.S_eulertigs.k_26.d_na.M_default
yeast	eulertigs	26	na	ones	11540441	11663091	11544638	118453	5012	4906	11667997	3012820	3006124	17220	3023344	3031552	yeast.S_eulertigs.k_26.d_na.M_ones
yeast	eulertigs	26	na	runs	11540441	11663091	11544449	118642	4904	4906	11667997	3012820	3006124	16988	3023112	3032040	yeast.S_eulertigs.k_26.d_na.M_runs
yeast	eulertigs	26	na	zeros	11540441	11663091	11540441	122650	6732	4906	11667997	3012820	3006124	21428	3027552	3034484	yeast.S_eulertigs.k_26.d_na.M_zeros
yeast	greedytigs	26	na	default	11540441	11613362	11568687	44675	1787	1787	11615149	2992248	2990068	7744	2997812	3000756	yeast.S_greedytigs.k_26.d_na.M_default
yeast	greedytigs	26	na	ones	11540441	11613362	11570009	43353	1791	1787	11615149	2992248	2990068	8404	2998472	3000736	yeast.S_greedytigs.k_26.d_na.M_ones
yeast	greedytigs	26	na	runs	11540441	11613362	11570005	43357	1787	1787	11615149	2992248	2990068	8392	2998460	3001092	yeast.S_greedytigs.k_26.d_na.M_runs
yeast	greedytigs	26	na	zeros	11540441	11613362	11540441	72921	5547	1787	11615149	2992248	2990068	19596	3009664	3014972	yeast.S_greedytigs.k_26.d_na.M_zeros
yeast	matchtigs	26	na	default	11540441	11610227	11563677	46550	1862	1862	11612089	2990604	2986912	7908	2994820	2999852	yeast.S_matchtigs.k_26.d_na.M_default
yeast	matchtigs	26	na	ones	11540441	11610227	11564935	45292	1864	1862	11612089	2990604	2986912	8584	2995496	2998588	yeast.S_matchtigs.k_26.d_na.M_ones
yeast	matchtigs	26	na	runs	11540441	11610227	11564932	45295	1862	1862	11612089	2990604	2986912	8572	2995484	2998740	yeast.S_matchtigs.k_26.d_na.M_runs
yeast	matchtigs	26	na	zeros	11540441	11610227	11540441	69786	5459	1862	11612089	2990604	2986912	19060	3005972	3010376	yeast.S_matchtigs.k_26.d_na.M_zeros
yeast	eulertigs	27	na	default	11545835	11662185	11545835	116350	4475	4475	11666660	3010488	3004524	14368	3018892	3028676	yeast.S_eulertigs.k_27.d_na.M_default
yeast	eulertigs	27	na	ones	11545835	11662185	11549543	112642	4575	4475	11666660	3010488	3004524	16172	3020696	3028992	yeast.S_eulertigs.k_27.d_na.M_ones
yeast	eulertigs	27	na	runs	11545835	11662185	11549355	112830	4475	4475	11666660	3010488	3004524	15956	3020480	3029348	yeast.S_eulertigs.k_27.d_na.M_runs
yeast	eulertigs	27	na	zeros	11545835	11662185	11545835	116350	5930	4475	11666660	3010488	3004524	19324	3023848	3031236	yeast.S_eulertigs.k_27.d_na.M_zeros
yeast	greedytigs	27	na	default	11545835	11618153	11572939	45214	1739	1739	11619892	2991312	2988484	7664	2996148	2999612	yeast.S_greedytigs.k_27.d_na.M_default
yeast	greedytigs	27	na	ones	11545835	11618153	11574116	44037	1744	1739	11619892	2991312	2988484	8288	2996772	3000096	yeast.S_greedytigs.k_27.d_na.M_ones
yeast	greedytigs	27	na	runs	11545835	11618153	11574111	44042	1739	1739	11619892	2991312	2988484	8284	2996768	2999892	yeast.S_greedytigs.k_27.d_na.M_runs
yeast	greedytigs	27	na	zeros	11545835	11618153	11545835	72318	4962	1739	11619892	2991312	2988484	17760	3006244	3013704	yeast.S_greedytigs.k_27.d_na.M_zeros
yeast	matchtigs	27	na	default	11545835	11615296	11568340	46956	1806	1806	11617102	2992192	2989736	7812	2997548	3000652	yeast.S_matchtigs.k_27.d_na.M_default
yeast	matchtigs	27	na	ones	11545835	11615296	11569601	45695	1808	1806	11617102	2992192	2989736	8496	2998232	3000612	yeast.S_matchtigs.k_27.d_na.M_ones
yeast	matchtigs	27	na	runs	11545835	11615296	11569599	45697	1806	1806	11617102	2992192	2989736	8492	2998228	3000660	yeast.S_matchtigs.k_27.d_na.M_runs
yeast	matchtigs	27	na	zeros	11545835	11615296	11545835	69461	4993	1806	11617102	2992192	2989736	17720	3007456	3011900	yeast.S_matchtigs.k_27.d_na.M_zeros
yeast	eulertigs	28	na	default	11550770	11668328	11550770	117558	4354	4354	11672682	3011392	3003932	13940	3017872	3029352	yeast.S_eulertigs.k_28.d_na.M_default
yeast	eulertigs	28	na	ones	11550770	11668328	11554459	113869	4435	4354	11672682	3011392	3003932	15752	3019684	3029308	yeast.S_eulertigs.k_28.d_na.M_ones
yeast	eulertigs	28	na	runs	11550770	11668328	11554287	114041	4347	4354	11672682	3011392	3003932	15528	3019460	3029944	yeast.S_eulertigs.k_28.d_na.M_runs
yeast	eulertigs	28	na	zeros	11550770	11668328	11550770	117558	6162	4354	11672682	3011392	3003932	20200	3024132	3033076	yeast.S_eulertigs.k_28.d_na.M_zeros
yeast	greedytigs	28	na	default	11550770	11623180	11577928	45252	1676	1676	11624856	2991092	2988668	7464	2996132	3000116	yeast.S_greedytigs.k_28.d_na.M_default
yeast	greedytigs	28	na	ones	11550770	11623180	11579102	44078	1677	1676	11624856	2991092	2988668	8092	2996760	2999624	yeast.S_greedytigs.k_28.d_na.M_ones
yeast	greedytigs	28	na	runs	11550770	11623180	11579101	44079	1676	1676	11624856	2991092	2988668	8092	2996760	2999676	yeast.S_greedytigs.k_28.d_na.M_runs
yeast	greedytigs	28	na	zeros	11550770	11623180	11550770	72410	4769	1676	11624856	2991092	2988668	17136	3005804	3011792	yeast.S_greedytigs.k_28.d_na.M_zeros
yeast	matchtigs	28	na	default	11550770	11620314	11573631	46683	1729	1729	11622043	2992896	2990876	7608	2998484	3000836	yeast.S_matchtigs.k_28.d_na.M_default
yeast	matchtigs	28	na	ones	11550770	11620314	11574831	45483	1731	1729	11622043	2992896	2990876	8260	2999136	3001092	yeast.S_matchtigs.k_28.d_na.M_ones
yeast	matchtigs	28	na	runs	11550770	11620314	11574828	45486	1729	1729	11622043	2992896	2990876	8252	2999128	3000904	yeast.S_matchtigs.k_28.d_na.M_runs
yeast	matchtigs	28	na	zeros	11550770	11620314	11550770	69544	4853	1729	11622043	2992896	2990876	17500	3008376	3013032	yeast.S_matchtigs.k_28.d_na.M_zeros
yeast	eulertigs	29	na	default	11555456	11672664	11555456	117208	4186	4186	11676850	3012412	3004556	13432	3017988	3029664	yeast.S_eulertigs.k_29.d_na.M_default
yeast	eulertigs	29	na	ones	11555456	11672664	11558691	113973	4232	4186	11676850	3012412	3004556	15028	3019584	3029948	yeast.S_eulertigs.k_29.d_na.M_ones
yeast	eulertigs	29	na	runs	11555456	11672664	11558618	114046	4185	4186	11676850	3012412	3004556	14920	3019476	3029716	yeast.S_eulertigs.k_29.d_na.M_runs
yeast	eulertigs	29	na	zeros	11555456	11672664	11555456	117208	5735	4186	11676850	3012412	3004556	18780	3023336	3033256	yeast.S_eulertigs.k_29.d_na.M_zeros
yeast	greedytigs	29	na	default	11555456	11627550	11582302	45248	1616	1616	11629166	2992304	2989812	7400	2997212	3001308	yeast.S_greedytigs.k_29.d_na.M_default
yeast	greedytigs	29	na	ones	11555456	11627550	11583379	44171	1620	1616	11629166	2992304	2989812	8036	2997848	3000940	yeast.S_greedytigs.k_29.d_na.M_ones
yeast	greedytigs	29	na	runs	11555456	11627550	11583374	44176	1616	1616	11629166	2992304	2989812	8032	2997844	3000552	yeast.S_greedytigs.k_29.d_na.M_runs
yeast	greedytigs	29	na	zeros	11555456	11627550	11555456	72094	4924	1616	11629166	2992304	2989812	18064	3007876	3011740	yeast.S_greedytigs.k_29.d_na.M_zeros
yeast	matchtigs	29	na	default	11555456	11624974	11578326	46648	1666	1666	11626640	2992152	2989164	7480	2996644	3001644	yeast.S_matchtigs.k_29.d_na.M_default
yeast	matchtigs	29	na	ones	11555456	11624974	11579548	45426	1671	1666	11626640	2992152	2989164	8088	2997252	3001060	yeast.S_matchtigs.k_29.d_na.M_ones
yeast	matchtigs	29	na	runs	11555456	11624974	11579541	45433	1666	1666	11626640	2992152	2989164	8068	2997232	3000476	yeast.S_matchtigs.k_29.d_na.M_runs
yeast	matchtigs	29	na	zeros	11555456	11624974	11555456	69518	4680	1666	11626640	2992152	2989164	16760	3005924	3011044	yeast.S_matchtigs.k_29.d_na.M_zeros
yeast	eulertigs	30	na	default	11559932	11673583	11559932	113651	3919	3919	11677502	3008088	3002356	12820	3015176	3027420	yeast.S_eulertigs.k_30.d_na.M_default
yeast	eulertigs	30	na	ones	11559932	11673583	11562966	110617	3966	3919	11677502	3008088	3002356	14376	3016732	3026284	yeast.S_eulertigs.k_30.d_na.M_ones
yeast	eulertigs	30	na	runs	11559932	11673583	11562880	110703	3918	3919	11677502	3008088	3002356	14268	3016624	3027444	yeast.S_eulertigs.k_30.d_na.M_runs
yeast	eulertigs	30	na	zeros	11559932	11673583	11559932	113651	5436	3919	11677502	3008088	3002356	18100	3020456	3029564	yeast.S_eulertigs.k_30.d_na.M_zeros
yeast	greedytigs	30	na	default	11559932	11631815	11586256	45559	1571	1571	11633386	2991472	2989108	7280	2996388	3000668	yeast.S_greedytigs.k_30.d_na.M_default
yeast	greedytigs	30	na	ones	11559932	11631815	11587286	44529	1576	1571	11633386	2991472	2989108	7864	2996972	3003936	yeast.S_greedytigs.k_30.d_na.M_ones
yeast	greedytigs	30	na	runs	11559932	11631815	11587278	44537	1571	1571	11633386	2991472	2989108	7852	2996960	3004344	yeast.S_greedytigs.k_30.d_na.M_runs
yeast	greedytigs	30	na	zeros	11559932	11631815	11559932	71883	4322	1571	11633386	2991472	2989108	16056	3005164	3012584	yeast.S_greedytigs.k_30.d_na.M_zeros
yeast	matchtigs	30	na	default	11559932	11629376	11582280	47096	1624	1624	11631000	2993300	2990812	7364	2998176	3002808	yeast.S_matchtigs.k_30.d_na.M_default
yeast	matchtigs	30	na	ones	11559932	11629376	11583362	46014	1629	1624	11631000	2993300	2990812	8024	2998836	3002684	yeast.S_matchtigs.k_30.d_na.M_ones
yeast	matchtigs	30	na	runs	11559932	11629376	11583357	46019	1624	1624	11631000	2993300	2990812	8008	2998820	3002492	yeast.S_matchtigs.k_30.d_na.M_runs
yeast	matchtigs	30	na	zeros	11559932	11629376	11559932	69444	4318	1624	11631000	2993300	2990812	15776	3006588	3012124	yeast.S_matchtigs.k_30.d_na.M_zeros
yeast	eulertigs	31	na	default	11564096	11678126	11564096	114030	3801	3801	11681927	3010260	3004740	12576	3017316	3029672	yeast.S_eulertigs.k_31.d_na.M_default
yeast	eulertigs	31	na	ones	11564096	11678126	11566940	111186	3837	3801	11681927	3010260	3004740	14076	3018816	3027864	yeast.S_eulertigs.k_31.d_na.M_ones
yeast	eulertigs	31	na	runs	11564096	11678126	11566892	111234	3801	3801	11681927	3010260	3004740	13984	3018724	3027908	yeast.S_eulertigs.k_31.d_na.M_runs
yeast	eulertigs	31	na	zeros	11564096	11678126	11564096	114030	5100	3801	11681927	3010260	3004740	17112	3021852	3030808	yeast.S_eulertigs.k_31.d_na.M_zeros
yeast	greedytigs	31	na	default	11564096	11635917	11590407	45510	1517	1517	11637434	2993776	2991204	7096	2998300	3003664	yeast.S_greedytigs.k_31.d_na.M_default
yeast	greedytigs	31	na	ones	11564096	11635917	11591522	44395	1519	1517	11637434	2993776	2991204	7692	2998896	3002688	yeast.S_greedytigs.k_31.d_na.M_ones
yeast	greedytigs	31	na	runs	11564096	11635917	11591520	44397	1517	1517	11637434	2993776	2991204	7688	2998892	3002940	yeast.S_greedytigs.k_31.d_na.M_runs
yeast	greedytigs	31	na	zeros	11564096	11635917	11564096	71821	4334	1517	11637434	2993776	2991204	16176	3007380	3014172	yeast.S_greedytigs.k_31.d_na.M_zeros
yeast	matchtigs	31	na	default	11564096	11633756	11586776	46980	1566	1566	11635322	2993412	2989992	7208	2997200	3000472	yeast.S_matchtigs.k_31.d_na.M_default
yeast	matchtigs	31	na	ones	11564096	11633756	11587810	45946	1567	1566	11635322	2993412	2989992	7740	2997732	3000640	yeast.S_matchtigs.k_31.d_na.M_ones
yeast	matchtigs	31	na	runs	11564096	11633756	11587809	45947	1566	1566	11635322	2993412	2989992	7736	2997728	3000616	yeast.S_matchtigs.k_31.d_na.M_runs
yeast	matchtigs	31	na	zeros	11564096	11633756	11564096	69660	4106	1566	11635322	2993412	2989992	15160	3005152	3011028	yeast.S_matchtigs.k_31.d_na.M_zeros
