genome	S_alg	k	d	M_alg	kmer_count	l	o	z	r	S_xz_bytes	M_xz_bytes	enc1_xz_bytes	enc2_xz_bytes	pref
spneumoniae	pseudosimplitigs	2	1	default	10	12	10	2	2	68	68	136	68	spneumoniae.S_pseudosimplitigs.k_2.d_1.M_default
spneumoniae	pseudosimplitigs	2	1	ones	10	12	11	1	1	68	68	136	68	spneumoniae.S_pseudosimplitigs.k_2.d_1.M_ones
spneumoniae	pseudosimplitigs	2	1	runs	10	12	11	1	1	68	68	136	68	spneumoniae.S_pseudosimplitigs.k_2.d_1.M_runs
spneumoniae	pseudosimplitigs	2	1	zeros	10	12	10	2	2	68	68	136	68	spneumoniae.S_pseudosimplitigs.k_2.d_1.M_zeros
spneumoniae	pseudosimplitigsAC	2	1	default	10	12	10	2	2	68	68	136	68	spneumoniae.S_pseudosimplitigsAC.k_2.d_1.M_default
spneumoniae	pseudosimplitigsAC	2	1	ones	10	12	11	1	1	68	68	136	68	spneumoniae.S_pseudosimplitigsAC.k_2.d_1.M_ones
spneumoniae	pseudosimplitigsAC	2	1	runs	10	12	11	1	1	68	68	136	68	spneumoniae.S_pseudosimplitigsAC.k_2.d_1.M_runs
spneumoniae	pseudosimplitigsAC	2	1	zeros	10	12	10	2	2	68	68	136	68	spneumoniae.S_pseudosimplitigsAC.k_2.d_1.M_zeros
spneumoniae	pseudosimplitigs	3	1	default	32	36	32	4	2	92	72	164	96	spneumoniae.S_pseudosimplitigs.k_3.d_1.M_default
spneumoniae	pseudosimplitigs	3	1	ones	32	36	34	2	1	92	72	164	92	spneumoniae.S_pseudosimplitigs.k_3.d_1.M_ones
spneumoniae	pseudosimplitigs	3	1	runs	32	36	34	2	1	92	72	164	92	spneumoniae.S_pseudosimplitigs.k_3.d_1.M_runs
spneumoniae	pseudosimplitigs	3	1	zeros	32	36	32	4	2	92	72	164	96	spneumoniae.S_pseudosimplitigs.k_3.d_1.M_zeros
spneumoniae	pseudosimplitigs	3	2	default	32	37	32	5	4	92	72	164	96	spneumoniae.S_pseudosimplitigs.k_3.d_2.M_default
spneumoniae	pseudosimplitigs	3	2	ones	32	37	35	2	1	92	72	164	92	spneumoniae.S_pseudosimplitigs.k_3.d_2.M_ones
spneumoniae	pseudosimplitigs	3	2	runs	32	37	35	2	1	92	72	164	92	spneumoniae.S_pseudosimplitigs.k_3.d_2.M_runs
spneumoniae	pseudosimplitigs	3	2	zeros	32	37	32	5	4	92	72	164	96	spneumoniae.S_pseudosimplitigs.k_3.d_2.M_zeros
spneumoniae	pseudosimplitigsAC	3	1	default	32	36	32	4	2	96	72	168	92	spneumoniae.S_pseudosimplitigsAC.k_3.d_1.M_default
spneumoniae	pseudosimplitigsAC	3	1	ones	32	36	34	2	1	96	72	168	96	spneumoniae.S_pseudosimplitigsAC.k_3.d_1.M_ones
spneumoniae	pseudosimplitigsAC	3	1	runs	32	36	34	2	1	96	72	168	96	spneumoniae.S_pseudosimplitigsAC.k_3.d_1.M_runs
spneumoniae	pseudosimplitigsAC	3	1	zeros	32	36	32	4	2	96	72	168	96	spneumoniae.S_pseudosimplitigsAC.k_3.d_1.M_zeros
spneumoniae	pseudosimplitigsAC	3	2	default	32	35	32	3	2	96	72	168	92	spneumoniae.S_pseudosimplitigsAC.k_3.d_2.M_default
spneumoniae	pseudosimplitigsAC	3	2	ones	32	35	33	2	1	96	72	168	92	spneumoniae.S_pseudosimplitigsAC.k_3.d_2.M_ones
spneumoniae	pseudosimplitigsAC	3	2	runs	32	35	33	2	1	96	72	168	92	spneumoniae.S_pseudosimplitigsAC.k_3.d_2.M_runs
spneumoniae	pseudosimplitigsAC	3	2	zeros	32	35	32	3	2	96	72	168	92	spneumoniae.S_pseudosimplitigsAC.k_3.d_2.M_zeros
spneumoniae	pseudosimplitigs	4	1	default	136	163	136	27	9	156	84	240	172	spneumoniae.S_pseudosimplitigs.k_4.d_1.M_default
spneumoniae	pseudosimplitigs	4	1	ones	136	163	160	3	1	156	76	232	156	spneumoniae.S_pseudosimplitigs.k_4.d_1.M_ones
spneumoniae	pseudosimplitigs	4	1	runs	136	163	160	3	1	156	76	232	156	spneumoniae.S_pseudosimplitigs.k_4.d_1.M_runs
spneumoniae	pseudosimplitigs	4	1	zeros	136	163	136	27	13	156	92	248	172	spneumoniae.S_pseudosimplitigs.k_4.d_1.M_zeros
spneumoniae	pseudosimplitigs	4	2	default	136	154	136	18	10	148	88	236	164	spneumoniae.S_pseudosimplitigs.k_4.d_2.M_default
spneumoniae	pseudosimplitigs	4	2	ones	136	154	151	3	1	148	76	224	152	spneumoniae.S_pseudosimplitigs.k_4.d_2.M_ones
spneumoniae	pseudosimplitigs	4	2	runs	136	154	151	3	1	148	76	224	152	spneumoniae.S_pseudosimplitigs.k_4.d_2.M_runs
spneumoniae	pseudosimplitigs	4	2	zeros	136	154	136	18	10	148	88	236	164	spneumoniae.S_pseudosimplitigs.k_4.d_2.M_zeros
spneumoniae	pseudosimplitigs	4	3	default	136	151	136	15	10	148	88	236	160	spneumoniae.S_pseudosimplitigs.k_4.d_3.M_default
spneumoniae	pseudosimplitigs	4	3	ones	136	151	148	3	1	148	76	224	152	spneumoniae.S_pseudosimplitigs.k_4.d_3.M_ones
spneumoniae	pseudosimplitigs	4	3	runs	136	151	148	3	1	148	76	224	152	spneumoniae.S_pseudosimplitigs.k_4.d_3.M_runs
spneumoniae	pseudosimplitigs	4	3	zeros	136	151	136	15	10	148	88	236	160	spneumoniae.S_pseudosimplitigs.k_4.d_3.M_zeros
spneumoniae	pseudosimplitigsAC	4	1	default	136	154	136	18	6	160	80	240	172	spneumoniae.S_pseudosimplitigsAC.k_4.d_1.M_default
spneumoniae	pseudosimplitigsAC	4	1	ones	136	154	151	3	1	160	76	236	160	spneumoniae.S_pseudosimplitigsAC.k_4.d_1.M_ones
spneumoniae	pseudosimplitigsAC	4	1	runs	136	154	151	3	1	160	76	236	160	spneumoniae.S_pseudosimplitigsAC.k_4.d_1.M_runs
spneumoniae	pseudosimplitigsAC	4	1	zeros	136	154	136	18	8	160	84	244	172	spneumoniae.S_pseudosimplitigsAC.k_4.d_1.M_zeros
spneumoniae	pseudosimplitigsAC	4	2	default	136	152	136	16	12	156	88	244	168	spneumoniae.S_pseudosimplitigsAC.k_4.d_2.M_default
spneumoniae	pseudosimplitigsAC	4	2	ones	136	152	149	3	1	156	76	232	160	spneumoniae.S_pseudosimplitigsAC.k_4.d_2.M_ones
spneumoniae	pseudosimplitigsAC	4	2	runs	136	152	149	3	1	156	76	232	160	spneumoniae.S_pseudosimplitigsAC.k_4.d_2.M_runs
spneumoniae	pseudosimplitigsAC	4	2	zeros	136	152	136	16	12	156	88	244	168	spneumoniae.S_pseudosimplitigsAC.k_4.d_2.M_zeros
spneumoniae	pseudosimplitigsAC	4	3	default	136	153	136	17	13	156	88	244	168	spneumoniae.S_pseudosimplitigsAC.k_4.d_3.M_default
spneumoniae	pseudosimplitigsAC	4	3	ones	136	153	150	3	1	156	76	232	160	spneumoniae.S_pseudosimplitigsAC.k_4.d_3.M_ones
spneumoniae	pseudosimplitigsAC	4	3	runs	136	153	150	3	1	156	76	232	160	spneumoniae.S_pseudosimplitigsAC.k_4.d_3.M_runs
spneumoniae	pseudosimplitigsAC	4	3	zeros	136	153	136	17	13	156	88	244	168	spneumoniae.S_pseudosimplitigsAC.k_4.d_3.M_zeros
spneumoniae	pseudosimplitigs	5	1	default	512	564	512	52	13	272	96	368	308	spneumoniae.S_pseudosimplitigs.k_5.d_1.M_default
spneumoniae	pseudosimplitigs	5	1	ones	512	564	560	4	1	272	76	348	272	spneumoniae.S_pseudosimplitigs.k_5.d_1.M_ones
spneumoniae	pseudosimplitigs	5	1	runs	512	564	560	4	1	272	76	348	272	spneumoniae.S_pseudosimplitigs.k_5.d_1.M_runs
spneumoniae	pseudosimplitigs	5	1	zeros	512	564	512	52	21	272	112	384	316	spneumoniae.S_pseudosimplitigs.k_5.d_1.M_zeros
spneumoniae	pseudosimplitigs	5	2	default	512	558	512	46	31	272	112	384	316	spneumoniae.S_pseudosimplitigs.k_5.d_2.M_default
spneumoniae	pseudosimplitigs	5	2	ones	512	558	554	4	1	272	76	348	276	spneumoniae.S_pseudosimplitigs.k_5.d_2.M_ones
spneumoniae	pseudosimplitigs	5	2	runs	512	558	554	4	1	272	76	348	276	spneumoniae.S_pseudosimplitigs.k_5.d_2.M_runs
spneumoniae	pseudosimplitigs	5	2	zeros	512	558	512	46	29	272	112	384	312	spneumoniae.S_pseudosimplitigs.k_5.d_2.M_zeros
spneumoniae	pseudosimplitigs	5	3	default	512	553	512	41	32	272	120	392	312	spneumoniae.S_pseudosimplitigs.k_5.d_3.M_default
spneumoniae	pseudosimplitigs	5	3	ones	512	553	549	4	1	272	76	348	276	spneumoniae.S_pseudosimplitigs.k_5.d_3.M_ones
spneumoniae	pseudosimplitigs	5	3	runs	512	553	549	4	1	272	76	348	276	spneumoniae.S_pseudosimplitigs.k_5.d_3.M_runs
spneumoniae	pseudosimplitigs	5	3	zeros	512	553	512	41	31	272	120	392	312	spneumoniae.S_pseudosimplitigs.k_5.d_3.M_zeros
spneumoniae	pseudosimplitigs	5	4	default	512	554	512	42	33	272	120	392	316	spneumoniae.S_pseudosimplitigs.k_5.d_4.M_default
spneumoniae	pseudosimplitigs	5	4	ones	512	554	550	4	1	272	76	348	276	spneumoniae.S_pseudosimplitigs.k_5.d_4.M_ones
spneumoniae	pseudosimplitigs	5	4	runs	512	554	550	4	1	272	76	348	276	spneumoniae.S_pseudosimplitigs.k_5.d_4.M_runs
spneumoniae	pseudosimplitigs	5	4	zeros	512	554	512	42	32	272	120	392	312	spneumoniae.S_pseudosimplitigs.k_5.d_4.M_zeros
spneumoniae	pseudosimplitigsAC	5	1	default	512	524	512	12	3	308	80	388	320	spneumoniae.S_pseudosimplitigsAC.k_5.d_1.M_default
spneumoniae	pseudosimplitigsAC	5	1	ones	512	524	520	4	1	308	76	384	312	spneumoniae.S_pseudosimplitigsAC.k_5.d_1.M_ones
spneumoniae	pseudosimplitigsAC	5	1	runs	512	524	520	4	1	308	76	384	312	spneumoniae.S_pseudosimplitigsAC.k_5.d_1.M_runs
spneumoniae	pseudosimplitigsAC	5	1	zeros	512	524	512	12	3	308	80	388	320	spneumoniae.S_pseudosimplitigsAC.k_5.d_1.M_zeros
spneumoniae	pseudosimplitigsAC	5	2	default	512	524	512	12	3	308	80	388	320	spneumoniae.S_pseudosimplitigsAC.k_5.d_2.M_default
spneumoniae	pseudosimplitigsAC	5	2	ones	512	524	520	4	1	308	76	384	312	spneumoniae.S_pseudosimplitigsAC.k_5.d_2.M_ones
spneumoniae	pseudosimplitigsAC	5	2	runs	512	524	520	4	1	308	76	384	312	spneumoniae.S_pseudosimplitigsAC.k_5.d_2.M_runs
spneumoniae	pseudosimplitigsAC	5	2	zeros	512	524	512	12	3	308	80	388	320	spneumoniae.S_pseudosimplitigsAC.k_5.d_2.M_zeros
spneumoniae	pseudosimplitigsAC	5	3	default	512	524	512	12	3	308	80	388	320	spneumoniae.S_pseudosimplitigsAC.k_5.d_3.M_default
spneumoniae	pseudosimplitigsAC	5	3	ones	512	524	520	4	1	308	76	384	312	spneumoniae.S_pseudosimplitigsAC.k_5.d_3.M_ones
spneumoniae	pseudosimplitigsAC	5	3	runs	512	524	520	4	1	308	76	384	312	spneumoniae.S_pseudosimplitigsAC.k_5.d_3.M_runs
spneumoniae	pseudosimplitigsAC	5	3	zeros	512	524	512	12	3	308	80	388	320	spneumoniae.S_pseudosimplitigsAC.k_5.d_3.M_zeros
spneumoniae	pseudosimplitigsAC	5	4	default	512	522	512	10	3	308	80	388	320	spneumoniae.S_pseudosimplitigsAC.k_5.d_4.M_default
spneumoniae	pseudosimplitigsAC	5	4	ones	512	522	518	4	1	308	76	384	312	spneumoniae.S_pseudosimplitigsAC.k_5.d_4.M_ones
spneumoniae	pseudosimplitigsAC	5	4	runs	512	522	518	4	1	308	76	384	312	spneumoniae.S_pseudosimplitigsAC.k_5.d_4.M_runs
spneumoniae	pseudosimplitigsAC	5	4	zeros	512	522	512	10	4	308	84	392	316	spneumoniae.S_pseudosimplitigsAC.k_5.d_4.M_zeros
spneumoniae	pseudosimplitigs	6	1	default	2080	2285	2080	205	41	660	140	800	744	spneumoniae.S_pseudosimplitigs.k_6.d_1.M_default
spneumoniae	pseudosimplitigs	6	1	ones	2080	2285	2280	5	1	660	88	748	664	spneumoniae.S_pseudosimplitigs.k_6.d_1.M_ones
spneumoniae	pseudosimplitigs	6	1	runs	2080	2285	2280	5	1	660	88	748	664	spneumoniae.S_pseudosimplitigs.k_6.d_1.M_runs
spneumoniae	pseudosimplitigs	6	1	zeros	2080	2285	2080	205	62	660	184	844	760	spneumoniae.S_pseudosimplitigs.k_6.d_1.M_zeros
spneumoniae	pseudosimplitigs	6	2	default	2080	2259	2080	179	75	672	192	864	752	spneumoniae.S_pseudosimplitigs.k_6.d_2.M_default
spneumoniae	pseudosimplitigs	6	2	ones	2080	2259	2254	5	1	672	88	760	676	spneumoniae.S_pseudosimplitigs.k_6.d_2.M_ones
spneumoniae	pseudosimplitigs	6	2	runs	2080	2259	2254	5	1	672	88	760	676	spneumoniae.S_pseudosimplitigs.k_6.d_2.M_runs
spneumoniae	pseudosimplitigs	6	2	zeros	2080	2259	2080	179	77	672	196	868	756	spneumoniae.S_pseudosimplitigs.k_6.d_2.M_zeros
spneumoniae	pseudosimplitigs	6	3	default	2080	2297	2080	217	140	672	244	916	808	spneumoniae.S_pseudosimplitigs.k_6.d_3.M_default
spneumoniae	pseudosimplitigs	6	3	ones	2080	2297	2292	5	1	672	88	760	680	spneumoniae.S_pseudosimplitigs.k_6.d_3.M_ones
spneumoniae	pseudosimplitigs	6	3	runs	2080	2297	2292	5	1	672	88	760	680	spneumoniae.S_pseudosimplitigs.k_6.d_3.M_runs
spneumoniae	pseudosimplitigs	6	3	zeros	2080	2297	2080	217	144	672	252	924	816	spneumoniae.S_pseudosimplitigs.k_6.d_3.M_zeros
spneumoniae	pseudosimplitigs	6	4	default	2080	2286	2080	206	142	668	248	916	796	spneumoniae.S_pseudosimplitigs.k_6.d_4.M_default
spneumoniae	pseudosimplitigs	6	4	ones	2080	2286	2281	5	1	668	88	756	672	spneumoniae.S_pseudosimplitigs.k_6.d_4.M_ones
spneumoniae	pseudosimplitigs	6	4	runs	2080	2286	2281	5	1	668	88	756	672	spneumoniae.S_pseudosimplitigs.k_6.d_4.M_runs
spneumoniae	pseudosimplitigs	6	4	zeros	2080	2286	2080	206	146	668	252	920	804	spneumoniae.S_pseudosimplitigs.k_6.d_4.M_zeros
spneumoniae	pseudosimplitigs	6	5	default	2080	2283	2080	203	142	664	248	912	796	spneumoniae.S_pseudosimplitigs.k_6.d_5.M_default
spneumoniae	pseudosimplitigs	6	5	ones	2080	2283	2278	5	1	664	88	752	668	spneumoniae.S_pseudosimplitigs.k_6.d_5.M_ones
spneumoniae	pseudosimplitigs	6	5	runs	2080	2283	2278	5	1	664	88	752	668	spneumoniae.S_pseudosimplitigs.k_6.d_5.M_runs
spneumoniae	pseudosimplitigs	6	5	zeros	2080	2283	2080	203	149	664	256	920	808	spneumoniae.S_pseudosimplitigs.k_6.d_5.M_zeros
spneumoniae	pseudosimplitigsAC	6	1	default	2080	2240	2080	160	32	872	120	992	928	spneumoniae.S_pseudosimplitigsAC.k_6.d_1.M_default
spneumoniae	pseudosimplitigsAC	6	1	ones	2080	2240	2235	5	1	872	88	960	876	spneumoniae.S_pseudosimplitigsAC.k_6.d_1.M_ones
spneumoniae	pseudosimplitigsAC	6	1	runs	2080	2240	2235	5	1	872	88	960	876	spneumoniae.S_pseudosimplitigsAC.k_6.d_1.M_runs
spneumoniae	pseudosimplitigsAC	6	1	zeros	2080	2240	2080	160	37	872	132	1004	940	spneumoniae.S_pseudosimplitigsAC.k_6.d_1.M_zeros
spneumoniae	pseudosimplitigsAC	6	2	default	2080	2205	2080	125	49	876	152	1028	944	spneumoniae.S_pseudosimplitigsAC.k_6.d_2.M_default
spneumoniae	pseudosimplitigsAC	6	2	ones	2080	2205	2200	5	1	876	84	960	876	spneumoniae.S_pseudosimplitigsAC.k_6.d_2.M_ones
spneumoniae	pseudosimplitigsAC	6	2	runs	2080	2205	2200	5	1	876	84	960	876	spneumoniae.S_pseudosimplitigsAC.k_6.d_2.M_runs
spneumoniae	pseudosimplitigsAC	6	2	zeros	2080	2205	2080	125	50	876	156	1032	928	spneumoniae.S_pseudosimplitigsAC.k_6.d_2.M_zeros
spneumoniae	pseudosimplitigsAC	6	3	default	2080	2184	2080	104	56	868	164	1032	932	spneumoniae.S_pseudosimplitigsAC.k_6.d_3.M_default
spneumoniae	pseudosimplitigsAC	6	3	ones	2080	2184	2179	5	1	868	84	952	872	spneumoniae.S_pseudosimplitigsAC.k_6.d_3.M_ones
spneumoniae	pseudosimplitigsAC	6	3	runs	2080	2184	2179	5	1	868	84	952	872	spneumoniae.S_pseudosimplitigsAC.k_6.d_3.M_runs
spneumoniae	pseudosimplitigsAC	6	3	zeros	2080	2184	2080	104	55	868	160	1028	916	spneumoniae.S_pseudosimplitigsAC.k_6.d_3.M_zeros
spneumoniae	pseudosimplitigsAC	6	4	default	2080	2187	2080	107	59	868	160	1028	932	spneumoniae.S_pseudosimplitigsAC.k_6.d_4.M_default
spneumoniae	pseudosimplitigsAC	6	4	ones	2080	2187	2182	5	1	868	84	952	872	spneumoniae.S_pseudosimplitigsAC.k_6.d_4.M_ones
spneumoniae	pseudosimplitigsAC	6	4	runs	2080	2187	2182	5	1	868	84	952	872	spneumoniae.S_pseudosimplitigsAC.k_6.d_4.M_runs
spneumoniae	pseudosimplitigsAC	6	4	zeros	2080	2187	2080	107	58	868	160	1028	916	spneumoniae.S_pseudosimplitigsAC.k_6.d_4.M_zeros
spneumoniae	pseudosimplitigsAC	6	5	default	2080	2190	2080	110	60	868	164	1032	932	spneumoniae.S_pseudosimplitigsAC.k_6.d_5.M_default
spneumoniae	pseudosimplitigsAC	6	5	ones	2080	2190	2185	5	1	868	84	952	872	spneumoniae.S_pseudosimplitigsAC.k_6.d_5.M_ones
spneumoniae	pseudosimplitigsAC	6	5	runs	2080	2190	2185	5	1	868	84	952	872	spneumoniae.S_pseudosimplitigsAC.k_6.d_5.M_runs
spneumoniae	pseudosimplitigsAC	6	5	zeros	2080	2190	2080	110	59	868	160	1028	916	spneumoniae.S_pseudosimplitigsAC.k_6.d_5.M_zeros
spneumoniae	pseudosimplitigs	7	1	default	8192	8612	8192	420	70	1724	204	1928	1816	spneumoniae.S_pseudosimplitigs.k_7.d_1.M_default
spneumoniae	pseudosimplitigs	7	1	ones	8192	8612	8606	6	1	1724	108	1832	1732	spneumoniae.S_pseudosimplitigs.k_7.d_1.M_ones
spneumoniae	pseudosimplitigs	7	1	runs	8192	8612	8606	6	1	1724	108	1832	1732	spneumoniae.S_pseudosimplitigs.k_7.d_1.M_runs
spneumoniae	pseudosimplitigs	7	1	zeros	8192	8612	8192	420	115	1724	320	2044	1904	spneumoniae.S_pseudosimplitigs.k_7.d_1.M_zeros
spneumoniae	pseudosimplitigs	7	2	default	8192	8495	8192	303	158	1728	308	2036	1892	spneumoniae.S_pseudosimplitigs.k_7.d_2.M_default
spneumoniae	pseudosimplitigs	7	2	ones	8192	8495	8489	6	1	1728	108	1836	1736	spneumoniae.S_pseudosimplitigs.k_7.d_2.M_ones
spneumoniae	pseudosimplitigs	7	2	runs	8192	8495	8489	6	1	1728	108	1836	1736	spneumoniae.S_pseudosimplitigs.k_7.d_2.M_runs
spneumoniae	pseudosimplitigs	7	2	zeros	8192	8495	8192	303	145	1728	328	2056	1900	spneumoniae.S_pseudosimplitigs.k_7.d_2.M_zeros
spneumoniae	pseudosimplitigs	7	3	default	8192	8511	8192	319	226	1684	388	2072	1880	spneumoniae.S_pseudosimplitigs.k_7.d_3.M_default
spneumoniae	pseudosimplitigs	7	3	ones	8192	8511	8505	6	1	1684	108	1792	1692	spneumoniae.S_pseudosimplitigs.k_7.d_3.M_ones
spneumoniae	pseudosimplitigs	7	3	runs	8192	8511	8505	6	1	1684	108	1792	1692	spneumoniae.S_pseudosimplitigs.k_7.d_3.M_runs
spneumoniae	pseudosimplitigs	7	3	zeros	8192	8511	8192	319	197	1684	412	2096	1884	spneumoniae.S_pseudosimplitigs.k_7.d_3.M_zeros
spneumoniae	pseudosimplitigs	7	4	default	8192	8490	8192	298	222	1716	384	2100	1872	spneumoniae.S_pseudosimplitigs.k_7.d_4.M_default
spneumoniae	pseudosimplitigs	7	4	ones	8192	8490	8484	6	1	1716	108	1824	1724	spneumoniae.S_pseudosimplitigs.k_7.d_4.M_ones
spneumoniae	pseudosimplitigs	7	4	runs	8192	8490	8484	6	1	1716	108	1824	1724	spneumoniae.S_pseudosimplitigs.k_7.d_4.M_runs
spneumoniae	pseudosimplitigs	7	4	zeros	8192	8490	8192	298	195	1716	416	2132	1896	spneumoniae.S_pseudosimplitigs.k_7.d_4.M_zeros
spneumoniae	pseudosimplitigs	7	5	default	8192	8481	8192	289	221	1712	388	2100	1860	spneumoniae.S_pseudosimplitigs.k_7.d_5.M_default
spneumoniae	pseudosimplitigs	7	5	ones	8192	8481	8475	6	1	1712	108	1820	1720	spneumoniae.S_pseudosimplitigs.k_7.d_5.M_ones
spneumoniae	pseudosimplitigs	7	5	runs	8192	8481	8475	6	1	1712	108	1820	1720	spneumoniae.S_pseudosimplitigs.k_7.d_5.M_runs
spneumoniae	pseudosimplitigs	7	5	zeros	8192	8481	8192	289	194	1712	416	2128	1888	spneumoniae.S_pseudosimplitigs.k_7.d_5.M_zeros
spneumoniae	pseudosimplitigs	7	6	default	8192	8481	8192	289	221	1712	388	2100	1860	spneumoniae.S_pseudosimplitigs.k_7.d_6.M_default
spneumoniae	pseudosimplitigs	7	6	ones	8192	8481	8475	6	1	1712	108	1820	1720	spneumoniae.S_pseudosimplitigs.k_7.d_6.M_ones
spneumoniae	pseudosimplitigs	7	6	runs	8192	8481	8475	6	1	1712	108	1820	1720	spneumoniae.S_pseudosimplitigs.k_7.d_6.M_runs
spneumoniae	pseudosimplitigs	7	6	zeros	8192	8481	8192	289	194	1712	416	2128	1888	spneumoniae.S_pseudosimplitigs.k_7.d_6.M_zeros
spneumoniae	pseudosimplitigsAC	7	1	default	8192	8204	8192	12	2	2628	112	2740	2640	spneumoniae.S_pseudosimplitigsAC.k_7.d_1.M_default
spneumoniae	pseudosimplitigsAC	7	1	ones	8192	8204	8198	6	1	2628	108	2736	2632	spneumoniae.S_pseudosimplitigsAC.k_7.d_1.M_ones
spneumoniae	pseudosimplitigsAC	7	1	runs	8192	8204	8198	6	1	2628	108	2736	2632	spneumoniae.S_pseudosimplitigsAC.k_7.d_1.M_runs
spneumoniae	pseudosimplitigsAC	7	1	zeros	8192	8204	8192	12	2	2628	112	2740	2640	spneumoniae.S_pseudosimplitigsAC.k_7.d_1.M_zeros
spneumoniae	pseudosimplitigsAC	7	2	default	8192	8204	8192	12	2	2628	112	2740	2640	spneumoniae.S_pseudosimplitigsAC.k_7.d_2.M_default
spneumoniae	pseudosimplitigsAC	7	2	ones	8192	8204	8198	6	1	2628	108	2736	2632	spneumoniae.S_pseudosimplitigsAC.k_7.d_2.M_ones
spneumoniae	pseudosimplitigsAC	7	2	runs	8192	8204	8198	6	1	2628	108	2736	2632	spneumoniae.S_pseudosimplitigsAC.k_7.d_2.M_runs
spneumoniae	pseudosimplitigsAC	7	2	zeros	8192	8204	8192	12	2	2628	112	2740	2640	spneumoniae.S_pseudosimplitigsAC.k_7.d_2.M_zeros
spneumoniae	pseudosimplitigsAC	7	3	default	8192	8200	8192	8	2	2628	112	2740	2636	spneumoniae.S_pseudosimplitigsAC.k_7.d_3.M_default
spneumoniae	pseudosimplitigsAC	7	3	ones	8192	8200	8194	6	1	2628	108	2736	2632	spneumoniae.S_pseudosimplitigsAC.k_7.d_3.M_ones
spneumoniae	pseudosimplitigsAC	7	3	runs	8192	8200	8194	6	1	2628	108	2736	2632	spneumoniae.S_pseudosimplitigsAC.k_7.d_3.M_runs
spneumoniae	pseudosimplitigsAC	7	3	zeros	8192	8200	8192	8	2	2628	112	2740	2636	spneumoniae.S_pseudosimplitigsAC.k_7.d_3.M_zeros
spneumoniae	pseudosimplitigsAC	7	4	default	8192	8200	8192	8	2	2628	112	2740	2636	spneumoniae.S_pseudosimplitigsAC.k_7.d_4.M_default
spneumoniae	pseudosimplitigsAC	7	4	ones	8192	8200	8194	6	1	2628	108	2736	2632	spneumoniae.S_pseudosimplitigsAC.k_7.d_4.M_ones
spneumoniae	pseudosimplitigsAC	7	4	runs	8192	8200	8194	6	1	2628	108	2736	2632	spneumoniae.S_pseudosimplitigsAC.k_7.d_4.M_runs
spneumoniae	pseudosimplitigsAC	7	4	zeros	8192	8200	8192	8	2	2628	112	2740	2636	spneumoniae.S_pseudosimplitigsAC.k_7.d_4.M_zeros
spneumoniae	pseudosimplitigsAC	7	5	default	8192	8200	8192	8	2	2628	112	2740	2636	spneumoniae.S_pseudosimplitigsAC.k_7.d_5.M_default
spneumoniae	pseudosimplitigsAC	7	5	ones	8192	8200	8194	6	1	2628	108	2736	2632	spneumoniae.S_pseudosimplitigsAC.k_7.d_5.M_ones
spneumoniae	pseudosimplitigsAC	7	5	runs	8192	8200	8194	6	1	2628	108	2736	2632	spneumoniae.S_pseudosimplitigsAC.k_7.d_5.M_runs
spneumoniae	pseudosimplitigsAC	7	5	zeros	8192	8200	8192	8	2	2628	112	2740	2636	spneumoniae.S_pseudosimplitigsAC.k_7.d_5.M_zeros
spneumoniae	pseudosimplitigsAC	7	6	default	8192	8200	8192	8	2	2628	112	2740	2636	spneumoniae.S_pseudosimplitigsAC.k_7.d_6.M_default
spneumoniae	pseudosimplitigsAC	7	6	ones	8192	8200	8194	6	1	2628	108	2736	2632	spneumoniae.S_pseudosimplitigsAC.k_7.d_6.M_ones
spneumoniae	pseudosimplitigsAC	7	6	runs	8192	8200	8194	6	1	2628	108	2736	2632	spneumoniae.S_pseudosimplitigsAC.k_7.d_6.M_runs
spneumoniae	pseudosimplitigsAC	7	6	zeros	8192	8200	8192	8	2	2628	112	2740	2636	spneumoniae.S_pseudosimplitigsAC.k_7.d_6.M_zeros
spneumoniae	pseudosimplitigs	8	1	default	32835	35068	32835	2233	319	4708	564	5272	5656	spneumoniae.S_pseudosimplitigs.k_8.d_1.M_default
spneumoniae	pseudosimplitigs	8	1	ones	32835	35068	35030	38	31	4708	236	4944	4768	spneumoniae.S_pseudosimplitigs.k_8.d_1.M_ones
spneumoniae	pseudosimplitigs	8	1	runs	32835	35068	35024	44	29	4708	240	4948	4760	spneumoniae.S_pseudosimplitigs.k_8.d_1.M_runs
spneumoniae	pseudosimplitigs	8	1	zeros	32835	35068	32835	2233	503	4708	916	5624	5844	spneumoniae.S_pseudosimplitigs.k_8.d_1.M_zeros
spneumoniae	pseudosimplitigs	8	2	default	32835	34549	32835	1714	574	4736	868	5604	5792	spneumoniae.S_pseudosimplitigs.k_8.d_2.M_default
spneumoniae	pseudosimplitigs	8	2	ones	32835	34549	34523	26	20	4736	204	4940	4784	spneumoniae.S_pseudosimplitigs.k_8.d_2.M_ones
spneumoniae	pseudosimplitigs	8	2	runs	32835	34549	34523	26	20	4736	204	4940	4784	spneumoniae.S_pseudosimplitigs.k_8.d_2.M_runs
spneumoniae	pseudosimplitigs	8	2	zeros	32835	34549	32835	1714	581	4736	952	5688	5816	spneumoniae.S_pseudosimplitigs.k_8.d_2.M_zeros
spneumoniae	pseudosimplitigs	8	3	default	32835	34175	32835	1340	674	4488	1000	5488	5340	spneumoniae.S_pseudosimplitigs.k_8.d_3.M_default
spneumoniae	pseudosimplitigs	8	3	ones	32835	34175	34140	35	28	4488	212	4700	4504	spneumoniae.S_pseudosimplitigs.k_8.d_3.M_ones
spneumoniae	pseudosimplitigs	8	3	runs	32835	34175	34136	39	27	4488	212	4700	4508	spneumoniae.S_pseudosimplitigs.k_8.d_3.M_runs
spneumoniae	pseudosimplitigs	8	3	zeros	32835	34175	32835	1340	631	4488	1008	5496	5276	spneumoniae.S_pseudosimplitigs.k_8.d_3.M_zeros
spneumoniae	pseudosimplitigs	8	4	default	32835	34364	32835	1529	934	4396	1156	5552	5436	spneumoniae.S_pseudosimplitigs.k_8.d_4.M_default
spneumoniae	pseudosimplitigs	8	4	ones	32835	34364	34331	33	25	4396	212	4608	4264	spneumoniae.S_pseudosimplitigs.k_8.d_4.M_ones
spneumoniae	pseudosimplitigs	8	4	runs	32835	34364	34329	35	23	4396	212	4608	4264	spneumoniae.S_pseudosimplitigs.k_8.d_4.M_runs
spneumoniae	pseudosimplitigs	8	4	zeros	32835	34364	32835	1529	928	4396	1244	5640	5644	spneumoniae.S_pseudosimplitigs.k_8.d_4.M_zeros
spneumoniae	pseudosimplitigs	8	5	default	32835	34329	32835	1494	930	4156	1160	5316	5480	spneumoniae.S_pseudosimplitigs.k_8.d_5.M_default
spneumoniae	pseudosimplitigs	8	5	ones	32835	34329	34293	36	28	4156	212	4368	4092	spneumoniae.S_pseudosimplitigs.k_8.d_5.M_ones
spneumoniae	pseudosimplitigs	8	5	runs	32835	34329	34292	37	27	4156	216	4372	4092	spneumoniae.S_pseudosimplitigs.k_8.d_5.M_runs
spneumoniae	pseudosimplitigs	8	5	zeros	32835	34329	32835	1494	963	4156	1308	5464	5624	spneumoniae.S_pseudosimplitigs.k_8.d_5.M_zeros
spneumoniae	pseudosimplitigs	8	6	default	32835	34323	32835	1488	933	4376	1164	5540	5444	spneumoniae.S_pseudosimplitigs.k_8.d_6.M_default
spneumoniae	pseudosimplitigs	8	6	ones	32835	34323	34287	36	27	4376	212	4588	4272	spneumoniae.S_pseudosimplitigs.k_8.d_6.M_ones
spneumoniae	pseudosimplitigs	8	6	runs	32835	34323	34287	36	27	4376	212	4588	4272	spneumoniae.S_pseudosimplitigs.k_8.d_6.M_runs
spneumoniae	pseudosimplitigs	8	6	zeros	32835	34323	32835	1488	967	4376	1312	5688	5576	spneumoniae.S_pseudosimplitigs.k_8.d_6.M_zeros
spneumoniae	pseudosimplitigs	8	7	default	32835	34324	32835	1489	934	4380	1164	5544	5440	spneumoniae.S_pseudosimplitigs.k_8.d_7.M_default
spneumoniae	pseudosimplitigs	8	7	ones	32835	34324	34288	36	27	4380	208	4588	4272	spneumoniae.S_pseudosimplitigs.k_8.d_7.M_ones
spneumoniae	pseudosimplitigs	8	7	runs	32835	34324	34288	36	27	4380	208	4588	4272	spneumoniae.S_pseudosimplitigs.k_8.d_7.M_runs
spneumoniae	pseudosimplitigs	8	7	zeros	32835	34324	32835	1489	968	4380	1308	5688	5572	spneumoniae.S_pseudosimplitigs.k_8.d_7.M_zeros
spneumoniae	pseudosimplitigsAC	8	1	default	32835	33941	32835	1106	158	9864	360	10224	10212	spneumoniae.S_pseudosimplitigsAC.k_8.d_1.M_default
spneumoniae	pseudosimplitigsAC	8	1	ones	32835	33941	33886	55	42	9864	248	10112	9928	spneumoniae.S_pseudosimplitigsAC.k_8.d_1.M_ones
spneumoniae	pseudosimplitigsAC	8	1	runs	32835	33941	33860	81	31	9864	240	10104	9928	spneumoniae.S_pseudosimplitigsAC.k_8.d_1.M_runs
spneumoniae	pseudosimplitigsAC	8	1	zeros	32835	33941	32835	1106	222	9864	488	10352	10308	spneumoniae.S_pseudosimplitigsAC.k_8.d_1.M_zeros
spneumoniae	pseudosimplitigsAC	8	2	default	32835	33861	32835	1026	252	9856	512	10368	10336	spneumoniae.S_pseudosimplitigsAC.k_8.d_2.M_default
spneumoniae	pseudosimplitigsAC	8	2	ones	32835	33861	33824	37	31	9856	232	10088	9960	spneumoniae.S_pseudosimplitigsAC.k_8.d_2.M_ones
spneumoniae	pseudosimplitigsAC	8	2	runs	32835	33861	33822	39	30	9856	232	10088	9964	spneumoniae.S_pseudosimplitigsAC.k_8.d_2.M_runs
spneumoniae	pseudosimplitigsAC	8	2	zeros	32835	33861	32835	1026	255	9856	536	10392	10292	spneumoniae.S_pseudosimplitigsAC.k_8.d_2.M_zeros
spneumoniae	pseudosimplitigsAC	8	3	default	32835	33757	32835	922	308	9784	624	10408	10352	spneumoniae.S_pseudosimplitigsAC.k_8.d_3.M_default
spneumoniae	pseudosimplitigsAC	8	3	ones	32835	33757	33720	37	30	9784	236	10020	9932	spneumoniae.S_pseudosimplitigsAC.k_8.d_3.M_ones
spneumoniae	pseudosimplitigsAC	8	3	runs	32835	33757	33720	37	30	9784	236	10020	9932	spneumoniae.S_pseudosimplitigsAC.k_8.d_3.M_runs
spneumoniae	pseudosimplitigsAC	8	3	zeros	32835	33757	32835	922	316	9784	680	10464	10340	spneumoniae.S_pseudosimplitigsAC.k_8.d_3.M_zeros
spneumoniae	pseudosimplitigsAC	8	4	default	32835	33633	32835	798	333	9740	644	10384	10328	spneumoniae.S_pseudosimplitigsAC.k_8.d_4.M_default
spneumoniae	pseudosimplitigsAC	8	4	ones	32835	33633	33593	40	32	9740	240	9980	9904	spneumoniae.S_pseudosimplitigsAC.k_8.d_4.M_ones
spneumoniae	pseudosimplitigsAC	8	4	runs	32835	33633	33593	40	32	9740	240	9980	9904	spneumoniae.S_pseudosimplitigsAC.k_8.d_4.M_runs
spneumoniae	pseudosimplitigsAC	8	4	zeros	32835	33633	32835	798	354	9740	732	10472	10332	spneumoniae.S_pseudosimplitigsAC.k_8.d_4.M_zeros
spneumoniae	pseudosimplitigsAC	8	5	default	32835	33600	32835	765	340	9740	656	10396	10344	spneumoniae.S_pseudosimplitigsAC.k_8.d_5.M_default
spneumoniae	pseudosimplitigsAC	8	5	ones	32835	33600	33559	41	33	9740	240	9980	9904	spneumoniae.S_pseudosimplitigsAC.k_8.d_5.M_ones
spneumoniae	pseudosimplitigsAC	8	5	runs	32835	33600	33558	42	32	9740	240	9980	9904	spneumoniae.S_pseudosimplitigsAC.k_8.d_5.M_runs
spneumoniae	pseudosimplitigsAC	8	5	zeros	32835	33600	32835	765	376	9740	784	10524	10336	spneumoniae.S_pseudosimplitigsAC.k_8.d_5.M_zeros
spneumoniae	pseudosimplitigsAC	8	6	default	32835	33607	32835	772	340	9740	656	10396	10320	spneumoniae.S_pseudosimplitigsAC.k_8.d_6.M_default
spneumoniae	pseudosimplitigsAC	8	6	ones	32835	33607	33567	40	32	9740	240	9980	9888	spneumoniae.S_pseudosimplitigsAC.k_8.d_6.M_ones
spneumoniae	pseudosimplitigsAC	8	6	runs	32835	33607	33566	41	31	9740	240	9980	9888	spneumoniae.S_pseudosimplitigsAC.k_8.d_6.M_runs
spneumoniae	pseudosimplitigsAC	8	6	zeros	32835	33607	32835	772	385	9740	808	10548	10372	spneumoniae.S_pseudosimplitigsAC.k_8.d_6.M_zeros
spneumoniae	pseudosimplitigsAC	8	7	default	32835	33606	32835	771	340	9740	656	10396	10320	spneumoniae.S_pseudosimplitigsAC.k_8.d_7.M_default
spneumoniae	pseudosimplitigsAC	8	7	ones	32835	33606	33566	40	32	9740	240	9980	9888	spneumoniae.S_pseudosimplitigsAC.k_8.d_7.M_ones
spneumoniae	pseudosimplitigsAC	8	7	runs	32835	33606	33565	41	31	9740	240	9980	9888	spneumoniae.S_pseudosimplitigsAC.k_8.d_7.M_runs
spneumoniae	pseudosimplitigsAC	8	7	zeros	32835	33606	32835	771	385	9740	808	10548	10372	spneumoniae.S_pseudosimplitigsAC.k_8.d_7.M_zeros
spneumoniae	pseudosimplitigs	9	1	default	127423	141759	127423	14336	1792	23460	2556	26016	26848	spneumoniae.S_pseudosimplitigs.k_9.d_1.M_default
spneumoniae	pseudosimplitigs	9	1	ones	127423	141759	138939	2820	1798	23460	2840	26300	25548	spneumoniae.S_pseudosimplitigs.k_9.d_1.M_ones
spneumoniae	pseudosimplitigs	9	1	runs	127423	141759	137265	4494	1109	23460	2492	25952	25388	spneumoniae.S_pseudosimplitigs.k_9.d_1.M_runs
spneumoniae	pseudosimplitigs	9	1	zeros	127423	141759	127423	14336	2906	23460	4288	27748	27864	spneumoniae.S_pseudosimplitigs.k_9.d_1.M_zeros
spneumoniae	pseudosimplitigs	9	2	default	127423	136054	127423	8631	3171	21248	3992	25240	25740	spneumoniae.S_pseudosimplitigs.k_9.d_2.M_default
spneumoniae	pseudosimplitigs	9	2	ones	127423	136054	134171	1883	1416	21248	2588	23836	23124	spneumoniae.S_pseudosimplitigs.k_9.d_2.M_ones
spneumoniae	pseudosimplitigs	9	2	runs	127423	136054	133770	2284	1223	21248	2528	23776	23132	spneumoniae.S_pseudosimplitigs.k_9.d_2.M_runs
spneumoniae	pseudosimplitigs	9	2	zeros	127423	136054	127423	8631	3249	21248	4300	25548	25704	spneumoniae.S_pseudosimplitigs.k_9.d_2.M_zeros
spneumoniae	pseudosimplitigs	9	3	default	127423	135379	127423	7956	4330	21240	5112	26352	26540	spneumoniae.S_pseudosimplitigs.k_9.d_3.M_default
spneumoniae	pseudosimplitigs	9	3	ones	127423	135379	133860	1519	1227	21240	2388	23628	22296	spneumoniae.S_pseudosimplitigs.k_9.d_3.M_ones
spneumoniae	pseudosimplitigs	9	3	runs	127423	135379	133690	1689	1136	21240	2376	23616	22288	spneumoniae.S_pseudosimplitigs.k_9.d_3.M_runs
spneumoniae	pseudosimplitigs	9	3	zeros	127423	135379	127423	7956	4277	21240	5132	26372	26260	spneumoniae.S_pseudosimplitigs.k_9.d_3.M_zeros
spneumoniae	pseudosimplitigs	9	4	default	127423	135268	127423	7845	4787	20868	5524	26392	26600	spneumoniae.S_pseudosimplitigs.k_9.d_4.M_default
spneumoniae	pseudosimplitigs	9	4	ones	127423	135268	133867	1401	1204	20868	2308	23176	21908	spneumoniae.S_pseudosimplitigs.k_9.d_4.M_ones
spneumoniae	pseudosimplitigs	9	4	runs	127423	135268	133741	1527	1132	20868	2304	23172	22000	spneumoniae.S_pseudosimplitigs.k_9.d_4.M_runs
spneumoniae	pseudosimplitigs	9	4	zeros	127423	135268	127423	7845	4800	20868	5632	26500	26692	spneumoniae.S_pseudosimplitigs.k_9.d_4.M_zeros
spneumoniae	pseudosimplitigs	9	5	default	127423	135308	127423	7885	4854	21048	5572	26620	26844	spneumoniae.S_pseudosimplitigs.k_9.d_5.M_default
spneumoniae	pseudosimplitigs	9	5	ones	127423	135308	133931	1377	1185	21048	2296	23344	21872	spneumoniae.S_pseudosimplitigs.k_9.d_5.M_ones
spneumoniae	pseudosimplitigs	9	5	runs	127423	135308	133846	1462	1130	21048	2304	23352	21920	spneumoniae.S_pseudosimplitigs.k_9.d_5.M_runs
spneumoniae	pseudosimplitigs	9	5	zeros	127423	135308	127423	7885	4888	21048	5708	26756	26860	spneumoniae.S_pseudosimplitigs.k_9.d_5.M_zeros
spneumoniae	pseudosimplitigs	9	6	default	127423	135275	127423	7852	4847	21040	5572	26612	26828	spneumoniae.S_pseudosimplitigs.k_9.d_6.M_default
spneumoniae	pseudosimplitigs	9	6	ones	127423	135275	133910	1365	1195	21040	2296	23336	21884	spneumoniae.S_pseudosimplitigs.k_9.d_6.M_ones
spneumoniae	pseudosimplitigs	9	6	runs	127423	135275	133807	1468	1135	21040	2304	23344	21876	spneumoniae.S_pseudosimplitigs.k_9.d_6.M_runs
spneumoniae	pseudosimplitigs	9	6	zeros	127423	135275	127423	7852	4882	21040	5712	26752	26836	spneumoniae.S_pseudosimplitigs.k_9.d_6.M_zeros
spneumoniae	pseudosimplitigs	9	7	default	127423	135234	127423	7811	4847	20884	5588	26472	26760	spneumoniae.S_pseudosimplitigs.k_9.d_7.M_default
spneumoniae	pseudosimplitigs	9	7	ones	127423	135234	133874	1360	1183	20884	2292	23176	21816	spneumoniae.S_pseudosimplitigs.k_9.d_7.M_ones
spneumoniae	pseudosimplitigs	9	7	runs	127423	135234	133797	1437	1132	20884	2292	23176	21808	spneumoniae.S_pseudosimplitigs.k_9.d_7.M_runs
spneumoniae	pseudosimplitigs	9	7	zeros	127423	135234	127423	7811	4891	20884	5732	26616	26844	spneumoniae.S_pseudosimplitigs.k_9.d_7.M_zeros
spneumoniae	pseudosimplitigs	9	8	default	127423	135228	127423	7805	4845	20976	5600	26576	27296	spneumoniae.S_pseudosimplitigs.k_9.d_8.M_default
spneumoniae	pseudosimplitigs	9	8	ones	127423	135228	133850	1378	1199	20976	2312	23288	21872	spneumoniae.S_pseudosimplitigs.k_9.d_8.M_ones
spneumoniae	pseudosimplitigs	9	8	runs	127423	135228	133757	1471	1139	20976	2316	23292	21908	spneumoniae.S_pseudosimplitigs.k_9.d_8.M_runs
spneumoniae	pseudosimplitigs	9	8	zeros	127423	135228	127423	7805	4965	20976	5844	26820	26908	spneumoniae.S_pseudosimplitigs.k_9.d_8.M_zeros
spneumoniae	pseudosimplitigsAC	9	1	default	127423	139159	127423	11736	1467	38976	2316	41292	41340	spneumoniae.S_pseudosimplitigsAC.k_9.d_1.M_default
spneumoniae	pseudosimplitigsAC	9	1	ones	127423	139159	136109	3050	1908	38976	2880	41856	41024	spneumoniae.S_pseudosimplitigsAC.k_9.d_1.M_ones
spneumoniae	pseudosimplitigsAC	9	1	runs	127423	139159	134163	4996	1109	38976	2548	41524	40772	spneumoniae.S_pseudosimplitigsAC.k_9.d_1.M_runs
spneumoniae	pseudosimplitigsAC	9	1	zeros	127423	139159	127423	11736	2326	38976	3652	42628	42124	spneumoniae.S_pseudosimplitigsAC.k_9.d_1.M_zeros
spneumoniae	pseudosimplitigsAC	9	2	default	127423	134189	127423	6766	2412	37644	3232	40876	40852	spneumoniae.S_pseudosimplitigsAC.k_9.d_2.M_default
spneumoniae	pseudosimplitigsAC	9	2	ones	127423	134189	132350	1839	1347	37644	2372	40016	39312	spneumoniae.S_pseudosimplitigsAC.k_9.d_2.M_ones
spneumoniae	pseudosimplitigsAC	9	2	runs	127423	134189	131930	2259	1133	37644	2288	39932	39264	spneumoniae.S_pseudosimplitigsAC.k_9.d_2.M_runs
spneumoniae	pseudosimplitigsAC	9	2	zeros	127423	134189	127423	6766	2448	37644	3348	40992	40648	spneumoniae.S_pseudosimplitigsAC.k_9.d_2.M_zeros
spneumoniae	pseudosimplitigsAC	9	3	default	127423	133619	127423	6196	2838	37424	3656	41080	40924	spneumoniae.S_pseudosimplitigsAC.k_9.d_3.M_default
spneumoniae	pseudosimplitigsAC	9	3	ones	127423	133619	132241	1378	1148	37424	2200	39624	39104	spneumoniae.S_pseudosimplitigsAC.k_9.d_3.M_ones
spneumoniae	pseudosimplitigsAC	9	3	runs	127423	133619	132092	1527	1078	37424	2184	39608	39124	spneumoniae.S_pseudosimplitigsAC.k_9.d_3.M_runs
spneumoniae	pseudosimplitigsAC	9	3	zeros	127423	133619	127423	6196	2865	37424	3828	41252	40712	spneumoniae.S_pseudosimplitigsAC.k_9.d_3.M_zeros
spneumoniae	pseudosimplitigsAC	9	4	default	127423	133372	127423	5949	3034	37376	3864	41240	40768	spneumoniae.S_pseudosimplitigsAC.k_9.d_4.M_default
spneumoniae	pseudosimplitigsAC	9	4	ones	127423	133372	132082	1290	1100	37376	2164	39540	38940	spneumoniae.S_pseudosimplitigsAC.k_9.d_4.M_ones
spneumoniae	pseudosimplitigsAC	9	4	runs	127423	133372	132026	1346	1065	37376	2176	39552	38928	spneumoniae.S_pseudosimplitigsAC.k_9.d_4.M_runs
spneumoniae	pseudosimplitigsAC	9	4	zeros	127423	133372	127423	5949	3132	37376	4180	41556	40844	spneumoniae.S_pseudosimplitigsAC.k_9.d_4.M_zeros
spneumoniae	pseudosimplitigsAC	9	5	default	127423	133144	127423	5721	3072	37332	3912	41244	40388	spneumoniae.S_pseudosimplitigsAC.k_9.d_5.M_default
spneumoniae	pseudosimplitigsAC	9	5	ones	127423	133144	131860	1284	1117	37332	2164	39496	39084	spneumoniae.S_pseudosimplitigsAC.k_9.d_5.M_ones
spneumoniae	pseudosimplitigsAC	9	5	runs	127423	133144	131823	1321	1090	37332	2168	39500	38952	spneumoniae.S_pseudosimplitigsAC.k_9.d_5.M_runs
spneumoniae	pseudosimplitigsAC	9	5	zeros	127423	133144	127423	5721	3253	37332	4404	41736	41368	spneumoniae.S_pseudosimplitigsAC.k_9.d_5.M_zeros
spneumoniae	pseudosimplitigsAC	9	6	default	127423	133144	127423	5721	3087	37296	3924	41220	40388	spneumoniae.S_pseudosimplitigsAC.k_9.d_6.M_default
spneumoniae	pseudosimplitigsAC	9	6	ones	127423	133144	131862	1282	1109	37296	2164	39460	39144	spneumoniae.S_pseudosimplitigsAC.k_9.d_6.M_ones
spneumoniae	pseudosimplitigsAC	9	6	runs	127423	133144	131826	1318	1084	37296	2184	39480	39444	spneumoniae.S_pseudosimplitigsAC.k_9.d_6.M_runs
spneumoniae	pseudosimplitigsAC	9	6	zeros	127423	133144	127423	5721	3364	37296	4608	41904	41328	spneumoniae.S_pseudosimplitigsAC.k_9.d_6.M_zeros
spneumoniae	pseudosimplitigsAC	9	7	default	127423	133116	127423	5693	3086	37280	3932	41212	40372	spneumoniae.S_pseudosimplitigsAC.k_9.d_7.M_default
spneumoniae	pseudosimplitigsAC	9	7	ones	127423	133116	131812	1304	1118	37280	2176	39456	39144	spneumoniae.S_pseudosimplitigsAC.k_9.d_7.M_ones
spneumoniae	pseudosimplitigsAC	9	7	runs	127423	133116	131764	1352	1086	37280	2192	39472	38836	spneumoniae.S_pseudosimplitigsAC.k_9.d_7.M_runs
spneumoniae	pseudosimplitigsAC	9	7	zeros	127423	133116	127423	5693	3363	37280	4608	41888	41300	spneumoniae.S_pseudosimplitigsAC.k_9.d_7.M_zeros
spneumoniae	pseudosimplitigsAC	9	8	default	127423	133134	127423	5711	3088	37288	3932	41220	40376	spneumoniae.S_pseudosimplitigsAC.k_9.d_8.M_default
spneumoniae	pseudosimplitigsAC	9	8	ones	127423	133134	131831	1303	1120	37288	2180	39468	39144	spneumoniae.S_pseudosimplitigsAC.k_9.d_8.M_ones
spneumoniae	pseudosimplitigsAC	9	8	runs	127423	133134	131780	1354	1088	37288	2192	39480	38872	spneumoniae.S_pseudosimplitigsAC.k_9.d_8.M_runs
spneumoniae	pseudosimplitigsAC	9	8	zeros	127423	133134	127423	5711	3365	37288	4612	41900	41304	spneumoniae.S_pseudosimplitigsAC.k_9.d_8.M_zeros
spneumoniae	pseudosimplitigs	10	1	default	427303	624691	427303	197388	21932	149552	20092	169644	177392	spneumoniae.S_pseudosimplitigs.k_10.d_1.M_default
spneumoniae	pseudosimplitigs	10	1	ones	427303	624691	565971	58720	32834	149552	33824	183376	180768	spneumoniae.S_pseudosimplitigs.k_10.d_1.M_ones
spneumoniae	pseudosimplitigs	10	1	runs	427303	624691	527118	97573	17569	149552	26920	176472	175180	spneumoniae.S_pseudosimplitigs.k_10.d_1.M_runs
spneumoniae	pseudosimplitigs	10	1	zeros	427303	624691	427303	197388	34390	149552	35816	185368	188068	spneumoniae.S_pseudosimplitigs.k_10.d_1.M_zeros
spneumoniae	pseudosimplitigs	10	2	default	427303	532380	427303	105077	34781	120784	27532	148316	151104	spneumoniae.S_pseudosimplitigs.k_10.d_2.M_default
spneumoniae	pseudosimplitigs	10	2	ones	427303	532380	496758	35622	23906	120784	25128	145912	142916	spneumoniae.S_pseudosimplitigs.k_10.d_2.M_ones
spneumoniae	pseudosimplitigs	10	2	runs	427303	532380	484811	47569	18460	120784	23576	144360	141808	spneumoniae.S_pseudosimplitigs.k_10.d_2.M_runs
spneumoniae	pseudosimplitigs	10	2	zeros	427303	532380	427303	105077	35737	120784	29404	150188	152248	spneumoniae.S_pseudosimplitigs.k_10.d_2.M_zeros
spneumoniae	pseudosimplitigs	10	3	default	427303	508058	427303	80755	38276	114412	29672	144084	144372	spneumoniae.S_pseudosimplitigs.k_10.d_3.M_default
spneumoniae	pseudosimplitigs	10	3	ones	427303	508058	479272	28786	21259	114412	22568	136980	134316	spneumoniae.S_pseudosimplitigs.k_10.d_3.M_ones
spneumoniae	pseudosimplitigs	10	3	runs	427303	508058	474216	33842	18790	114412	21988	136400	133824	spneumoniae.S_pseudosimplitigs.k_10.d_3.M_runs
spneumoniae	pseudosimplitigs	10	3	zeros	427303	508058	427303	80755	38291	114412	29956	144368	144372	spneumoniae.S_pseudosimplitigs.k_10.d_3.M_zeros
spneumoniae	pseudosimplitigs	10	4	default	427303	501039	427303	73736	41475	112660	31492	144152	142768	spneumoniae.S_pseudosimplitigs.k_10.d_4.M_default
spneumoniae	pseudosimplitigs	10	4	ones	427303	501039	476725	24314	18740	112660	20252	132912	130176	spneumoniae.S_pseudosimplitigs.k_10.d_4.M_ones
spneumoniae	pseudosimplitigs	10	4	runs	427303	501039	474170	26869	17380	112660	20072	132732	130180	spneumoniae.S_pseudosimplitigs.k_10.d_4.M_runs
spneumoniae	pseudosimplitigs	10	4	zeros	427303	501039	427303	73736	41450	112660	31516	144176	142752	spneumoniae.S_pseudosimplitigs.k_10.d_4.M_zeros
spneumoniae	pseudosimplitigs	10	5	default	427303	498129	427303	70826	41760	111660	31828	143488	141660	spneumoniae.S_pseudosimplitigs.k_10.d_5.M_default
spneumoniae	pseudosimplitigs	10	5	ones	427303	498129	474179	23950	18592	111660	20216	131876	129240	spneumoniae.S_pseudosimplitigs.k_10.d_5.M_ones
spneumoniae	pseudosimplitigs	10	5	runs	427303	498129	472323	25806	17500	111660	20032	131692	128980	spneumoniae.S_pseudosimplitigs.k_10.d_5.M_runs
spneumoniae	pseudosimplitigs	10	5	zeros	427303	498129	427303	70826	42387	111660	32672	144332	143016	spneumoniae.S_pseudosimplitigs.k_10.d_5.M_zeros
spneumoniae	pseudosimplitigs	10	6	default	427303	496827	427303	69524	41736	111448	31984	143432	141200	spneumoniae.S_pseudosimplitigs.k_10.d_6.M_default
spneumoniae	pseudosimplitigs	10	6	ones	427303	496827	473486	23341	18424	111448	20016	131464	128924	spneumoniae.S_pseudosimplitigs.k_10.d_6.M_ones
spneumoniae	pseudosimplitigs	10	6	runs	427303	496827	471860	24967	17417	111448	19952	131400	128664	spneumoniae.S_pseudosimplitigs.k_10.d_6.M_runs
spneumoniae	pseudosimplitigs	10	6	zeros	427303	496827	427303	69524	42653	111448	33092	144540	143412	spneumoniae.S_pseudosimplitigs.k_10.d_6.M_zeros
spneumoniae	pseudosimplitigs	10	7	default	427303	496570	427303	69267	41741	111348	32024	143372	141048	spneumoniae.S_pseudosimplitigs.k_10.d_7.M_default
spneumoniae	pseudosimplitigs	10	7	ones	427303	496570	473232	23338	18363	111348	19968	131316	128812	spneumoniae.S_pseudosimplitigs.k_10.d_7.M_ones
spneumoniae	pseudosimplitigs	10	7	runs	427303	496570	471782	24788	17415	111348	19896	131244	128860	spneumoniae.S_pseudosimplitigs.k_10.d_7.M_runs
spneumoniae	pseudosimplitigs	10	7	zeros	427303	496570	427303	69267	42660	111348	33132	144480	143264	spneumoniae.S_pseudosimplitigs.k_10.d_7.M_zeros
spneumoniae	pseudosimplitigs	10	8	default	427303	496486	427303	69183	41733	111312	32084	143396	140932	spneumoniae.S_pseudosimplitigs.k_10.d_8.M_default
spneumoniae	pseudosimplitigs	10	8	ones	427303	496486	473228	23258	18398	111312	19956	131268	128748	spneumoniae.S_pseudosimplitigs.k_10.d_8.M_ones
spneumoniae	pseudosimplitigs	10	8	runs	427303	496486	471712	24774	17400	111312	19900	131212	128804	spneumoniae.S_pseudosimplitigs.k_10.d_8.M_runs
spneumoniae	pseudosimplitigs	10	8	zeros	427303	496486	427303	69183	42653	111312	33188	144500	143156	spneumoniae.S_pseudosimplitigs.k_10.d_8.M_zeros
spneumoniae	pseudosimplitigs	10	9	default	427303	496557	427303	69254	41714	111312	32092	143404	140872	spneumoniae.S_pseudosimplitigs.k_10.d_9.M_default
spneumoniae	pseudosimplitigs	10	9	ones	427303	496557	473435	23122	18325	111312	19932	131244	128740	spneumoniae.S_pseudosimplitigs.k_10.d_9.M_ones
spneumoniae	pseudosimplitigs	10	9	runs	427303	496557	472014	24543	17394	111312	19932	131244	128708	spneumoniae.S_pseudosimplitigs.k_10.d_9.M_runs
spneumoniae	pseudosimplitigs	10	9	zeros	427303	496557	427303	69254	42634	111312	33192	144504	143088	spneumoniae.S_pseudosimplitigs.k_10.d_9.M_zeros
spneumoniae	pseudosimplitigsAC	10	1	default	427303	624259	427303	196956	21884	173020	19192	192212	199036	spneumoniae.S_pseudosimplitigsAC.k_10.d_1.M_default
spneumoniae	pseudosimplitigsAC	10	1	ones	427303	624259	564830	59429	33062	173020	33376	206396	201344	spneumoniae.S_pseudosimplitigsAC.k_10.d_1.M_ones
spneumoniae	pseudosimplitigsAC	10	1	runs	427303	624259	525160	99099	17623	173020	26624	199644	196456	spneumoniae.S_pseudosimplitigsAC.k_10.d_1.M_runs
spneumoniae	pseudosimplitigsAC	10	1	zeros	427303	624259	427303	196956	35722	173020	34908	207928	209016	spneumoniae.S_pseudosimplitigsAC.k_10.d_1.M_zeros
spneumoniae	pseudosimplitigsAC	10	2	default	427303	534658	427303	107355	33859	148268	25244	173512	175540	spneumoniae.S_pseudosimplitigsAC.k_10.d_2.M_default
spneumoniae	pseudosimplitigsAC	10	2	ones	427303	534658	500053	34605	22764	148268	23572	171840	168604	spneumoniae.S_pseudosimplitigsAC.k_10.d_2.M_ones
spneumoniae	pseudosimplitigsAC	10	2	runs	427303	534658	488078	46580	17313	148268	21784	170052	167120	spneumoniae.S_pseudosimplitigsAC.k_10.d_2.M_runs
spneumoniae	pseudosimplitigsAC	10	2	zeros	427303	534658	427303	107355	34716	148268	27184	175452	176080	spneumoniae.S_pseudosimplitigsAC.k_10.d_2.M_zeros
spneumoniae	pseudosimplitigsAC	10	3	default	427303	507706	427303	80403	37314	140548	27504	168052	166820	spneumoniae.S_pseudosimplitigsAC.k_10.d_3.M_default
spneumoniae	pseudosimplitigsAC	10	3	ones	427303	507706	481174	26532	19289	140548	20472	161020	157592	spneumoniae.S_pseudosimplitigsAC.k_10.d_3.M_ones
spneumoniae	pseudosimplitigsAC	10	3	runs	427303	507706	476607	31099	17000	140548	19908	160456	157052	spneumoniae.S_pseudosimplitigsAC.k_10.d_3.M_runs
spneumoniae	pseudosimplitigsAC	10	3	zeros	427303	507706	427303	80403	37327	140548	28620	169168	167720	spneumoniae.S_pseudosimplitigsAC.k_10.d_3.M_zeros
spneumoniae	pseudosimplitigsAC	10	4	default	427303	497779	427303	70476	37961	137208	28000	165208	162676	spneumoniae.S_pseudosimplitigsAC.k_10.d_4.M_default
spneumoniae	pseudosimplitigsAC	10	4	ones	427303	497779	474029	23750	18113	137208	19528	156736	153776	spneumoniae.S_pseudosimplitigsAC.k_10.d_4.M_ones
spneumoniae	pseudosimplitigsAC	10	4	runs	427303	497779	471730	26049	16855	137208	19312	156520	153420	spneumoniae.S_pseudosimplitigsAC.k_10.d_4.M_runs
spneumoniae	pseudosimplitigsAC	10	4	zeros	427303	497779	427303	70476	38190	137208	29656	166864	164700	spneumoniae.S_pseudosimplitigsAC.k_10.d_4.M_zeros
spneumoniae	pseudosimplitigsAC	10	5	default	427303	494642	427303	67339	38138	137124	28288	165412	161936	spneumoniae.S_pseudosimplitigsAC.k_10.d_5.M_default
spneumoniae	pseudosimplitigsAC	10	5	ones	427303	494642	471838	22804	17866	137124	19336	156460	152120	spneumoniae.S_pseudosimplitigsAC.k_10.d_5.M_ones
spneumoniae	pseudosimplitigsAC	10	5	runs	427303	494642	470231	24411	16870	137124	19220	156344	152308	spneumoniae.S_pseudosimplitigsAC.k_10.d_5.M_runs
spneumoniae	pseudosimplitigsAC	10	5	zeros	427303	494642	427303	67339	38572	137124	30292	167416	163792	spneumoniae.S_pseudosimplitigsAC.k_10.d_5.M_zeros
spneumoniae	pseudosimplitigsAC	10	6	default	427303	493972	427303	66669	38184	136888	28384	165272	161576	spneumoniae.S_pseudosimplitigsAC.k_10.d_6.M_default
spneumoniae	pseudosimplitigsAC	10	6	ones	427303	493972	471579	22393	17731	136888	19184	156072	151748	spneumoniae.S_pseudosimplitigsAC.k_10.d_6.M_ones
spneumoniae	pseudosimplitigsAC	10	6	runs	427303	493972	470172	23800	16847	136888	19144	156032	151624	spneumoniae.S_pseudosimplitigsAC.k_10.d_6.M_runs
spneumoniae	pseudosimplitigsAC	10	6	zeros	427303	493972	427303	66669	38618	136888	30392	167280	163452	spneumoniae.S_pseudosimplitigsAC.k_10.d_6.M_zeros
spneumoniae	pseudosimplitigsAC	10	7	default	427303	493820	427303	66517	38186	136796	28452	165248	161472	spneumoniae.S_pseudosimplitigsAC.k_10.d_7.M_default
spneumoniae	pseudosimplitigsAC	10	7	ones	427303	493820	471404	22416	17702	136796	19176	155972	151636	spneumoniae.S_pseudosimplitigsAC.k_10.d_7.M_ones
spneumoniae	pseudosimplitigsAC	10	7	runs	427303	493820	470024	23796	16847	136796	19144	155940	151800	spneumoniae.S_pseudosimplitigsAC.k_10.d_7.M_runs
spneumoniae	pseudosimplitigsAC	10	7	zeros	427303	493820	427303	66517	38622	136796	30472	167268	163328	spneumoniae.S_pseudosimplitigsAC.k_10.d_7.M_zeros
spneumoniae	pseudosimplitigsAC	10	8	default	427303	493879	427303	66576	38216	136800	28504	165304	161380	spneumoniae.S_pseudosimplitigsAC.k_10.d_8.M_default
spneumoniae	pseudosimplitigsAC	10	8	ones	427303	493879	471496	22383	17691	136800	19188	155988	151608	spneumoniae.S_pseudosimplitigsAC.k_10.d_8.M_ones
spneumoniae	pseudosimplitigsAC	10	8	runs	427303	493879	470229	23650	16862	136800	19156	155956	152388	spneumoniae.S_pseudosimplitigsAC.k_10.d_8.M_runs
spneumoniae	pseudosimplitigsAC	10	8	zeros	427303	493879	427303	66576	38651	136800	30524	167324	163240	spneumoniae.S_pseudosimplitigsAC.k_10.d_8.M_zeros
spneumoniae	pseudosimplitigsAC	10	9	default	427303	493940	427303	66637	38228	136792	28544	165336	161344	spneumoniae.S_pseudosimplitigsAC.k_10.d_9.M_default
spneumoniae	pseudosimplitigsAC	10	9	ones	427303	493940	471472	22468	17739	136792	19208	156000	151628	spneumoniae.S_pseudosimplitigsAC.k_10.d_9.M_ones
spneumoniae	pseudosimplitigsAC	10	9	runs	427303	493940	470161	23779	16882	136792	19140	155932	152100	spneumoniae.S_pseudosimplitigsAC.k_10.d_9.M_runs
spneumoniae	pseudosimplitigsAC	10	9	zeros	427303	493940	427303	66637	38664	136792	30548	167340	163200	spneumoniae.S_pseudosimplitigsAC.k_10.d_9.M_zeros
spneumoniae	pseudosimplitigs	11	1	default	1004213	1906113	1004213	901900	90190	498028	66864	564892	596012	spneumoniae.S_pseudosimplitigs.k_11.d_1.M_default
spneumoniae	pseudosimplitigs	11	1	ones	1004213	1906113	1520811	385302	171123	498028	156048	654076	646440	spneumoniae.S_pseudosimplitigs.k_11.d_1.M_ones
spneumoniae	pseudosimplitigs	11	1	runs	1004213	1906113	1310677	595436	80575	498028	105852	603880	603624	spneumoniae.S_pseudosimplitigs.k_11.d_1.M_runs
spneumoniae	pseudosimplitigs	11	1	zeros	1004213	1906113	1004213	901900	137189	498028	128056	626084	638048	spneumoniae.S_pseudosimplitigs.k_11.d_1.M_zeros
spneumoniae	pseudosimplitigs	11	10	default	1004213	1272953	1004213	268740	155971	325800	103176	428976	423140	spneumoniae.S_pseudosimplitigs.k_11.d_10.M_default
spneumoniae	pseudosimplitigs	11	10	ones	1004213	1272953	1149503	123450	88238	325800	77992	403792	399208	spneumoniae.S_pseudosimplitigs.k_11.d_10.M_ones
spneumoniae	pseudosimplitigs	11	10	runs	1004213	1272953	1141734	131219	82991	325800	77512	403312	398600	spneumoniae.S_pseudosimplitigs.k_11.d_10.M_runs
spneumoniae	pseudosimplitigs	11	10	zeros	1004213	1272953	1004213	268740	158763	325800	106332	432132	427844	spneumoniae.S_pseudosimplitigs.k_11.d_10.M_zeros
spneumoniae	pseudosimplitigs	11	2	default	1004213	1485514	1004213	481301	136025	384744	90284	475028	491048	spneumoniae.S_pseudosimplitigs.k_11.d_2.M_default
spneumoniae	pseudosimplitigs	11	2	ones	1004213	1485514	1262729	222785	117616	384744	105356	490100	486380	spneumoniae.S_pseudosimplitigs.k_11.d_2.M_ones
spneumoniae	pseudosimplitigs	11	2	runs	1004213	1485514	1183878	301636	80195	384744	88000	472744	473396	spneumoniae.S_pseudosimplitigs.k_11.d_2.M_runs
spneumoniae	pseudosimplitigs	11	2	zeros	1004213	1485514	1004213	481301	140433	384744	99404	484148	495220	spneumoniae.S_pseudosimplitigs.k_11.d_2.M_zeros
spneumoniae	pseudosimplitigs	11	3	default	1004213	1347165	1004213	342952	149784	346996	98112	445108	449408	spneumoniae.S_pseudosimplitigs.k_11.d_3.M_default
spneumoniae	pseudosimplitigs	11	3	ones	1004213	1347165	1184109	163056	99578	346996	87712	434708	430688	spneumoniae.S_pseudosimplitigs.k_11.d_3.M_ones
spneumoniae	pseudosimplitigs	11	3	runs	1004213	1347165	1150761	196404	82632	346996	81484	428480	426952	spneumoniae.S_pseudosimplitigs.k_11.d_3.M_runs
spneumoniae	pseudosimplitigs	11	3	zeros	1004213	1347165	1004213	342952	150044	346996	99372	446368	449904	spneumoniae.S_pseudosimplitigs.k_11.d_3.M_zeros
spneumoniae	pseudosimplitigs	11	4	default	1004213	1297090	1004213	292877	154362	333088	100852	433940	432204	spneumoniae.S_pseudosimplitigs.k_11.d_4.M_default
spneumoniae	pseudosimplitigs	11	4	ones	1004213	1297090	1159707	137383	91497	333088	80380	413468	408904	spneumoniae.S_pseudosimplitigs.k_11.d_4.M_ones
spneumoniae	pseudosimplitigs	11	4	runs	1004213	1297090	1143367	153723	82335	333088	77900	410988	407544	spneumoniae.S_pseudosimplitigs.k_11.d_4.M_runs
spneumoniae	pseudosimplitigs	11	4	zeros	1004213	1297090	1004213	292877	154341	333088	101080	434168	432312	spneumoniae.S_pseudosimplitigs.k_11.d_4.M_zeros
spneumoniae	pseudosimplitigs	11	5	default	1004213	1280609	1004213	276396	155498	329096	102416	431512	426976	spneumoniae.S_pseudosimplitigs.k_11.d_5.M_default
spneumoniae	pseudosimplitigs	11	5	ones	1004213	1280609	1152428	128181	89314	329096	78908	408004	403980	spneumoniae.S_pseudosimplitigs.k_11.d_5.M_ones
spneumoniae	pseudosimplitigs	11	5	runs	1004213	1280609	1141395	139214	82633	329096	77664	406760	403252	spneumoniae.S_pseudosimplitigs.k_11.d_5.M_runs
spneumoniae	pseudosimplitigs	11	5	zeros	1004213	1280609	1004213	276396	156065	329096	103188	432284	429656	spneumoniae.S_pseudosimplitigs.k_11.d_5.M_zeros
spneumoniae	pseudosimplitigs	11	6	default	1004213	1274886	1004213	270673	155935	326792	102680	429472	424684	spneumoniae.S_pseudosimplitigs.k_11.d_6.M_default
spneumoniae	pseudosimplitigs	11	6	ones	1004213	1274886	1149677	125209	88527	326792	78276	405068	400700	spneumoniae.S_pseudosimplitigs.k_11.d_6.M_ones
spneumoniae	pseudosimplitigs	11	6	runs	1004213	1274886	1140954	133932	82911	326792	77548	404340	400392	spneumoniae.S_pseudosimplitigs.k_11.d_6.M_runs
spneumoniae	pseudosimplitigs	11	6	zeros	1004213	1274886	1004213	270673	158256	326792	105348	432140	428592	spneumoniae.S_pseudosimplitigs.k_11.d_6.M_zeros
spneumoniae	pseudosimplitigs	11	7	default	1004213	1272813	1004213	268600	155948	326348	102900	429248	423336	spneumoniae.S_pseudosimplitigs.k_11.d_7.M_default
spneumoniae	pseudosimplitigs	11	7	ones	1004213	1272813	1149122	123691	88188	326348	78012	404360	400276	spneumoniae.S_pseudosimplitigs.k_11.d_7.M_ones
spneumoniae	pseudosimplitigs	11	7	runs	1004213	1272813	1141243	131570	82960	326348	77428	403776	399496	spneumoniae.S_pseudosimplitigs.k_11.d_7.M_runs
spneumoniae	pseudosimplitigs	11	7	zeros	1004213	1272813	1004213	268600	158698	326348	105928	432276	428508	spneumoniae.S_pseudosimplitigs.k_11.d_7.M_zeros
spneumoniae	pseudosimplitigs	11	8	default	1004213	1272496	1004213	268283	155943	325824	103032	428856	423388	spneumoniae.S_pseudosimplitigs.k_11.d_8.M_default
spneumoniae	pseudosimplitigs	11	8	ones	1004213	1272496	1149063	123433	88150	325824	77960	403784	399172	spneumoniae.S_pseudosimplitigs.k_11.d_8.M_ones
spneumoniae	pseudosimplitigs	11	8	runs	1004213	1272496	1141342	131154	82952	325824	77480	403304	398728	spneumoniae.S_pseudosimplitigs.k_11.d_8.M_runs
spneumoniae	pseudosimplitigs	11	8	zeros	1004213	1272496	1004213	268283	158735	325824	106188	432012	428100	spneumoniae.S_pseudosimplitigs.k_11.d_8.M_zeros
spneumoniae	pseudosimplitigs	11	9	default	1004213	1272495	1004213	268282	155961	325772	103172	428944	423228	spneumoniae.S_pseudosimplitigs.k_11.d_9.M_default
spneumoniae	pseudosimplitigs	11	9	ones	1004213	1272495	1149237	123258	88150	325772	77956	403728	399100	spneumoniae.S_pseudosimplitigs.k_11.d_9.M_ones
spneumoniae	pseudosimplitigs	11	9	runs	1004213	1272495	1141566	130929	82961	325772	77488	403260	399012	spneumoniae.S_pseudosimplitigs.k_11.d_9.M_runs
spneumoniae	pseudosimplitigs	11	9	zeros	1004213	1272495	1004213	268282	158753	325772	106328	432100	427928	spneumoniae.S_pseudosimplitigs.k_11.d_9.M_zeros
spneumoniae	pseudosimplitigsAC	11	1	default	1004213	1906133	1004213	901920	90192	517620	63192	580812	618064	spneumoniae.S_pseudosimplitigsAC.k_11.d_1.M_default
spneumoniae	pseudosimplitigsAC	11	1	ones	1004213	1906133	1516999	389134	171956	517620	154028	671648	663756	spneumoniae.S_pseudosimplitigsAC.k_11.d_1.M_ones
spneumoniae	pseudosimplitigsAC	11	1	runs	1004213	1906133	1301170	604963	80263	517620	104196	621816	622204	spneumoniae.S_pseudosimplitigsAC.k_11.d_1.M_runs
spneumoniae	pseudosimplitigsAC	11	1	zeros	1004213	1906133	1004213	901920	143546	517620	126256	643876	656500	spneumoniae.S_pseudosimplitigsAC.k_11.d_1.M_zeros
spneumoniae	pseudosimplitigsAC	11	10	default	1004213	1263414	1004213	259201	147776	342776	91728	434504	427524	spneumoniae.S_pseudosimplitigsAC.k_11.d_10.M_default
spneumoniae	pseudosimplitigsAC	11	10	ones	1004213	1263414	1146646	116768	84326	342776	72972	415748	408224	spneumoniae.S_pseudosimplitigsAC.k_11.d_10.M_ones
spneumoniae	pseudosimplitigsAC	11	10	runs	1004213	1263414	1139901	123513	79719	342776	72556	415332	407680	spneumoniae.S_pseudosimplitigsAC.k_11.d_10.M_runs
spneumoniae	pseudosimplitigsAC	11	10	zeros	1004213	1263414	1004213	259201	150100	342776	96716	439492	432756	spneumoniae.S_pseudosimplitigsAC.k_11.d_10.M_zeros
spneumoniae	pseudosimplitigsAC	11	2	default	1004213	1485898	1004213	481685	132107	404112	82568	486680	502164	spneumoniae.S_pseudosimplitigsAC.k_11.d_2.M_default
spneumoniae	pseudosimplitigsAC	11	2	ones	1004213	1485898	1266490	219408	114362	404112	100632	504744	496912	spneumoniae.S_pseudosimplitigsAC.k_11.d_2.M_ones
spneumoniae	pseudosimplitigsAC	11	2	runs	1004213	1485898	1187603	298295	76898	404112	82980	487092	484496	spneumoniae.S_pseudosimplitigsAC.k_11.d_2.M_runs
spneumoniae	pseudosimplitigsAC	11	2	zeros	1004213	1485898	1004213	481685	136562	404112	91960	496072	505820	spneumoniae.S_pseudosimplitigsAC.k_11.d_2.M_zeros
spneumoniae	pseudosimplitigsAC	11	3	default	1004213	1341411	1004213	337198	144150	365300	88948	454248	455644	spneumoniae.S_pseudosimplitigsAC.k_11.d_3.M_default
spneumoniae	pseudosimplitigsAC	11	3	ones	1004213	1341411	1182943	158468	95598	365300	83088	448388	440376	spneumoniae.S_pseudosimplitigsAC.k_11.d_3.M_ones
spneumoniae	pseudosimplitigsAC	11	3	runs	1004213	1341411	1150502	190909	79086	365300	76664	441964	435672	spneumoniae.S_pseudosimplitigsAC.k_11.d_3.M_runs
spneumoniae	pseudosimplitigsAC	11	3	zeros	1004213	1341411	1004213	337198	144263	365300	91224	456524	457036	spneumoniae.S_pseudosimplitigsAC.k_11.d_3.M_zeros
spneumoniae	pseudosimplitigsAC	11	4	default	1004213	1288936	1004213	284723	146964	349068	90304	439372	437952	spneumoniae.S_pseudosimplitigsAC.k_11.d_4.M_default
spneumoniae	pseudosimplitigsAC	11	4	ones	1004213	1288936	1155695	133241	88258	349068	76428	425496	419436	spneumoniae.S_pseudosimplitigsAC.k_11.d_4.M_ones
spneumoniae	pseudosimplitigsAC	11	4	runs	1004213	1288936	1140201	148735	79596	349068	74000	423068	418112	spneumoniae.S_pseudosimplitigsAC.k_11.d_4.M_runs
spneumoniae	pseudosimplitigsAC	11	4	zeros	1004213	1288936	1004213	284723	146997	349068	92200	441268	439208	spneumoniae.S_pseudosimplitigsAC.k_11.d_4.M_zeros
spneumoniae	pseudosimplitigsAC	11	5	default	1004213	1272636	1004213	268423	147583	343892	90960	434852	432404	spneumoniae.S_pseudosimplitigsAC.k_11.d_5.M_default
spneumoniae	pseudosimplitigsAC	11	5	ones	1004213	1272636	1148320	124316	85835	343892	74108	418000	412724	spneumoniae.S_pseudosimplitigsAC.k_11.d_5.M_ones
spneumoniae	pseudosimplitigsAC	11	5	runs	1004213	1272636	1138602	134034	79867	343892	73144	417036	413980	spneumoniae.S_pseudosimplitigsAC.k_11.d_5.M_runs
spneumoniae	pseudosimplitigsAC	11	5	zeros	1004213	1272636	1004213	268423	148203	343892	93732	437624	434900	spneumoniae.S_pseudosimplitigsAC.k_11.d_5.M_zeros
spneumoniae	pseudosimplitigsAC	11	6	default	1004213	1266433	1004213	262220	147749	343248	91224	434472	429756	spneumoniae.S_pseudosimplitigsAC.k_11.d_6.M_default
spneumoniae	pseudosimplitigsAC	11	6	ones	1004213	1266433	1146088	120345	85136	343248	73556	416804	410480	spneumoniae.S_pseudosimplitigsAC.k_11.d_6.M_ones
spneumoniae	pseudosimplitigsAC	11	6	runs	1004213	1266433	1138158	128275	79924	343248	72676	415924	409336	spneumoniae.S_pseudosimplitigsAC.k_11.d_6.M_runs
spneumoniae	pseudosimplitigsAC	11	6	zeros	1004213	1266433	1004213	262220	149966	343248	96176	439424	434552	spneumoniae.S_pseudosimplitigsAC.k_11.d_6.M_zeros
spneumoniae	pseudosimplitigsAC	11	7	default	1004213	1264131	1004213	259918	147720	341320	91428	432748	428324	spneumoniae.S_pseudosimplitigsAC.k_11.d_7.M_default
spneumoniae	pseudosimplitigsAC	11	7	ones	1004213	1264131	1146186	117945	84557	341320	72944	414264	408884	spneumoniae.S_pseudosimplitigsAC.k_11.d_7.M_ones
spneumoniae	pseudosimplitigsAC	11	7	runs	1004213	1264131	1138942	125189	79747	341320	72536	413856	408304	spneumoniae.S_pseudosimplitigsAC.k_11.d_7.M_runs
spneumoniae	pseudosimplitigsAC	11	7	zeros	1004213	1264131	1004213	259918	149979	341320	96236	437556	433256	spneumoniae.S_pseudosimplitigsAC.k_11.d_7.M_zeros
spneumoniae	pseudosimplitigsAC	11	8	default	1004213	1263569	1004213	259356	147735	342616	91384	434000	427884	spneumoniae.S_pseudosimplitigsAC.k_11.d_8.M_default
spneumoniae	pseudosimplitigsAC	11	8	ones	1004213	1263569	1146380	117189	84412	342616	73024	415640	408292	spneumoniae.S_pseudosimplitigsAC.k_11.d_8.M_ones
spneumoniae	pseudosimplitigsAC	11	8	runs	1004213	1263569	1139425	124144	79724	342616	72720	415336	408368	spneumoniae.S_pseudosimplitigsAC.k_11.d_8.M_runs
spneumoniae	pseudosimplitigsAC	11	8	zeros	1004213	1263569	1004213	259356	150047	342616	96576	439192	433296	spneumoniae.S_pseudosimplitigsAC.k_11.d_8.M_zeros
spneumoniae	pseudosimplitigsAC	11	9	default	1004213	1263099	1004213	258886	147755	342736	91720	434456	427592	spneumoniae.S_pseudosimplitigsAC.k_11.d_9.M_default
spneumoniae	pseudosimplitigsAC	11	9	ones	1004213	1263099	1146341	116758	84279	342736	72968	415704	408172	spneumoniae.S_pseudosimplitigsAC.k_11.d_9.M_ones
spneumoniae	pseudosimplitigsAC	11	9	runs	1004213	1263099	1139613	123486	79679	342736	72616	415352	407876	spneumoniae.S_pseudosimplitigsAC.k_11.d_9.M_runs
spneumoniae	pseudosimplitigsAC	11	9	zeros	1004213	1263099	1004213	258886	150079	342736	96708	439444	432820	spneumoniae.S_pseudosimplitigsAC.k_11.d_9.M_zeros
spneumoniae	pseudosimplitigs	12	1	default	1585876	2992270	1585876	1406394	127854	777496	101376	878872	935040	spneumoniae.S_pseudosimplitigs.k_12.d_1.M_default
spneumoniae	pseudosimplitigs	12	1	ones	1585876	2992270	2147332	844938	265126	777496	250460	1027956	1031212	spneumoniae.S_pseudosimplitigs.k_12.d_1.M_ones
spneumoniae	pseudosimplitigs	12	1	runs	1585876	2992270	1864192	1128078	121823	777496	156576	934072	943876	spneumoniae.S_pseudosimplitigs.k_12.d_1.M_runs
spneumoniae	pseudosimplitigs	12	1	zeros	1585876	2992270	1585876	1406394	190645	777496	187452	964948	995372	spneumoniae.S_pseudosimplitigs.k_12.d_1.M_zeros
spneumoniae	pseudosimplitigs	12	10	default	1585876	2014841	1585876	428965	226660	521416	162816	684232	679912	spneumoniae.S_pseudosimplitigs.k_12.d_10.M_default
spneumoniae	pseudosimplitigs	12	10	ones	1585876	2014841	1774045	240796	145222	521416	129800	651216	646756	spneumoniae.S_pseudosimplitigs.k_12.d_10.M_ones
spneumoniae	pseudosimplitigs	12	10	runs	1585876	2014841	1761048	253793	135734	521416	128032	649448	645272	spneumoniae.S_pseudosimplitigs.k_12.d_10.M_runs
spneumoniae	pseudosimplitigs	12	10	zeros	1585876	2014841	1585876	428965	238761	521416	175116	696532	693828	spneumoniae.S_pseudosimplitigs.k_12.d_10.M_zeros
spneumoniae	pseudosimplitigs	12	11	default	1585876	2015257	1585876	429381	226679	521488	162820	684308	679824	spneumoniae.S_pseudosimplitigs.k_12.d_11.M_default
spneumoniae	pseudosimplitigs	12	11	ones	1585876	2015257	1774021	241236	145267	521488	129856	651344	646856	spneumoniae.S_pseudosimplitigs.k_12.d_11.M_ones
spneumoniae	pseudosimplitigs	12	11	runs	1585876	2015257	1761063	254194	135782	521488	127888	649376	644788	spneumoniae.S_pseudosimplitigs.k_12.d_11.M_runs
spneumoniae	pseudosimplitigs	12	11	zeros	1585876	2015257	1585876	429381	238780	521488	175128	696616	693720	spneumoniae.S_pseudosimplitigs.k_12.d_11.M_zeros
spneumoniae	pseudosimplitigs	12	2	default	1585876	2368061	1585876	782185	185285	616996	136620	753616	782180	spneumoniae.S_pseudosimplitigs.k_12.d_2.M_default
spneumoniae	pseudosimplitigs	12	2	ones	1585876	2368061	1897194	470867	177545	616996	170568	787564	782700	spneumoniae.S_pseudosimplitigs.k_12.d_2.M_ones
spneumoniae	pseudosimplitigs	12	2	runs	1585876	2368061	1777419	590642	113523	616996	129840	746836	752164	spneumoniae.S_pseudosimplitigs.k_12.d_2.M_runs
spneumoniae	pseudosimplitigs	12	2	zeros	1585876	2368061	1585876	782185	193616	616996	151240	768236	789728	spneumoniae.S_pseudosimplitigs.k_12.d_2.M_zeros
spneumoniae	pseudosimplitigs	12	3	default	1585876	2166705	1585876	580829	212313	564492	152600	717092	728224	spneumoniae.S_pseudosimplitigs.k_12.d_3.M_default
spneumoniae	pseudosimplitigs	12	3	ones	1585876	2166705	1815867	350838	158813	564492	146916	711408	706412	spneumoniae.S_pseudosimplitigs.k_12.d_3.M_ones
spneumoniae	pseudosimplitigs	12	3	runs	1585876	2166705	1759088	407617	126676	564492	129272	693764	694320	spneumoniae.S_pseudosimplitigs.k_12.d_3.M_runs
spneumoniae	pseudosimplitigs	12	3	zeros	1585876	2166705	1585876	580829	213073	564492	154776	719268	728680	spneumoniae.S_pseudosimplitigs.k_12.d_3.M_zeros
spneumoniae	pseudosimplitigs	12	4	default	1585876	2075193	1585876	489317	221771	539044	158576	697620	700252	spneumoniae.S_pseudosimplitigs.k_12.d_4.M_default
spneumoniae	pseudosimplitigs	12	4	ones	1585876	2075193	1787107	288086	149080	539044	135400	674444	670192	spneumoniae.S_pseudosimplitigs.k_12.d_4.M_ones
spneumoniae	pseudosimplitigs	12	4	runs	1585876	2075193	1758438	316755	131541	539044	127768	666812	665212	spneumoniae.S_pseudosimplitigs.k_12.d_4.M_runs
spneumoniae	pseudosimplitigs	12	4	zeros	1585876	2075193	1585876	489317	221853	539044	158852	697896	700068	spneumoniae.S_pseudosimplitigs.k_12.d_4.M_zeros
spneumoniae	pseudosimplitigs	12	5	default	1585876	2037162	1585876	451286	225602	528108	161224	689332	687156	spneumoniae.S_pseudosimplitigs.k_12.d_5.M_default
spneumoniae	pseudosimplitigs	12	5	ones	1585876	2037162	1777586	259576	147028	528108	132244	660352	655248	spneumoniae.S_pseudosimplitigs.k_12.d_5.M_ones
spneumoniae	pseudosimplitigs	12	5	runs	1585876	2037162	1759110	278052	134769	528108	128216	656324	652092	spneumoniae.S_pseudosimplitigs.k_12.d_5.M_runs
spneumoniae	pseudosimplitigs	12	5	zeros	1585876	2037162	1585876	451286	226211	528108	161816	689924	687968	spneumoniae.S_pseudosimplitigs.k_12.d_5.M_zeros
spneumoniae	pseudosimplitigs	12	6	default	1585876	2021578	1585876	435702	226398	523072	161992	685064	682220	spneumoniae.S_pseudosimplitigs.k_12.d_6.M_default
spneumoniae	pseudosimplitigs	12	6	ones	1585876	2021578	1774794	246784	145766	523072	130664	653736	649452	spneumoniae.S_pseudosimplitigs.k_12.d_6.M_ones
spneumoniae	pseudosimplitigs	12	6	runs	1585876	2021578	1760316	261262	135519	523072	127964	651036	647376	spneumoniae.S_pseudosimplitigs.k_12.d_6.M_runs
spneumoniae	pseudosimplitigs	12	6	zeros	1585876	2021578	1585876	435702	231394	523072	167472	690544	689304	spneumoniae.S_pseudosimplitigs.k_12.d_6.M_zeros
spneumoniae	pseudosimplitigs	12	7	default	1585876	2016842	1585876	430966	226518	522328	162340	684668	680668	spneumoniae.S_pseudosimplitigs.k_12.d_7.M_default
spneumoniae	pseudosimplitigs	12	7	ones	1585876	2016842	1774028	242814	145388	522328	130008	652336	648048	spneumoniae.S_pseudosimplitigs.k_12.d_7.M_ones
spneumoniae	pseudosimplitigs	12	7	runs	1585876	2016842	1760557	256285	135694	522328	127884	650212	646092	spneumoniae.S_pseudosimplitigs.k_12.d_7.M_runs
spneumoniae	pseudosimplitigs	12	7	zeros	1585876	2016842	1585876	430966	237645	522328	173624	695952	694568	spneumoniae.S_pseudosimplitigs.k_12.d_7.M_zeros
spneumoniae	pseudosimplitigs	12	8	default	1585876	2015239	1585876	429363	226619	521820	162528	684348	680500	spneumoniae.S_pseudosimplitigs.k_12.d_8.M_default
spneumoniae	pseudosimplitigs	12	8	ones	1585876	2015239	1774033	241206	145280	521820	129900	651720	646768	spneumoniae.S_pseudosimplitigs.k_12.d_8.M_ones
spneumoniae	pseudosimplitigs	12	8	runs	1585876	2015239	1760772	254467	135679	521820	127796	649616	645156	spneumoniae.S_pseudosimplitigs.k_12.d_8.M_runs
spneumoniae	pseudosimplitigs	12	8	zeros	1585876	2015239	1585876	429363	238199	521820	174316	696136	694080	spneumoniae.S_pseudosimplitigs.k_12.d_8.M_zeros
spneumoniae	pseudosimplitigs	12	9	default	1585876	2014921	1585876	429045	226649	521564	162772	684336	679656	spneumoniae.S_pseudosimplitigs.k_12.d_9.M_default
spneumoniae	pseudosimplitigs	12	9	ones	1585876	2014921	1773983	240938	145189	521564	129824	651388	647188	spneumoniae.S_pseudosimplitigs.k_12.d_9.M_ones
spneumoniae	pseudosimplitigs	12	9	runs	1585876	2014921	1761003	253918	135715	521564	127844	649408	645348	spneumoniae.S_pseudosimplitigs.k_12.d_9.M_runs
spneumoniae	pseudosimplitigs	12	9	zeros	1585876	2014921	1585876	429045	238613	521564	174840	696404	694064	spneumoniae.S_pseudosimplitigs.k_12.d_9.M_zeros
spneumoniae	pseudosimplitigsAC	12	1	default	1585876	2992281	1585876	1406405	127855	786372	97460	883832	948712	spneumoniae.S_pseudosimplitigsAC.k_12.d_1.M_default
spneumoniae	pseudosimplitigsAC	12	1	ones	1585876	2992281	2144261	848020	266807	786372	247212	1033584	1038744	spneumoniae.S_pseudosimplitigsAC.k_12.d_1.M_ones
spneumoniae	pseudosimplitigsAC	12	1	runs	1585876	2992281	1852074	1140207	121044	786372	153096	939468	953300	spneumoniae.S_pseudosimplitigsAC.k_12.d_1.M_runs
spneumoniae	pseudosimplitigsAC	12	1	zeros	1585876	2992281	1585876	1406405	194928	786372	184820	971192	1004476	spneumoniae.S_pseudosimplitigsAC.k_12.d_1.M_zeros
spneumoniae	pseudosimplitigsAC	12	10	default	1585876	2000580	1585876	414704	217984	526380	148964	675344	674316	spneumoniae.S_pseudosimplitigsAC.k_12.d_10.M_default
spneumoniae	pseudosimplitigsAC	12	10	ones	1585876	2000580	1775615	224965	137232	526380	120556	646936	644212	spneumoniae.S_pseudosimplitigsAC.k_12.d_10.M_ones
spneumoniae	pseudosimplitigsAC	12	10	runs	1585876	2000580	1762732	237848	128190	526380	118840	645220	642268	spneumoniae.S_pseudosimplitigsAC.k_12.d_10.M_runs
spneumoniae	pseudosimplitigsAC	12	10	zeros	1585876	2000580	1585876	414704	218564	526380	153160	679540	678356	spneumoniae.S_pseudosimplitigsAC.k_12.d_10.M_zeros
spneumoniae	pseudosimplitigsAC	12	11	default	1585876	2000580	1585876	414704	218000	526364	149000	675364	674224	spneumoniae.S_pseudosimplitigsAC.k_12.d_11.M_default
spneumoniae	pseudosimplitigsAC	12	11	ones	1585876	2000580	1775551	225029	137212	526364	120552	646916	644176	spneumoniae.S_pseudosimplitigsAC.k_12.d_11.M_ones
spneumoniae	pseudosimplitigsAC	12	11	runs	1585876	2000580	1762803	237777	128223	526364	118796	645160	642660	spneumoniae.S_pseudosimplitigsAC.k_12.d_11.M_runs
spneumoniae	pseudosimplitigsAC	12	11	zeros	1585876	2000580	1585876	414704	218580	526364	153196	679560	678268	spneumoniae.S_pseudosimplitigsAC.k_12.d_11.M_zeros
spneumoniae	pseudosimplitigsAC	12	2	default	1585876	2353456	1585876	767580	180950	623212	128880	752092	782244	spneumoniae.S_pseudosimplitigsAC.k_12.d_2.M_default
spneumoniae	pseudosimplitigsAC	12	2	ones	1585876	2353456	1897518	455938	171242	623212	161212	784424	781316	spneumoniae.S_pseudosimplitigsAC.k_12.d_2.M_ones
spneumoniae	pseudosimplitigsAC	12	2	runs	1585876	2353456	1778709	574747	107962	623212	121728	744940	751832	spneumoniae.S_pseudosimplitigsAC.k_12.d_2.M_runs
spneumoniae	pseudosimplitigsAC	12	2	zeros	1585876	2353456	1585876	767580	189253	623212	143220	766432	789052	spneumoniae.S_pseudosimplitigsAC.k_12.d_2.M_zeros
spneumoniae	pseudosimplitigsAC	12	3	default	1585876	2150734	1585876	564858	205426	568044	142380	710424	725592	spneumoniae.S_pseudosimplitigsAC.k_12.d_3.M_default
spneumoniae	pseudosimplitigsAC	12	3	ones	1585876	2150734	1816672	334062	149738	568044	136848	704892	703336	spneumoniae.S_pseudosimplitigsAC.k_12.d_3.M_ones
spneumoniae	pseudosimplitigsAC	12	3	runs	1585876	2150734	1761036	389698	118480	568044	119596	687640	691420	spneumoniae.S_pseudosimplitigsAC.k_12.d_3.M_runs
spneumoniae	pseudosimplitigsAC	12	3	zeros	1585876	2150734	1585876	564858	206086	568044	145728	713772	726720	spneumoniae.S_pseudosimplitigsAC.k_12.d_3.M_zeros
spneumoniae	pseudosimplitigsAC	12	4	default	1585876	2063057	1585876	477181	214532	545020	147044	692064	696960	spneumoniae.S_pseudosimplitigsAC.k_12.d_4.M_default
spneumoniae	pseudosimplitigsAC	12	4	ones	1585876	2063057	1786883	276174	142417	545020	127324	672344	669208	spneumoniae.S_pseudosimplitigsAC.k_12.d_4.M_ones
spneumoniae	pseudosimplitigsAC	12	4	runs	1585876	2063057	1758810	304247	125286	545020	119816	664836	664376	spneumoniae.S_pseudosimplitigsAC.k_12.d_4.M_runs
spneumoniae	pseudosimplitigsAC	12	4	zeros	1585876	2063057	1585876	477181	214766	545020	150692	695712	701140	spneumoniae.S_pseudosimplitigsAC.k_12.d_4.M_zeros
spneumoniae	pseudosimplitigsAC	12	5	default	1585876	2024565	1585876	438689	217163	534824	148000	682824	683468	spneumoniae.S_pseudosimplitigsAC.k_12.d_5.M_default
spneumoniae	pseudosimplitigsAC	12	5	ones	1585876	2024565	1777329	247236	139323	534824	123196	658020	653892	spneumoniae.S_pseudosimplitigsAC.k_12.d_5.M_ones
spneumoniae	pseudosimplitigsAC	12	5	runs	1585876	2024565	1759330	265235	127487	534824	119424	654248	651480	spneumoniae.S_pseudosimplitigsAC.k_12.d_5.M_runs
spneumoniae	pseudosimplitigsAC	12	5	zeros	1585876	2024565	1585876	438689	217471	534824	151832	686656	687532	spneumoniae.S_pseudosimplitigsAC.k_12.d_5.M_zeros
spneumoniae	pseudosimplitigsAC	12	6	default	1585876	2009868	1585876	423992	217850	530348	148480	678828	678216	spneumoniae.S_pseudosimplitigsAC.k_12.d_6.M_default
spneumoniae	pseudosimplitigsAC	12	6	ones	1585876	2009868	1775335	234533	138202	530348	121492	651840	648136	spneumoniae.S_pseudosimplitigsAC.k_12.d_6.M_ones
spneumoniae	pseudosimplitigsAC	12	6	runs	1585876	2009868	1760535	249333	128057	530348	119004	649352	646564	spneumoniae.S_pseudosimplitigsAC.k_12.d_6.M_runs
spneumoniae	pseudosimplitigsAC	12	6	zeros	1585876	2009868	1585876	423992	218030	530348	152368	682716	682340	spneumoniae.S_pseudosimplitigsAC.k_12.d_6.M_zeros
spneumoniae	pseudosimplitigsAC	12	7	default	1585876	2003981	1585876	418105	217924	528072	148532	676604	675732	spneumoniae.S_pseudosimplitigsAC.k_12.d_7.M_default
spneumoniae	pseudosimplitigsAC	12	7	ones	1585876	2003981	1775053	228928	137614	528072	120808	648880	645604	spneumoniae.S_pseudosimplitigsAC.k_12.d_7.M_ones
spneumoniae	pseudosimplitigsAC	12	7	runs	1585876	2003981	1761618	242363	128219	528072	118840	646912	643828	spneumoniae.S_pseudosimplitigsAC.k_12.d_7.M_runs
spneumoniae	pseudosimplitigsAC	12	7	zeros	1585876	2003981	1585876	418105	218241	528072	152356	680428	679720	spneumoniae.S_pseudosimplitigsAC.k_12.d_7.M_zeros
spneumoniae	pseudosimplitigsAC	12	8	default	1585876	2001885	1585876	416009	217947	526868	148772	675640	675168	spneumoniae.S_pseudosimplitigsAC.k_12.d_8.M_default
spneumoniae	pseudosimplitigsAC	12	8	ones	1585876	2001885	1775142	226743	137323	526868	120652	647520	644896	spneumoniae.S_pseudosimplitigsAC.k_12.d_8.M_ones
spneumoniae	pseudosimplitigsAC	12	8	runs	1585876	2001885	1762073	239812	128190	526868	118784	645652	643152	spneumoniae.S_pseudosimplitigsAC.k_12.d_8.M_runs
spneumoniae	pseudosimplitigsAC	12	8	zeros	1585876	2001885	1585876	416009	218443	526868	153000	679868	678880	spneumoniae.S_pseudosimplitigsAC.k_12.d_8.M_zeros
spneumoniae	pseudosimplitigsAC	12	9	default	1585876	2001157	1585876	415281	217961	526920	148944	675864	674740	spneumoniae.S_pseudosimplitigsAC.k_12.d_9.M_default
spneumoniae	pseudosimplitigsAC	12	9	ones	1585876	2001157	1775466	225691	137282	526920	120640	647560	644804	spneumoniae.S_pseudosimplitigsAC.k_12.d_9.M_ones
spneumoniae	pseudosimplitigsAC	12	9	runs	1585876	2001157	1762563	238594	128193	526920	118696	645616	643072	spneumoniae.S_pseudosimplitigsAC.k_12.d_9.M_runs
spneumoniae	pseudosimplitigsAC	12	9	zeros	1585876	2001157	1585876	415281	218512	526920	153036	679956	678612	spneumoniae.S_pseudosimplitigsAC.k_12.d_9.M_zeros
spneumoniae	pseudosimplitigs	13	1	default	1917960	2955672	1917960	1037712	86476	764300	87796	852096	894972	spneumoniae.S_pseudosimplitigs.k_13.d_1.M_default
spneumoniae	pseudosimplitigs	13	1	ones	1917960	2955672	2170693	784979	159681	764300	181968	946268	954132	spneumoniae.S_pseudosimplitigs.k_13.d_1.M_ones
spneumoniae	pseudosimplitigs	13	1	runs	1917960	2955672	2042803	912869	84568	764300	120240	884540	896376	spneumoniae.S_pseudosimplitigs.k_13.d_1.M_runs
spneumoniae	pseudosimplitigs	13	1	zeros	1917960	2955672	1917960	1037712	121026	764300	142504	906804	932504	spneumoniae.S_pseudosimplitigs.k_13.d_1.M_zeros
spneumoniae	pseudosimplitigs	13	10	default	1917960	2277213	1917960	359253	159738	590696	146472	737168	731980	spneumoniae.S_pseudosimplitigs.k_13.d_10.M_default
spneumoniae	pseudosimplitigs	13	10	ones	1917960	2277213	2051650	225563	102878	590696	113276	703972	696652	spneumoniae.S_pseudosimplitigs.k_13.d_10.M_ones
spneumoniae	pseudosimplitigs	13	10	runs	1917960	2277213	2041646	235567	95448	590696	110204	700900	693804	spneumoniae.S_pseudosimplitigs.k_13.d_10.M_runs
spneumoniae	pseudosimplitigs	13	10	zeros	1917960	2277213	1917960	359253	164428	590696	153164	743860	738772	spneumoniae.S_pseudosimplitigs.k_13.d_10.M_zeros
spneumoniae	pseudosimplitigs	13	11	default	1917960	2277541	1917960	359581	159788	590624	146560	737184	732772	spneumoniae.S_pseudosimplitigs.k_13.d_11.M_default
spneumoniae	pseudosimplitigs	13	11	ones	1917960	2277541	2051751	225790	102959	590624	113228	703852	696996	spneumoniae.S_pseudosimplitigs.k_13.d_11.M_ones
spneumoniae	pseudosimplitigs	13	11	runs	1917960	2277541	2041667	235874	95472	590624	110224	700848	693808	spneumoniae.S_pseudosimplitigs.k_13.d_11.M_runs
spneumoniae	pseudosimplitigs	13	11	zeros	1917960	2277541	1917960	359581	164498	590624	153232	743856	739012	spneumoniae.S_pseudosimplitigs.k_13.d_11.M_zeros
spneumoniae	pseudosimplitigs	13	12	default	1917960	2278168	1917960	360208	159806	590600	146848	737448	732496	spneumoniae.S_pseudosimplitigs.k_13.d_12.M_default
spneumoniae	pseudosimplitigs	13	12	ones	1917960	2278168	2051911	226257	103028	590600	113324	703924	696728	spneumoniae.S_pseudosimplitigs.k_13.d_12.M_ones
spneumoniae	pseudosimplitigs	13	12	runs	1917960	2278168	2041670	236498	95474	590600	110264	700864	693980	spneumoniae.S_pseudosimplitigs.k_13.d_12.M_runs
spneumoniae	pseudosimplitigs	13	12	zeros	1917960	2278168	1917960	360208	164524	590600	153164	743764	738740	spneumoniae.S_pseudosimplitigs.k_13.d_12.M_zeros
spneumoniae	pseudosimplitigs	13	2	default	1917960	2475111	1917960	557151	114962	644008	115540	759548	774756	spneumoniae.S_pseudosimplitigs.k_13.d_2.M_default
spneumoniae	pseudosimplitigs	13	2	ones	1917960	2475111	2077903	397208	98805	644008	122168	766176	761688	spneumoniae.S_pseudosimplitigs.k_13.d_2.M_ones
spneumoniae	pseudosimplitigs	13	2	runs	1917960	2475111	2022217	452894	65181	644008	94840	738848	739496	spneumoniae.S_pseudosimplitigs.k_13.d_2.M_runs
spneumoniae	pseudosimplitigs	13	2	zeros	1917960	2475111	1917960	557151	121057	644008	124284	768292	780268	spneumoniae.S_pseudosimplitigs.k_13.d_2.M_zeros
spneumoniae	pseudosimplitigs	13	3	default	1917960	2363152	1917960	445192	135660	615612	129404	745016	753484	spneumoniae.S_pseudosimplitigs.k_13.d_3.M_default
spneumoniae	pseudosimplitigs	13	3	ones	1917960	2363152	2059278	303874	94055	615612	113404	729016	722744	spneumoniae.S_pseudosimplitigs.k_13.d_3.M_ones
spneumoniae	pseudosimplitigs	13	3	runs	1917960	2363152	2028581	334571	74809	615612	98476	714088	712128	spneumoniae.S_pseudosimplitigs.k_13.d_3.M_runs
spneumoniae	pseudosimplitigs	13	3	zeros	1917960	2363152	1917960	445192	136475	615612	130924	746536	754404	spneumoniae.S_pseudosimplitigs.k_13.d_3.M_zeros
spneumoniae	pseudosimplitigs	13	4	default	1917960	2322962	1917960	405002	147740	604884	138124	743008	745420	spneumoniae.S_pseudosimplitigs.k_13.d_4.M_default
spneumoniae	pseudosimplitigs	13	4	ones	1917960	2322962	2052043	270919	96782	604884	112332	717216	711284	spneumoniae.S_pseudosimplitigs.k_13.d_4.M_ones
spneumoniae	pseudosimplitigs	13	4	runs	1917960	2322962	2033688	289274	84578	604884	103580	708464	705412	spneumoniae.S_pseudosimplitigs.k_13.d_4.M_runs
spneumoniae	pseudosimplitigs	13	4	zeros	1917960	2322962	1917960	405002	147843	604884	138264	743148	745828	spneumoniae.S_pseudosimplitigs.k_13.d_4.M_zeros
spneumoniae	pseudosimplitigs	13	5	default	1917960	2299142	1917960	381182	155200	598556	143400	741956	740068	spneumoniae.S_pseudosimplitigs.k_13.d_5.M_default
spneumoniae	pseudosimplitigs	13	5	ones	1917960	2299142	2050775	248367	99734	598556	112612	711168	704612	spneumoniae.S_pseudosimplitigs.k_13.d_5.M_ones
spneumoniae	pseudosimplitigs	13	5	runs	1917960	2299142	2038320	260822	90936	598556	107668	706224	700816	spneumoniae.S_pseudosimplitigs.k_13.d_5.M_runs
spneumoniae	pseudosimplitigs	13	5	zeros	1917960	2299142	1917960	381182	155521	598556	143932	742488	741516	spneumoniae.S_pseudosimplitigs.k_13.d_5.M_zeros
spneumoniae	pseudosimplitigs	13	6	default	1917960	2284608	1917960	366648	158314	593920	145188	739108	735448	spneumoniae.S_pseudosimplitigs.k_13.d_6.M_default
spneumoniae	pseudosimplitigs	13	6	ones	1917960	2284608	2050569	234039	101825	593920	112968	706888	698912	spneumoniae.S_pseudosimplitigs.k_13.d_6.M_ones
spneumoniae	pseudosimplitigs	13	6	runs	1917960	2284608	2040072	244536	94154	593920	109480	703400	696284	spneumoniae.S_pseudosimplitigs.k_13.d_6.M_runs
spneumoniae	pseudosimplitigs	13	6	zeros	1917960	2284608	1917960	366648	159596	593920	147460	741380	737588	spneumoniae.S_pseudosimplitigs.k_13.d_6.M_zeros
spneumoniae	pseudosimplitigs	13	7	default	1917960	2279063	1917960	361103	159287	591584	145844	737428	733764	spneumoniae.S_pseudosimplitigs.k_13.d_7.M_default
spneumoniae	pseudosimplitigs	13	7	ones	1917960	2279063	2050756	228307	102278	591584	112868	704452	697592	spneumoniae.S_pseudosimplitigs.k_13.d_7.M_ones
spneumoniae	pseudosimplitigs	13	7	runs	1917960	2279063	2040911	238152	94961	591584	109884	701468	695216	spneumoniae.S_pseudosimplitigs.k_13.d_7.M_runs
spneumoniae	pseudosimplitigs	13	7	zeros	1917960	2279063	1917960	361103	162049	591584	150208	741792	738104	spneumoniae.S_pseudosimplitigs.k_13.d_7.M_zeros
spneumoniae	pseudosimplitigs	13	8	default	1917960	2277204	1917960	359244	159536	590840	146084	736924	733052	spneumoniae.S_pseudosimplitigs.k_13.d_8.M_default
spneumoniae	pseudosimplitigs	13	8	ones	1917960	2277204	2051171	226033	102595	590840	113016	703856	696852	spneumoniae.S_pseudosimplitigs.k_13.d_8.M_ones
spneumoniae	pseudosimplitigs	13	8	runs	1917960	2277204	2041357	235847	95288	590840	110056	700896	694464	spneumoniae.S_pseudosimplitigs.k_13.d_8.M_runs
spneumoniae	pseudosimplitigs	13	8	zeros	1917960	2277204	1917960	359244	163736	590840	152256	743096	738608	spneumoniae.S_pseudosimplitigs.k_13.d_8.M_zeros
spneumoniae	pseudosimplitigs	13	9	default	1917960	2277186	1917960	359226	159704	590524	146484	737008	732684	spneumoniae.S_pseudosimplitigs.k_13.d_9.M_default
spneumoniae	pseudosimplitigs	13	9	ones	1917960	2277186	2051402	225784	102839	590524	113052	703576	696924	spneumoniae.S_pseudosimplitigs.k_13.d_9.M_ones
spneumoniae	pseudosimplitigs	13	9	runs	1917960	2277186	2041544	235642	95477	590524	109980	700504	694264	spneumoniae.S_pseudosimplitigs.k_13.d_9.M_runs
spneumoniae	pseudosimplitigs	13	9	zeros	1917960	2277186	1917960	359226	164311	590524	152868	743392	739432	spneumoniae.S_pseudosimplitigs.k_13.d_9.M_zeros
spneumoniae	pseudosimplitigsAC	13	1	default	1917960	2955672	1917960	1037712	86476	764736	85836	850572	898364	spneumoniae.S_pseudosimplitigsAC.k_13.d_1.M_default
spneumoniae	pseudosimplitigsAC	13	1	ones	1917960	2955672	2170206	785466	159403	764736	179844	944580	954224	spneumoniae.S_pseudosimplitigsAC.k_13.d_1.M_ones
spneumoniae	pseudosimplitigsAC	13	1	runs	1917960	2955672	2041450	914222	84393	764736	118380	883116	898528	spneumoniae.S_pseudosimplitigsAC.k_13.d_1.M_runs
spneumoniae	pseudosimplitigsAC	13	1	zeros	1917960	2955672	1917960	1037712	121456	764736	140544	905280	932832	spneumoniae.S_pseudosimplitigsAC.k_13.d_1.M_zeros
spneumoniae	pseudosimplitigsAC	13	10	default	1917960	2259755	1917960	341795	154193	589452	139252	728704	726652	spneumoniae.S_pseudosimplitigsAC.k_13.d_10.M_default
spneumoniae	pseudosimplitigsAC	13	10	ones	1917960	2259755	2049682	210073	97337	589452	106188	695640	690168	spneumoniae.S_pseudosimplitigsAC.k_13.d_10.M_ones
spneumoniae	pseudosimplitigsAC	13	10	runs	1917960	2259755	2040328	219427	90371	589452	103256	692708	687012	spneumoniae.S_pseudosimplitigsAC.k_13.d_10.M_runs
spneumoniae	pseudosimplitigsAC	13	10	zeros	1917960	2259755	1917960	341795	159543	589452	149592	739044	735592	spneumoniae.S_pseudosimplitigsAC.k_13.d_10.M_zeros
spneumoniae	pseudosimplitigsAC	13	11	default	1917960	2259491	1917960	341531	154199	588996	139328	728324	726456	spneumoniae.S_pseudosimplitigsAC.k_13.d_11.M_default
spneumoniae	pseudosimplitigsAC	13	11	ones	1917960	2259491	2049782	209709	97262	588996	106172	695168	689416	spneumoniae.S_pseudosimplitigsAC.k_13.d_11.M_ones
spneumoniae	pseudosimplitigsAC	13	11	runs	1917960	2259491	2040517	218974	90378	588996	103392	692388	687356	spneumoniae.S_pseudosimplitigsAC.k_13.d_11.M_runs
spneumoniae	pseudosimplitigsAC	13	11	zeros	1917960	2259491	1917960	341531	159563	588996	149388	738384	735524	spneumoniae.S_pseudosimplitigsAC.k_13.d_11.M_zeros
spneumoniae	pseudosimplitigsAC	13	12	default	1917960	2259507	1917960	341547	154206	589036	139280	728316	726508	spneumoniae.S_pseudosimplitigsAC.k_13.d_12.M_default
spneumoniae	pseudosimplitigsAC	13	12	ones	1917960	2259507	2049800	209707	97318	589036	106196	695232	689432	spneumoniae.S_pseudosimplitigsAC.k_13.d_12.M_ones
spneumoniae	pseudosimplitigsAC	13	12	runs	1917960	2259507	2040499	219008	90399	589036	103432	692468	686832	spneumoniae.S_pseudosimplitigsAC.k_13.d_12.M_runs
spneumoniae	pseudosimplitigsAC	13	12	zeros	1917960	2259507	1917960	341547	159570	589036	149552	738588	735412	spneumoniae.S_pseudosimplitigsAC.k_13.d_12.M_zeros
spneumoniae	pseudosimplitigsAC	13	2	default	1917960	2460693	1917960	542733	112567	642528	111380	753908	771376	spneumoniae.S_pseudosimplitigsAC.k_13.d_2.M_default
spneumoniae	pseudosimplitigsAC	13	2	ones	1917960	2460693	2077168	383525	93841	642528	115644	758172	754400	spneumoniae.S_pseudosimplitigsAC.k_13.d_2.M_ones
spneumoniae	pseudosimplitigsAC	13	2	runs	1917960	2460693	2022763	437930	61256	642528	89248	731776	733472	spneumoniae.S_pseudosimplitigsAC.k_13.d_2.M_runs
spneumoniae	pseudosimplitigsAC	13	2	zeros	1917960	2460693	1917960	542733	118491	642528	120032	762560	776232	spneumoniae.S_pseudosimplitigsAC.k_13.d_2.M_zeros
spneumoniae	pseudosimplitigsAC	13	3	default	1917960	2344763	1917960	426803	131496	612948	123596	736544	747896	spneumoniae.S_pseudosimplitigsAC.k_13.d_3.M_default
spneumoniae	pseudosimplitigsAC	13	3	ones	1917960	2344763	2058819	285944	87392	612948	105220	718168	713736	spneumoniae.S_pseudosimplitigsAC.k_13.d_3.M_ones
spneumoniae	pseudosimplitigsAC	13	3	runs	1917960	2344763	2029630	315133	69114	612948	90952	703900	703640	spneumoniae.S_pseudosimplitigsAC.k_13.d_3.M_runs
spneumoniae	pseudosimplitigsAC	13	3	zeros	1917960	2344763	1917960	426803	132355	612948	125192	738140	748572	spneumoniae.S_pseudosimplitigsAC.k_13.d_3.M_zeros
spneumoniae	pseudosimplitigsAC	13	4	default	1917960	2311069	1917960	393109	143952	604004	132728	736732	742264	spneumoniae.S_pseudosimplitigsAC.k_13.d_4.M_default
spneumoniae	pseudosimplitigsAC	13	4	ones	1917960	2311069	2052374	258695	91444	604004	105472	709476	705460	spneumoniae.S_pseudosimplitigsAC.k_13.d_4.M_ones
spneumoniae	pseudosimplitigsAC	13	4	runs	1917960	2311069	2034877	276192	79787	604004	97160	701164	700040	spneumoniae.S_pseudosimplitigsAC.k_13.d_4.M_runs
spneumoniae	pseudosimplitigsAC	13	4	zeros	1917960	2311069	1917960	393109	144116	604004	133808	737812	742672	spneumoniae.S_pseudosimplitigsAC.k_13.d_4.M_zeros
spneumoniae	pseudosimplitigsAC	13	5	default	1917960	2290448	1917960	372488	150761	597980	137216	735196	736816	spneumoniae.S_pseudosimplitigsAC.k_13.d_5.M_default
spneumoniae	pseudosimplitigsAC	13	5	ones	1917960	2290448	2050105	240343	95610	597980	106468	704448	700624	spneumoniae.S_pseudosimplitigsAC.k_13.d_5.M_ones
spneumoniae	pseudosimplitigsAC	13	5	runs	1917960	2290448	2037569	252879	86792	597980	101680	699660	697108	spneumoniae.S_pseudosimplitigsAC.k_13.d_5.M_runs
spneumoniae	pseudosimplitigsAC	13	5	zeros	1917960	2290448	1917960	372488	151465	597980	139888	737868	739192	spneumoniae.S_pseudosimplitigsAC.k_13.d_5.M_zeros
spneumoniae	pseudosimplitigsAC	13	6	default	1917960	2273097	1917960	355137	152994	593400	138640	732040	731436	spneumoniae.S_pseudosimplitigsAC.k_13.d_6.M_default
spneumoniae	pseudosimplitigsAC	13	6	ones	1917960	2273097	2049706	223391	96579	593400	106640	700040	694572	spneumoniae.S_pseudosimplitigsAC.k_13.d_6.M_ones
spneumoniae	pseudosimplitigsAC	13	6	runs	1917960	2273097	2039611	233486	89229	593400	102992	696392	691844	spneumoniae.S_pseudosimplitigsAC.k_13.d_6.M_runs
spneumoniae	pseudosimplitigsAC	13	6	zeros	1917960	2273097	1917960	355137	157082	593400	147052	740452	738672	spneumoniae.S_pseudosimplitigsAC.k_13.d_6.M_zeros
spneumoniae	pseudosimplitigsAC	13	7	default	1917960	2264971	1917960	347011	153945	590536	138708	729244	728504	spneumoniae.S_pseudosimplitigsAC.k_13.d_7.M_default
spneumoniae	pseudosimplitigsAC	13	7	ones	1917960	2264971	2049150	215821	97207	590536	106380	696916	691852	spneumoniae.S_pseudosimplitigsAC.k_13.d_7.M_ones
spneumoniae	pseudosimplitigsAC	13	7	runs	1917960	2264971	2039720	225251	90177	590536	103392	693928	689260	spneumoniae.S_pseudosimplitigsAC.k_13.d_7.M_runs
spneumoniae	pseudosimplitigsAC	13	7	zeros	1917960	2264971	1917960	347011	158916	590536	148800	739336	737800	spneumoniae.S_pseudosimplitigsAC.k_13.d_7.M_zeros
spneumoniae	pseudosimplitigsAC	13	8	default	1917960	2261008	1917960	343048	154115	590008	138784	728792	727360	spneumoniae.S_pseudosimplitigsAC.k_13.d_8.M_default
spneumoniae	pseudosimplitigsAC	13	8	ones	1917960	2261008	2049496	211512	97236	590008	106076	696084	690036	spneumoniae.S_pseudosimplitigsAC.k_13.d_8.M_ones
spneumoniae	pseudosimplitigsAC	13	8	runs	1917960	2261008	2040281	220727	90372	590008	103300	693308	687836	spneumoniae.S_pseudosimplitigsAC.k_13.d_8.M_runs
spneumoniae	pseudosimplitigsAC	13	8	zeros	1917960	2261008	1917960	343048	159277	590008	149064	739072	736224	spneumoniae.S_pseudosimplitigsAC.k_13.d_8.M_zeros
spneumoniae	pseudosimplitigsAC	13	9	default	1917960	2260039	1917960	342079	154178	589560	139216	728776	726852	spneumoniae.S_pseudosimplitigsAC.k_13.d_9.M_default
spneumoniae	pseudosimplitigsAC	13	9	ones	1917960	2260039	2049503	210536	97257	589560	106160	695720	690292	spneumoniae.S_pseudosimplitigsAC.k_13.d_9.M_ones
spneumoniae	pseudosimplitigsAC	13	9	runs	1917960	2260039	2040279	219760	90397	589560	103356	692916	687396	spneumoniae.S_pseudosimplitigsAC.k_13.d_9.M_runs
spneumoniae	pseudosimplitigsAC	13	9	zeros	1917960	2260039	1917960	342079	159527	589560	149564	739124	735776	spneumoniae.S_pseudosimplitigsAC.k_13.d_9.M_zeros
spneumoniae	pseudosimplitigs	14	1	default	2052085	2551532	2052085	499447	38419	660872	55072	715944	732764	spneumoniae.S_pseudosimplitigs.k_14.d_1.M_default
spneumoniae	pseudosimplitigs	14	1	ones	2052085	2551532	2123558	427974	56437	660872	87128	748000	749220	spneumoniae.S_pseudosimplitigs.k_14.d_1.M_ones
spneumoniae	pseudosimplitigs	14	1	runs	2052085	2551532	2095285	456247	38014	660872	67244	728116	732928	spneumoniae.S_pseudosimplitigs.k_14.d_1.M_runs
spneumoniae	pseudosimplitigs	14	1	zeros	2052085	2551532	2052085	499447	48099	660872	73996	734868	744188	spneumoniae.S_pseudosimplitigs.k_14.d_1.M_zeros
spneumoniae	pseudosimplitigs	14	10	default	2052085	2245155	2052085	193070	69783	582880	90412	673292	666116	spneumoniae.S_pseudosimplitigs.k_14.d_10.M_default
spneumoniae	pseudosimplitigs	14	10	ones	2052085	2245155	2113672	131483	41464	582880	61496	644376	637528	spneumoniae.S_pseudosimplitigs.k_14.d_10.M_ones
spneumoniae	pseudosimplitigs	14	10	runs	2052085	2245155	2109874	135281	38647	582880	59612	642492	636500	spneumoniae.S_pseudosimplitigs.k_14.d_10.M_runs
spneumoniae	pseudosimplitigs	14	10	zeros	2052085	2245155	2052085	193070	70263	582880	91844	674724	666912	spneumoniae.S_pseudosimplitigs.k_14.d_10.M_zeros
spneumoniae	pseudosimplitigs	14	11	default	2052085	2245730	2052085	193645	69868	582956	90488	673444	666156	spneumoniae.S_pseudosimplitigs.k_14.d_11.M_default
spneumoniae	pseudosimplitigs	14	11	ones	2052085	2245730	2113879	131851	41604	582956	61596	644552	637672	spneumoniae.S_pseudosimplitigs.k_14.d_11.M_ones
spneumoniae	pseudosimplitigs	14	11	runs	2052085	2245730	2109919	135811	38680	582956	59716	642672	636316	spneumoniae.S_pseudosimplitigs.k_14.d_11.M_runs
spneumoniae	pseudosimplitigs	14	11	zeros	2052085	2245730	2052085	193645	70344	582956	91916	674872	666968	spneumoniae.S_pseudosimplitigs.k_14.d_11.M_zeros
spneumoniae	pseudosimplitigs	14	12	default	2052085	2246567	2052085	194482	69924	582908	90396	673304	666736	spneumoniae.S_pseudosimplitigs.k_14.d_12.M_default
spneumoniae	pseudosimplitigs	14	12	ones	2052085	2246567	2113929	132638	41677	582908	61684	644592	638168	spneumoniae.S_pseudosimplitigs.k_14.d_12.M_ones
spneumoniae	pseudosimplitigs	14	12	runs	2052085	2246567	2109922	136645	38728	582908	59700	642608	636524	spneumoniae.S_pseudosimplitigs.k_14.d_12.M_runs
spneumoniae	pseudosimplitigs	14	12	zeros	2052085	2246567	2052085	194482	70441	582908	92000	674908	667644	spneumoniae.S_pseudosimplitigs.k_14.d_12.M_zeros
spneumoniae	pseudosimplitigs	14	2	default	2052085	2292472	2052085	240387	45531	597176	67668	664844	664552	spneumoniae.S_pseudosimplitigs.k_14.d_2.M_default
spneumoniae	pseudosimplitigs	14	2	ones	2052085	2292472	2104168	188304	29472	597176	53680	650856	644760	spneumoniae.S_pseudosimplitigs.k_14.d_2.M_ones
spneumoniae	pseudosimplitigs	14	2	runs	2052085	2292472	2092799	199673	22027	597176	45268	642444	638616	spneumoniae.S_pseudosimplitigs.k_14.d_2.M_runs
spneumoniae	pseudosimplitigs	14	2	zeros	2052085	2292472	2052085	240387	47414	597176	70816	667992	665712	spneumoniae.S_pseudosimplitigs.k_14.d_2.M_zeros
spneumoniae	pseudosimplitigs	14	3	default	2052085	2236141	2052085	184056	51634	583016	74236	657252	652464	spneumoniae.S_pseudosimplitigs.k_14.d_3.M_default
spneumoniae	pseudosimplitigs	14	3	ones	2052085	2236141	2105540	130601	26635	583016	49316	632332	624148	spneumoniae.S_pseudosimplitigs.k_14.d_3.M_ones
spneumoniae	pseudosimplitigs	14	3	runs	2052085	2236141	2098987	137154	22250	583016	44752	627768	621232	spneumoniae.S_pseudosimplitigs.k_14.d_3.M_runs
spneumoniae	pseudosimplitigs	14	3	zeros	2052085	2236141	2052085	184056	51987	583016	74756	657772	652580	spneumoniae.S_pseudosimplitigs.k_14.d_3.M_zeros
spneumoniae	pseudosimplitigs	14	4	default	2052085	2232833	2052085	180748	57137	582324	79800	662124	655556	spneumoniae.S_pseudosimplitigs.k_14.d_4.M_default
spneumoniae	pseudosimplitigs	14	4	ones	2052085	2232833	2108153	124680	29700	582324	52496	634820	626104	spneumoniae.S_pseudosimplitigs.k_14.d_4.M_ones
spneumoniae	pseudosimplitigs	14	4	runs	2052085	2232833	2103561	129272	26527	582324	49392	631716	624176	spneumoniae.S_pseudosimplitigs.k_14.d_4.M_runs
spneumoniae	pseudosimplitigs	14	4	zeros	2052085	2232833	2052085	180748	57208	582324	79872	662196	655952	spneumoniae.S_pseudosimplitigs.k_14.d_4.M_zeros
spneumoniae	pseudosimplitigs	14	5	default	2052085	2238684	2052085	186599	62303	583716	84520	668236	661824	spneumoniae.S_pseudosimplitigs.k_14.d_5.M_default
spneumoniae	pseudosimplitigs	14	5	ones	2052085	2238684	2109851	128833	34314	583716	56644	640360	632760	spneumoniae.S_pseudosimplitigs.k_14.d_5.M_ones
spneumoniae	pseudosimplitigs	14	5	runs	2052085	2238684	2105974	132710	31536	583716	54200	637916	631100	spneumoniae.S_pseudosimplitigs.k_14.d_5.M_runs
spneumoniae	pseudosimplitigs	14	5	zeros	2052085	2238684	2052085	186599	62436	583716	85080	668796	662208	spneumoniae.S_pseudosimplitigs.k_14.d_5.M_zeros
spneumoniae	pseudosimplitigs	14	6	default	2052085	2243773	2052085	191688	66214	583920	87696	671616	665664	spneumoniae.S_pseudosimplitigs.k_14.d_6.M_default
spneumoniae	pseudosimplitigs	14	6	ones	2052085	2243773	2111654	132119	37790	583920	59276	643196	636272	spneumoniae.S_pseudosimplitigs.k_14.d_6.M_ones
spneumoniae	pseudosimplitigs	14	6	runs	2052085	2243773	2108052	135721	35181	583920	57196	641116	634936	spneumoniae.S_pseudosimplitigs.k_14.d_6.M_runs
spneumoniae	pseudosimplitigs	14	6	zeros	2052085	2243773	2052085	191688	66429	583920	88764	672684	665932	spneumoniae.S_pseudosimplitigs.k_14.d_6.M_zeros
spneumoniae	pseudosimplitigs	14	7	default	2052085	2244472	2052085	192387	68378	584200	89292	673492	665860	spneumoniae.S_pseudosimplitigs.k_14.d_7.M_default
spneumoniae	pseudosimplitigs	14	7	ones	2052085	2244472	2112815	131657	39897	584200	60708	644908	637928	spneumoniae.S_pseudosimplitigs.k_14.d_7.M_ones
spneumoniae	pseudosimplitigs	14	7	runs	2052085	2244472	2109367	135105	37328	584200	58836	643036	636444	spneumoniae.S_pseudosimplitigs.k_14.d_7.M_runs
spneumoniae	pseudosimplitigs	14	7	zeros	2052085	2244472	2052085	192387	68724	584200	90492	674692	667312	spneumoniae.S_pseudosimplitigs.k_14.d_7.M_zeros
spneumoniae	pseudosimplitigs	14	8	default	2052085	2244251	2052085	192166	69414	583356	89984	673340	665888	spneumoniae.S_pseudosimplitigs.k_14.d_8.M_default
spneumoniae	pseudosimplitigs	14	8	ones	2052085	2244251	2113260	130991	40958	583356	61144	644500	637588	spneumoniae.S_pseudosimplitigs.k_14.d_8.M_ones
spneumoniae	pseudosimplitigs	14	8	runs	2052085	2244251	2109633	134618	38270	583356	59308	642664	637028	spneumoniae.S_pseudosimplitigs.k_14.d_8.M_runs
spneumoniae	pseudosimplitigs	14	8	zeros	2052085	2244251	2052085	192166	69780	583356	91176	674532	667272	spneumoniae.S_pseudosimplitigs.k_14.d_8.M_zeros
spneumoniae	pseudosimplitigs	14	9	default	2052085	2244580	2052085	192495	69693	583576	90108	673684	666188	spneumoniae.S_pseudosimplitigs.k_14.d_9.M_default
spneumoniae	pseudosimplitigs	14	9	ones	2052085	2244580	2113376	131204	41310	583576	61376	644952	637688	spneumoniae.S_pseudosimplitigs.k_14.d_9.M_ones
spneumoniae	pseudosimplitigs	14	9	runs	2052085	2244580	2109684	134896	38553	583576	59624	643200	635876	spneumoniae.S_pseudosimplitigs.k_14.d_9.M_runs
spneumoniae	pseudosimplitigs	14	9	zeros	2052085	2244580	2052085	192495	70132	583576	91472	675048	667308	spneumoniae.S_pseudosimplitigs.k_14.d_9.M_zeros
spneumoniae	pseudosimplitigsAC	14	1	default	2052085	2551571	2052085	499486	38422	660168	54524	714692	732744	spneumoniae.S_pseudosimplitigsAC.k_14.d_1.M_default
spneumoniae	pseudosimplitigsAC	14	1	ones	2052085	2551571	2124689	426882	56621	660168	87036	747204	749676	spneumoniae.S_pseudosimplitigsAC.k_14.d_1.M_ones
spneumoniae	pseudosimplitigsAC	14	1	runs	2052085	2551571	2095806	455765	38001	660168	66900	727068	732620	spneumoniae.S_pseudosimplitigsAC.k_14.d_1.M_runs
spneumoniae	pseudosimplitigsAC	14	1	zeros	2052085	2551571	2052085	499486	48635	660168	74184	734352	745056	spneumoniae.S_pseudosimplitigsAC.k_14.d_1.M_zeros
spneumoniae	pseudosimplitigsAC	14	10	default	2052085	2233052	2052085	180967	67219	579848	87460	667308	660904	spneumoniae.S_pseudosimplitigsAC.k_14.d_10.M_default
spneumoniae	pseudosimplitigsAC	14	10	ones	2052085	2233052	2112603	120449	38244	579848	56916	636764	631244	spneumoniae.S_pseudosimplitigsAC.k_14.d_10.M_ones
spneumoniae	pseudosimplitigsAC	14	10	runs	2052085	2233052	2109242	123810	35738	579848	55264	635112	630124	spneumoniae.S_pseudosimplitigsAC.k_14.d_10.M_runs
spneumoniae	pseudosimplitigsAC	14	10	zeros	2052085	2233052	2052085	180967	69269	579848	92808	672656	664460	spneumoniae.S_pseudosimplitigsAC.k_14.d_10.M_zeros
spneumoniae	pseudosimplitigsAC	14	11	default	2052085	2232709	2052085	180624	67228	580600	87516	668116	661600	spneumoniae.S_pseudosimplitigsAC.k_14.d_11.M_default
spneumoniae	pseudosimplitigsAC	14	11	ones	2052085	2232709	2112695	120014	38240	580600	57000	637600	630932	spneumoniae.S_pseudosimplitigsAC.k_14.d_11.M_ones
spneumoniae	pseudosimplitigsAC	14	11	runs	2052085	2232709	2109298	123411	35721	580600	55280	635880	629668	spneumoniae.S_pseudosimplitigsAC.k_14.d_11.M_runs
spneumoniae	pseudosimplitigsAC	14	11	zeros	2052085	2232709	2052085	180624	69305	580600	92920	673520	664512	spneumoniae.S_pseudosimplitigsAC.k_14.d_11.M_zeros
spneumoniae	pseudosimplitigsAC	14	12	default	2052085	2232680	2052085	180595	67233	580580	87528	668108	661584	spneumoniae.S_pseudosimplitigsAC.k_14.d_12.M_default
spneumoniae	pseudosimplitigsAC	14	12	ones	2052085	2232680	2112721	119959	38259	580580	57012	637592	630924	spneumoniae.S_pseudosimplitigsAC.k_14.d_12.M_ones
spneumoniae	pseudosimplitigsAC	14	12	runs	2052085	2232680	2109296	123384	35717	580580	55296	635876	629824	spneumoniae.S_pseudosimplitigsAC.k_14.d_12.M_runs
spneumoniae	pseudosimplitigsAC	14	12	zeros	2052085	2232680	2052085	180595	69310	580580	92932	673512	664496	spneumoniae.S_pseudosimplitigsAC.k_14.d_12.M_zeros
spneumoniae	pseudosimplitigsAC	14	2	default	2052085	2284037	2052085	231952	44500	595348	66404	661752	660908	spneumoniae.S_pseudosimplitigsAC.k_14.d_2.M_default
spneumoniae	pseudosimplitigsAC	14	2	ones	2052085	2284037	2104468	179569	27687	595348	50552	645900	639420	spneumoniae.S_pseudosimplitigsAC.k_14.d_2.M_ones
spneumoniae	pseudosimplitigsAC	14	2	runs	2052085	2284037	2093347	190690	20363	595348	42464	637812	633716	spneumoniae.S_pseudosimplitigsAC.k_14.d_2.M_runs
spneumoniae	pseudosimplitigsAC	14	2	zeros	2052085	2284037	2052085	231952	46447	595348	69608	664956	661996	spneumoniae.S_pseudosimplitigsAC.k_14.d_2.M_zeros
spneumoniae	pseudosimplitigsAC	14	3	default	2052085	2228096	2052085	176011	50378	580896	72584	653480	649364	spneumoniae.S_pseudosimplitigsAC.k_14.d_3.M_default
spneumoniae	pseudosimplitigsAC	14	3	ones	2052085	2228096	2106059	122037	24528	580896	45768	626664	618800	spneumoniae.S_pseudosimplitigsAC.k_14.d_3.M_ones
spneumoniae	pseudosimplitigsAC	14	3	runs	2052085	2228096	2099652	128444	20335	580896	41244	622140	616276	spneumoniae.S_pseudosimplitigsAC.k_14.d_3.M_runs
spneumoniae	pseudosimplitigsAC	14	3	zeros	2052085	2228096	2052085	176011	50737	580896	73080	653976	649300	spneumoniae.S_pseudosimplitigsAC.k_14.d_3.M_zeros
spneumoniae	pseudosimplitigsAC	14	4	default	2052085	2225213	2052085	173128	55825	580672	77964	658636	652188	spneumoniae.S_pseudosimplitigsAC.k_14.d_4.M_default
spneumoniae	pseudosimplitigsAC	14	4	ones	2052085	2225213	2108234	116979	27773	580672	49152	629824	621740	spneumoniae.S_pseudosimplitigsAC.k_14.d_4.M_ones
spneumoniae	pseudosimplitigsAC	14	4	runs	2052085	2225213	2103787	121426	24724	580672	46252	626924	619756	spneumoniae.S_pseudosimplitigsAC.k_14.d_4.M_runs
spneumoniae	pseudosimplitigsAC	14	4	zeros	2052085	2225213	2052085	173128	55890	580672	78044	658716	652076	spneumoniae.S_pseudosimplitigsAC.k_14.d_4.M_zeros
spneumoniae	pseudosimplitigsAC	14	5	default	2052085	2229981	2052085	177896	60176	581004	82116	663120	657260	spneumoniae.S_pseudosimplitigsAC.k_14.d_5.M_default
spneumoniae	pseudosimplitigsAC	14	5	ones	2052085	2229981	2109769	120212	31420	581004	52492	633496	626560	spneumoniae.S_pseudosimplitigsAC.k_14.d_5.M_ones
spneumoniae	pseudosimplitigsAC	14	5	runs	2052085	2229981	2106196	123785	28845	581004	50188	631192	625384	spneumoniae.S_pseudosimplitigsAC.k_14.d_5.M_runs
spneumoniae	pseudosimplitigsAC	14	5	zeros	2052085	2229981	2052085	177896	60266	581004	82544	663548	657272	spneumoniae.S_pseudosimplitigsAC.k_14.d_5.M_zeros
spneumoniae	pseudosimplitigsAC	14	6	default	2052085	2235277	2052085	183192	63957	582300	85216	667516	661196	spneumoniae.S_pseudosimplitigsAC.k_14.d_6.M_default
spneumoniae	pseudosimplitigsAC	14	6	ones	2052085	2235277	2111246	124031	34864	582300	54944	637244	630832	spneumoniae.S_pseudosimplitigsAC.k_14.d_6.M_ones
spneumoniae	pseudosimplitigsAC	14	6	runs	2052085	2235277	2107972	127305	32471	582300	52956	635256	629600	spneumoniae.S_pseudosimplitigsAC.k_14.d_6.M_runs
spneumoniae	pseudosimplitigsAC	14	6	zeros	2052085	2235277	2052085	183192	64850	582300	88316	670616	663124	spneumoniae.S_pseudosimplitigsAC.k_14.d_6.M_zeros
spneumoniae	pseudosimplitigsAC	14	7	default	2052085	2236268	2052085	184183	66125	581620	86940	668560	662600	spneumoniae.S_pseudosimplitigsAC.k_14.d_7.M_default
spneumoniae	pseudosimplitigsAC	14	7	ones	2052085	2236268	2111901	124367	37049	581620	56328	637948	632208	spneumoniae.S_pseudosimplitigsAC.k_14.d_7.M_ones
spneumoniae	pseudosimplitigsAC	14	7	runs	2052085	2236268	2108647	127621	34636	581620	54668	636288	631072	spneumoniae.S_pseudosimplitigsAC.k_14.d_7.M_runs
spneumoniae	pseudosimplitigsAC	14	7	zeros	2052085	2236268	2052085	184183	67267	581620	90496	672116	664948	spneumoniae.S_pseudosimplitigsAC.k_14.d_7.M_zeros
spneumoniae	pseudosimplitigsAC	14	8	default	2052085	2235083	2052085	182998	66979	580764	87260	668024	661732	spneumoniae.S_pseudosimplitigsAC.k_14.d_8.M_default
spneumoniae	pseudosimplitigsAC	14	8	ones	2052085	2235083	2112488	122595	37968	580764	56904	637668	631948	spneumoniae.S_pseudosimplitigsAC.k_14.d_8.M_ones
spneumoniae	pseudosimplitigsAC	14	8	runs	2052085	2235083	2109094	125989	35482	580764	55128	635892	630640	spneumoniae.S_pseudosimplitigsAC.k_14.d_8.M_runs
spneumoniae	pseudosimplitigsAC	14	8	zeros	2052085	2235083	2052085	182998	68767	580764	92152	672916	665012	spneumoniae.S_pseudosimplitigsAC.k_14.d_8.M_zeros
spneumoniae	pseudosimplitigsAC	14	9	default	2052085	2233778	2052085	181693	67175	580920	87448	668368	660980	spneumoniae.S_pseudosimplitigsAC.k_14.d_9.M_default
spneumoniae	pseudosimplitigsAC	14	9	ones	2052085	2233778	2112557	121221	38120	580920	56968	637888	631448	spneumoniae.S_pseudosimplitigsAC.k_14.d_9.M_ones
spneumoniae	pseudosimplitigsAC	14	9	runs	2052085	2233778	2109205	124573	35637	580920	55188	636108	630204	spneumoniae.S_pseudosimplitigsAC.k_14.d_9.M_runs
spneumoniae	pseudosimplitigsAC	14	9	zeros	2052085	2233778	2052085	181693	69146	580920	92676	673596	664740	spneumoniae.S_pseudosimplitigsAC.k_14.d_9.M_zeros
spneumoniae	pseudosimplitigs	15	1	default	2098151	2301599	2098151	203448	14532	597636	29288	626924	630860	spneumoniae.S_pseudosimplitigs.k_15.d_1.M_default
spneumoniae	pseudosimplitigs	15	1	ones	2098151	2301599	2117222	184377	17395	597636	37524	635160	633340	spneumoniae.S_pseudosimplitigs.k_15.d_1.M_ones
spneumoniae	pseudosimplitigs	15	1	runs	2098151	2301599	2112961	188638	14458	597636	33240	630876	630376	spneumoniae.S_pseudosimplitigs.k_15.d_1.M_runs
spneumoniae	pseudosimplitigs	15	1	zeros	2098151	2301599	2098151	203448	16678	597636	34592	632228	633248	spneumoniae.S_pseudosimplitigs.k_15.d_1.M_zeros
spneumoniae	pseudosimplitigs	15	10	default	2098151	2190582	2098151	92431	26115	569616	47900	617516	609120	spneumoniae.S_pseudosimplitigs.k_15.d_10.M_default
spneumoniae	pseudosimplitigs	15	10	ones	2098151	2190582	2122352	68230	14668	569616	27836	597452	593244	spneumoniae.S_pseudosimplitigs.k_15.d_10.M_ones
spneumoniae	pseudosimplitigs	15	10	runs	2098151	2190582	2121369	69213	13970	569616	27232	596848	593164	spneumoniae.S_pseudosimplitigs.k_15.d_10.M_runs
spneumoniae	pseudosimplitigs	15	10	zeros	2098151	2190582	2098151	92431	26487	569616	49268	618884	609820	spneumoniae.S_pseudosimplitigs.k_15.d_10.M_zeros
spneumoniae	pseudosimplitigs	15	11	default	2098151	2190974	2098151	92823	26206	570088	47944	618032	608664	spneumoniae.S_pseudosimplitigs.k_15.d_11.M_default
spneumoniae	pseudosimplitigs	15	11	ones	2098151	2190974	2122387	68587	14762	570088	27896	597984	593944	spneumoniae.S_pseudosimplitigs.k_15.d_11.M_ones
spneumoniae	pseudosimplitigs	15	11	runs	2098151	2190974	2121313	69661	13990	570088	27316	597404	593284	spneumoniae.S_pseudosimplitigs.k_15.d_11.M_runs
spneumoniae	pseudosimplitigs	15	11	zeros	2098151	2190974	2098151	92823	26611	570088	49468	619556	609800	spneumoniae.S_pseudosimplitigs.k_15.d_11.M_zeros
spneumoniae	pseudosimplitigs	15	12	default	2098151	2191196	2098151	93045	26233	569760	48008	617768	608964	spneumoniae.S_pseudosimplitigs.k_15.d_12.M_default
spneumoniae	pseudosimplitigs	15	12	ones	2098151	2191196	2122449	68747	14800	569760	27908	597668	593764	spneumoniae.S_pseudosimplitigs.k_15.d_12.M_ones
spneumoniae	pseudosimplitigs	15	12	runs	2098151	2191196	2121362	69834	14020	569760	27304	597064	593292	spneumoniae.S_pseudosimplitigs.k_15.d_12.M_runs
spneumoniae	pseudosimplitigs	15	12	zeros	2098151	2191196	2098151	93045	26641	569760	49492	619252	610156	spneumoniae.S_pseudosimplitigs.k_15.d_12.M_zeros
spneumoniae	pseudosimplitigs	15	2	default	2098151	2193808	2098151	95657	15655	571548	33828	605376	599604	spneumoniae.S_pseudosimplitigs.k_15.d_2.M_default
spneumoniae	pseudosimplitigs	15	2	ones	2098151	2193808	2114138	79670	8176	571548	20708	592256	589200	spneumoniae.S_pseudosimplitigs.k_15.d_2.M_ones
spneumoniae	pseudosimplitigs	15	2	runs	2098151	2193808	2112514	81294	7030	571548	18924	590472	588356	spneumoniae.S_pseudosimplitigs.k_15.d_2.M_runs
spneumoniae	pseudosimplitigs	15	2	zeros	2098151	2193808	2098151	95657	16092	571548	34744	606292	599848	spneumoniae.S_pseudosimplitigs.k_15.d_2.M_zeros
spneumoniae	pseudosimplitigs	15	3	default	2098151	2166836	2098151	68685	16870	565144	36340	601484	592812	spneumoniae.S_pseudosimplitigs.k_15.d_3.M_default
spneumoniae	pseudosimplitigs	15	3	ones	2098151	2166836	2116412	50424	6344	565144	16832	581976	578428	spneumoniae.S_pseudosimplitigs.k_15.d_3.M_ones
spneumoniae	pseudosimplitigs	15	3	runs	2098151	2166836	2115505	51331	5718	565144	15944	581088	577412	spneumoniae.S_pseudosimplitigs.k_15.d_3.M_runs
spneumoniae	pseudosimplitigs	15	3	zeros	2098151	2166836	2098151	68685	16972	565144	36552	601696	592672	spneumoniae.S_pseudosimplitigs.k_15.d_3.M_zeros
spneumoniae	pseudosimplitigs	15	4	default	2098151	2163580	2098151	65429	18311	564544	39096	603640	594232	spneumoniae.S_pseudosimplitigs.k_15.d_4.M_default
spneumoniae	pseudosimplitigs	15	4	ones	2098151	2163580	2117961	45619	7001	564544	18424	582968	578172	spneumoniae.S_pseudosimplitigs.k_15.d_4.M_ones
spneumoniae	pseudosimplitigs	15	4	runs	2098151	2163580	2117269	46311	6506	564544	17808	582352	578128	spneumoniae.S_pseudosimplitigs.k_15.d_4.M_runs
spneumoniae	pseudosimplitigs	15	4	zeros	2098151	2163580	2098151	65429	18328	564544	39112	603656	593564	spneumoniae.S_pseudosimplitigs.k_15.d_4.M_zeros
spneumoniae	pseudosimplitigs	15	5	default	2098151	2167052	2098151	68901	19762	565104	41276	606380	596192	spneumoniae.S_pseudosimplitigs.k_15.d_5.M_default
spneumoniae	pseudosimplitigs	15	5	ones	2098151	2167052	2118973	48079	8255	565104	20796	585900	581148	spneumoniae.S_pseudosimplitigs.k_15.d_5.M_ones
spneumoniae	pseudosimplitigs	15	5	runs	2098151	2167052	2118362	48690	7819	565104	20204	585308	580844	spneumoniae.S_pseudosimplitigs.k_15.d_5.M_runs
spneumoniae	pseudosimplitigs	15	5	zeros	2098151	2167052	2098151	68901	19771	565104	41248	606352	596552	spneumoniae.S_pseudosimplitigs.k_15.d_5.M_zeros
spneumoniae	pseudosimplitigs	15	6	default	2098151	2173499	2098151	75348	21644	566108	43744	609852	600936	spneumoniae.S_pseudosimplitigs.k_15.d_6.M_default
spneumoniae	pseudosimplitigs	15	6	ones	2098151	2173499	2120122	53377	10058	566108	23256	589364	585284	spneumoniae.S_pseudosimplitigs.k_15.d_6.M_ones
spneumoniae	pseudosimplitigs	15	6	runs	2098151	2173499	2119444	54055	9559	566108	22724	588832	585032	spneumoniae.S_pseudosimplitigs.k_15.d_6.M_runs
spneumoniae	pseudosimplitigs	15	6	zeros	2098151	2173499	2098151	75348	21665	566108	43828	609936	600468	spneumoniae.S_pseudosimplitigs.k_15.d_6.M_zeros
spneumoniae	pseudosimplitigs	15	7	default	2098151	2181393	2098151	83242	23565	567720	45656	613376	604772	spneumoniae.S_pseudosimplitigs.k_15.d_7.M_default
spneumoniae	pseudosimplitigs	15	7	ones	2098151	2181393	2121085	60308	12022	567720	25556	593276	589480	spneumoniae.S_pseudosimplitigs.k_15.d_7.M_ones
spneumoniae	pseudosimplitigs	15	7	runs	2098151	2181393	2120358	61035	11485	567720	24984	592704	589388	spneumoniae.S_pseudosimplitigs.k_15.d_7.M_runs
spneumoniae	pseudosimplitigs	15	7	zeros	2098151	2181393	2098151	83242	23661	567720	46120	613840	605104	spneumoniae.S_pseudosimplitigs.k_15.d_7.M_zeros
spneumoniae	pseudosimplitigs	15	8	default	2098151	2187709	2098151	89558	25146	569516	47220	616736	607704	spneumoniae.S_pseudosimplitigs.k_15.d_8.M_default
spneumoniae	pseudosimplitigs	15	8	ones	2098151	2187709	2121656	66053	13669	569516	27172	596688	592392	spneumoniae.S_pseudosimplitigs.k_15.d_8.M_ones
spneumoniae	pseudosimplitigs	15	8	runs	2098151	2187709	2120840	66869	13059	569516	26580	596096	591828	spneumoniae.S_pseudosimplitigs.k_15.d_8.M_runs
spneumoniae	pseudosimplitigs	15	8	zeros	2098151	2187709	2098151	89558	25337	569516	48016	617532	608128	spneumoniae.S_pseudosimplitigs.k_15.d_8.M_zeros
spneumoniae	pseudosimplitigs	15	9	default	2098151	2190072	2098151	91921	25858	570064	47716	617780	608724	spneumoniae.S_pseudosimplitigs.k_15.d_9.M_default
spneumoniae	pseudosimplitigs	15	9	ones	2098151	2190072	2122038	68034	14369	570064	27648	597712	593628	spneumoniae.S_pseudosimplitigs.k_15.d_9.M_ones
spneumoniae	pseudosimplitigs	15	9	runs	2098151	2190072	2121142	68930	13722	570064	27064	597128	593104	spneumoniae.S_pseudosimplitigs.k_15.d_9.M_runs
spneumoniae	pseudosimplitigs	15	9	zeros	2098151	2190072	2098151	91921	26222	570064	49048	619112	609736	spneumoniae.S_pseudosimplitigs.k_15.d_9.M_zeros
spneumoniae	pseudosimplitigsAC	15	1	default	2098151	2301599	2098151	203448	14532	597356	28980	626336	630296	spneumoniae.S_pseudosimplitigsAC.k_15.d_1.M_default
spneumoniae	pseudosimplitigsAC	15	1	ones	2098151	2301599	2117277	184322	17370	597356	37204	634560	632484	spneumoniae.S_pseudosimplitigsAC.k_15.d_1.M_ones
spneumoniae	pseudosimplitigsAC	15	1	runs	2098151	2301599	2113057	188542	14478	597356	32908	630264	630272	spneumoniae.S_pseudosimplitigsAC.k_15.d_1.M_runs
spneumoniae	pseudosimplitigsAC	15	1	zeros	2098151	2301599	2098151	203448	16561	597356	34028	631384	632932	spneumoniae.S_pseudosimplitigsAC.k_15.d_1.M_zeros
spneumoniae	pseudosimplitigsAC	15	10	default	2098151	2185151	2098151	87000	25039	568140	46092	614232	605976	spneumoniae.S_pseudosimplitigsAC.k_15.d_10.M_default
spneumoniae	pseudosimplitigsAC	15	10	ones	2098151	2185151	2121972	63179	13357	568140	25160	593300	590332	spneumoniae.S_pseudosimplitigsAC.k_15.d_10.M_ones
spneumoniae	pseudosimplitigsAC	15	10	runs	2098151	2185151	2121102	64049	12716	568140	24644	592784	589840	spneumoniae.S_pseudosimplitigsAC.k_15.d_10.M_runs
spneumoniae	pseudosimplitigsAC	15	10	zeros	2098151	2185151	2098151	87000	25398	568140	47480	615620	606996	spneumoniae.S_pseudosimplitigsAC.k_15.d_10.M_zeros
spneumoniae	pseudosimplitigsAC	15	11	default	2098151	2185162	2098151	87011	25130	568472	46160	614632	605880	spneumoniae.S_pseudosimplitigsAC.k_15.d_11.M_default
spneumoniae	pseudosimplitigsAC	15	11	ones	2098151	2185162	2121965	63197	13464	568472	25232	593704	590208	spneumoniae.S_pseudosimplitigsAC.k_15.d_11.M_ones
spneumoniae	pseudosimplitigsAC	15	11	runs	2098151	2185162	2121076	64086	12807	568472	24680	593152	589416	spneumoniae.S_pseudosimplitigsAC.k_15.d_11.M_runs
spneumoniae	pseudosimplitigsAC	15	11	zeros	2098151	2185162	2098151	87011	25586	568472	47804	616276	606516	spneumoniae.S_pseudosimplitigsAC.k_15.d_11.M_zeros
spneumoniae	pseudosimplitigsAC	15	12	default	2098151	2184845	2098151	86694	25115	568384	46172	614556	605776	spneumoniae.S_pseudosimplitigsAC.k_15.d_12.M_default
spneumoniae	pseudosimplitigsAC	15	12	ones	2098151	2184845	2121977	62868	13436	568384	25216	593600	590100	spneumoniae.S_pseudosimplitigsAC.k_15.d_12.M_ones
spneumoniae	pseudosimplitigsAC	15	12	runs	2098151	2184845	2121122	63723	12801	568384	24680	593064	589836	spneumoniae.S_pseudosimplitigsAC.k_15.d_12.M_runs
spneumoniae	pseudosimplitigsAC	15	12	zeros	2098151	2184845	2098151	86694	25570	568384	47816	616200	606420	spneumoniae.S_pseudosimplitigsAC.k_15.d_12.M_zeros
spneumoniae	pseudosimplitigsAC	15	2	default	2098151	2191966	2098151	93815	15529	571728	33588	605316	599400	spneumoniae.S_pseudosimplitigsAC.k_15.d_2.M_default
spneumoniae	pseudosimplitigsAC	15	2	ones	2098151	2191966	2114367	77599	7932	571728	19884	591612	587964	spneumoniae.S_pseudosimplitigsAC.k_15.d_2.M_ones
spneumoniae	pseudosimplitigsAC	15	2	runs	2098151	2191966	2112701	79265	6745	571728	18116	589844	586884	spneumoniae.S_pseudosimplitigsAC.k_15.d_2.M_runs
spneumoniae	pseudosimplitigsAC	15	2	zeros	2098151	2191966	2098151	93815	15947	571728	34440	606168	599604	spneumoniae.S_pseudosimplitigsAC.k_15.d_2.M_zeros
spneumoniae	pseudosimplitigsAC	15	3	default	2098151	2164713	2098151	66562	16608	564348	35988	600336	591952	spneumoniae.S_pseudosimplitigsAC.k_15.d_3.M_default
spneumoniae	pseudosimplitigsAC	15	3	ones	2098151	2164713	2116341	48372	5943	564348	15728	580076	577076	spneumoniae.S_pseudosimplitigsAC.k_15.d_3.M_ones
spneumoniae	pseudosimplitigsAC	15	3	runs	2098151	2164713	2115484	49229	5326	564348	14860	579208	576504	spneumoniae.S_pseudosimplitigsAC.k_15.d_3.M_runs
spneumoniae	pseudosimplitigsAC	15	3	zeros	2098151	2164713	2098151	66562	16679	564348	36116	600464	591728	spneumoniae.S_pseudosimplitigsAC.k_15.d_3.M_zeros
spneumoniae	pseudosimplitigsAC	15	4	default	2098151	2160064	2098151	61913	17767	562896	37996	600892	591436	spneumoniae.S_pseudosimplitigsAC.k_15.d_4.M_default
spneumoniae	pseudosimplitigsAC	15	4	ones	2098151	2160064	2117963	42101	6183	562896	16332	579228	575008	spneumoniae.S_pseudosimplitigsAC.k_15.d_4.M_ones
spneumoniae	pseudosimplitigsAC	15	4	runs	2098151	2160064	2117348	42716	5760	562896	15740	578636	574860	spneumoniae.S_pseudosimplitigsAC.k_15.d_4.M_runs
spneumoniae	pseudosimplitigsAC	15	4	zeros	2098151	2160064	2098151	61913	17797	562896	38060	600956	592108	spneumoniae.S_pseudosimplitigsAC.k_15.d_4.M_zeros
spneumoniae	pseudosimplitigsAC	15	5	default	2098151	2164133	2098151	65982	19273	564268	40340	604608	595060	spneumoniae.S_pseudosimplitigsAC.k_15.d_5.M_default
spneumoniae	pseudosimplitigsAC	15	5	ones	2098151	2164133	2118996	45137	7607	564268	19076	583344	578680	spneumoniae.S_pseudosimplitigsAC.k_15.d_5.M_ones
spneumoniae	pseudosimplitigsAC	15	5	runs	2098151	2164133	2118415	45718	7196	564268	18572	582840	578412	spneumoniae.S_pseudosimplitigsAC.k_15.d_5.M_runs
spneumoniae	pseudosimplitigsAC	15	5	zeros	2098151	2164133	2098151	65982	19324	564268	40568	604836	595160	spneumoniae.S_pseudosimplitigsAC.k_15.d_5.M_zeros
spneumoniae	pseudosimplitigsAC	15	6	default	2098151	2170180	2098151	72029	20945	565156	42420	607576	598384	spneumoniae.S_pseudosimplitigsAC.k_15.d_6.M_default
spneumoniae	pseudosimplitigsAC	15	6	ones	2098151	2170180	2120013	50167	9130	565156	21216	586372	582104	spneumoniae.S_pseudosimplitigsAC.k_15.d_6.M_ones
spneumoniae	pseudosimplitigsAC	15	6	runs	2098151	2170180	2119449	50731	8722	565156	20736	585892	582120	spneumoniae.S_pseudosimplitigsAC.k_15.d_6.M_runs
spneumoniae	pseudosimplitigsAC	15	6	zeros	2098151	2170180	2098151	72029	21016	565156	42792	607948	598552	spneumoniae.S_pseudosimplitigsAC.k_15.d_6.M_zeros
spneumoniae	pseudosimplitigsAC	15	7	default	2098151	2177164	2098151	79013	22631	566916	44244	611160	602304	spneumoniae.S_pseudosimplitigsAC.k_15.d_7.M_default
spneumoniae	pseudosimplitigsAC	15	7	ones	2098151	2177164	2121098	56066	10861	566916	23104	590020	586384	spneumoniae.S_pseudosimplitigsAC.k_15.d_7.M_ones
spneumoniae	pseudosimplitigsAC	15	7	runs	2098151	2177164	2120462	56702	10390	566916	22592	589508	586228	spneumoniae.S_pseudosimplitigsAC.k_15.d_7.M_runs
spneumoniae	pseudosimplitigsAC	15	7	zeros	2098151	2177164	2098151	79013	22805	566916	44988	611904	602712	spneumoniae.S_pseudosimplitigsAC.k_15.d_7.M_zeros
spneumoniae	pseudosimplitigsAC	15	8	default	2098151	2182118	2098151	83967	23991	568064	45500	613564	604936	spneumoniae.S_pseudosimplitigsAC.k_15.d_8.M_default
spneumoniae	pseudosimplitigsAC	15	8	ones	2098151	2182118	2121484	60634	12251	568064	24492	592556	589196	spneumoniae.S_pseudosimplitigsAC.k_15.d_8.M_ones
spneumoniae	pseudosimplitigsAC	15	8	runs	2098151	2182118	2120804	61314	11729	568064	23952	592016	588732	spneumoniae.S_pseudosimplitigsAC.k_15.d_8.M_runs
spneumoniae	pseudosimplitigsAC	15	8	zeros	2098151	2182118	2098151	83967	24324	568064	46828	614892	605916	spneumoniae.S_pseudosimplitigsAC.k_15.d_8.M_zeros
spneumoniae	pseudosimplitigsAC	15	9	default	2098151	2185435	2098151	87284	24837	568380	45940	614320	606416	spneumoniae.S_pseudosimplitigsAC.k_15.d_9.M_default
spneumoniae	pseudosimplitigsAC	15	9	ones	2098151	2185435	2121912	63523	13163	568380	25104	593484	590772	spneumoniae.S_pseudosimplitigsAC.k_15.d_9.M_ones
spneumoniae	pseudosimplitigsAC	15	9	runs	2098151	2185435	2121040	64395	12527	568380	24452	592832	590788	spneumoniae.S_pseudosimplitigsAC.k_15.d_9.M_runs
spneumoniae	pseudosimplitigsAC	15	9	zeros	2098151	2185435	2098151	87284	25169	568380	47244	615624	607196	spneumoniae.S_pseudosimplitigsAC.k_15.d_9.M_zeros
spneumoniae	pseudosimplitigs	16	1	default	2114070	2203680	2114070	89610	5974	572612	14632	587244	588100	spneumoniae.S_pseudosimplitigs.k_16.d_1.M_default
spneumoniae	pseudosimplitigs	16	1	ones	2114070	2203680	2120423	83257	6406	572612	17000	589612	588828	spneumoniae.S_pseudosimplitigs.k_16.d_1.M_ones
spneumoniae	pseudosimplitigs	16	1	runs	2114070	2203680	2119784	83896	5961	572612	16184	588796	588104	spneumoniae.S_pseudosimplitigs.k_16.d_1.M_runs
spneumoniae	pseudosimplitigs	16	1	zeros	2114070	2203680	2114070	89610	6427	572612	15980	588592	589008	spneumoniae.S_pseudosimplitigs.k_16.d_1.M_zeros
spneumoniae	pseudosimplitigs	16	10	default	2114070	2170844	2114070	56774	11488	564168	25012	589180	585324	spneumoniae.S_pseudosimplitigs.k_16.d_10.M_default
spneumoniae	pseudosimplitigs	16	10	ones	2114070	2170844	2125214	45630	6956	564168	14368	578536	578444	spneumoniae.S_pseudosimplitigs.k_16.d_10.M_ones
spneumoniae	pseudosimplitigs	16	10	runs	2114070	2170844	2124901	45943	6755	564168	14244	578412	577420	spneumoniae.S_pseudosimplitigs.k_16.d_10.M_runs
spneumoniae	pseudosimplitigs	16	10	zeros	2114070	2170844	2114070	56774	11565	564168	25352	589520	585356	spneumoniae.S_pseudosimplitigs.k_16.d_10.M_zeros
spneumoniae	pseudosimplitigs	16	11	default	2114070	2172109	2114070	58039	11756	564244	25196	589440	585252	spneumoniae.S_pseudosimplitigs.k_16.d_11.M_default
spneumoniae	pseudosimplitigs	16	11	ones	2114070	2172109	2125262	46847	7232	564244	14524	578768	577996	spneumoniae.S_pseudosimplitigs.k_16.d_11.M_ones
spneumoniae	pseudosimplitigs	16	11	runs	2114070	2172109	2124934	47175	7011	564244	14368	578612	577876	spneumoniae.S_pseudosimplitigs.k_16.d_11.M_runs
spneumoniae	pseudosimplitigs	16	11	zeros	2114070	2172109	2114070	58039	11843	564244	25556	589800	585368	spneumoniae.S_pseudosimplitigs.k_16.d_11.M_zeros
spneumoniae	pseudosimplitigs	16	12	default	2114070	2172851	2114070	58781	11860	564272	25236	589508	585008	spneumoniae.S_pseudosimplitigs.k_16.d_12.M_default
spneumoniae	pseudosimplitigs	16	12	ones	2114070	2172851	2125303	47548	7355	564272	14584	578856	578336	spneumoniae.S_pseudosimplitigs.k_16.d_12.M_ones
spneumoniae	pseudosimplitigs	16	12	runs	2114070	2172851	2124945	47906	7119	564272	14400	578672	578088	spneumoniae.S_pseudosimplitigs.k_16.d_12.M_runs
spneumoniae	pseudosimplitigs	16	12	zeros	2114070	2172851	2114070	58781	11946	564272	25624	589896	585592	spneumoniae.S_pseudosimplitigs.k_16.d_12.M_zeros
spneumoniae	pseudosimplitigs	16	2	default	2114070	2163667	2114070	49597	6183	563332	16472	579804	575872	spneumoniae.S_pseudosimplitigs.k_16.d_2.M_default
spneumoniae	pseudosimplitigs	16	2	ones	2114070	2163667	2120009	43658	3416	563332	9664	572996	571384	spneumoniae.S_pseudosimplitigs.k_16.d_2.M_ones
spneumoniae	pseudosimplitigs	16	2	runs	2114070	2163667	2119749	43918	3225	563332	9280	572612	571368	spneumoniae.S_pseudosimplitigs.k_16.d_2.M_runs
spneumoniae	pseudosimplitigs	16	2	zeros	2114070	2163667	2114070	49597	6261	563332	16708	580040	575692	spneumoniae.S_pseudosimplitigs.k_16.d_2.M_zeros
spneumoniae	pseudosimplitigs	16	3	default	2114070	2150864	2114070	36794	6397	559992	17348	577340	572836	spneumoniae.S_pseudosimplitigs.k_16.d_3.M_default
spneumoniae	pseudosimplitigs	16	3	ones	2114070	2150864	2121195	29669	2486	559992	7332	567324	566628	spneumoniae.S_pseudosimplitigs.k_16.d_3.M_ones
spneumoniae	pseudosimplitigs	16	3	runs	2114070	2150864	2121059	29805	2393	559992	7144	567136	566492	spneumoniae.S_pseudosimplitigs.k_16.d_3.M_runs
spneumoniae	pseudosimplitigs	16	3	zeros	2114070	2150864	2114070	36794	6415	559992	17376	577368	572744	spneumoniae.S_pseudosimplitigs.k_16.d_3.M_zeros
spneumoniae	pseudosimplitigs	16	4	default	2114070	2147669	2114070	33599	6634	560332	18056	578388	572516	spneumoniae.S_pseudosimplitigs.k_16.d_4.M_default
spneumoniae	pseudosimplitigs	16	4	ones	2114070	2147669	2121849	25820	2403	560332	7152	567484	567464	spneumoniae.S_pseudosimplitigs.k_16.d_4.M_ones
spneumoniae	pseudosimplitigs	16	4	runs	2114070	2147669	2121721	25948	2306	560332	6944	567276	567392	spneumoniae.S_pseudosimplitigs.k_16.d_4.M_runs
spneumoniae	pseudosimplitigs	16	4	zeros	2114070	2147669	2114070	33599	6644	560332	18084	578416	572284	spneumoniae.S_pseudosimplitigs.k_16.d_4.M_zeros
spneumoniae	pseudosimplitigs	16	5	default	2114070	2147473	2114070	33403	7035	558888	19096	577984	572760	spneumoniae.S_pseudosimplitigs.k_16.d_5.M_default
spneumoniae	pseudosimplitigs	16	5	ones	2114070	2147473	2122512	24961	2619	558888	7908	566796	565220	spneumoniae.S_pseudosimplitigs.k_16.d_5.M_ones
spneumoniae	pseudosimplitigs	16	5	runs	2114070	2147473	2122414	25059	2545	558888	7740	566628	565112	spneumoniae.S_pseudosimplitigs.k_16.d_5.M_runs
spneumoniae	pseudosimplitigs	16	5	zeros	2114070	2147473	2114070	33403	7046	558888	19124	578012	572608	spneumoniae.S_pseudosimplitigs.k_16.d_5.M_zeros
spneumoniae	pseudosimplitigs	16	6	default	2114070	2149615	2114070	35545	7700	560044	20552	580596	574856	spneumoniae.S_pseudosimplitigs.k_16.d_6.M_default
spneumoniae	pseudosimplitigs	16	6	ones	2114070	2149615	2123217	26398	3197	560044	9436	569480	567204	spneumoniae.S_pseudosimplitigs.k_16.d_6.M_ones
spneumoniae	pseudosimplitigs	16	6	runs	2114070	2149615	2123095	26520	3113	560044	9300	569344	567260	spneumoniae.S_pseudosimplitigs.k_16.d_6.M_runs
spneumoniae	pseudosimplitigs	16	6	zeros	2114070	2149615	2114070	35545	7716	560044	20640	580684	574784	spneumoniae.S_pseudosimplitigs.k_16.d_6.M_zeros
spneumoniae	pseudosimplitigs	16	7	default	2114070	2154404	2114070	40334	8637	561072	22172	583244	577988	spneumoniae.S_pseudosimplitigs.k_16.d_7.M_default
spneumoniae	pseudosimplitigs	16	7	ones	2114070	2154404	2123826	30578	4099	561072	11232	572304	570296	spneumoniae.S_pseudosimplitigs.k_16.d_7.M_ones
spneumoniae	pseudosimplitigs	16	7	runs	2114070	2154404	2123698	30706	4017	561072	11116	572188	570272	spneumoniae.S_pseudosimplitigs.k_16.d_7.M_runs
spneumoniae	pseudosimplitigs	16	7	zeros	2114070	2154404	2114070	40334	8649	561072	22264	583336	577528	spneumoniae.S_pseudosimplitigs.k_16.d_7.M_zeros
spneumoniae	pseudosimplitigs	16	8	default	2114070	2160290	2114070	46220	9652	562232	23296	585528	580896	spneumoniae.S_pseudosimplitigs.k_16.d_8.M_default
spneumoniae	pseudosimplitigs	16	8	ones	2114070	2160290	2124310	35980	5109	562232	12568	574800	573072	spneumoniae.S_pseudosimplitigs.k_16.d_8.M_ones
spneumoniae	pseudosimplitigs	16	8	runs	2114070	2160290	2124137	36153	4989	562232	12400	574632	572952	spneumoniae.S_pseudosimplitigs.k_16.d_8.M_runs
spneumoniae	pseudosimplitigs	16	8	zeros	2114070	2160290	2114070	46220	9676	562232	23420	585652	580588	spneumoniae.S_pseudosimplitigs.k_16.d_8.M_zeros
spneumoniae	pseudosimplitigs	16	9	default	2114070	2167854	2114070	53784	10917	564224	24640	588864	583848	spneumoniae.S_pseudosimplitigs.k_16.d_9.M_default
spneumoniae	pseudosimplitigs	16	9	ones	2114070	2167854	2125027	42827	6375	564224	13956	578180	576996	spneumoniae.S_pseudosimplitigs.k_16.d_9.M_ones
spneumoniae	pseudosimplitigs	16	9	runs	2114070	2167854	2124764	43090	6199	564224	13788	578012	577084	spneumoniae.S_pseudosimplitigs.k_16.d_9.M_runs
spneumoniae	pseudosimplitigs	16	9	zeros	2114070	2167854	2114070	53784	10985	564224	24936	589160	584004	spneumoniae.S_pseudosimplitigs.k_16.d_9.M_zeros
spneumoniae	pseudosimplitigsAC	16	1	default	2114070	2203665	2114070	89595	5973	572224	14496	586720	588324	spneumoniae.S_pseudosimplitigsAC.k_16.d_1.M_default
spneumoniae	pseudosimplitigsAC	16	1	ones	2114070	2203665	2120246	83419	6371	572224	16884	589108	588604	spneumoniae.S_pseudosimplitigsAC.k_16.d_1.M_ones
spneumoniae	pseudosimplitigsAC	16	1	runs	2114070	2203665	2119620	84045	5953	572224	16076	588300	588132	spneumoniae.S_pseudosimplitigsAC.k_16.d_1.M_runs
spneumoniae	pseudosimplitigsAC	16	1	zeros	2114070	2203665	2114070	89595	6392	572224	15816	588040	588688	spneumoniae.S_pseudosimplitigsAC.k_16.d_1.M_zeros
spneumoniae	pseudosimplitigsAC	16	10	default	2114070	2167460	2114070	53390	10916	564064	24080	588144	583296	spneumoniae.S_pseudosimplitigsAC.k_16.d_10.M_default
spneumoniae	pseudosimplitigsAC	16	10	ones	2114070	2167460	2125075	42385	6349	564064	13244	577308	576332	spneumoniae.S_pseudosimplitigsAC.k_16.d_10.M_ones
spneumoniae	pseudosimplitigsAC	16	10	runs	2114070	2167460	2124811	42649	6160	564064	13052	577116	576132	spneumoniae.S_pseudosimplitigsAC.k_16.d_10.M_runs
spneumoniae	pseudosimplitigsAC	16	10	zeros	2114070	2167460	2114070	53390	11082	564064	24828	588892	583744	spneumoniae.S_pseudosimplitigsAC.k_16.d_10.M_zeros
spneumoniae	pseudosimplitigsAC	16	11	default	2114070	2169541	2114070	55471	11285	563440	24356	587796	583820	spneumoniae.S_pseudosimplitigsAC.k_16.d_11.M_default
spneumoniae	pseudosimplitigsAC	16	11	ones	2114070	2169541	2125194	44347	6710	563440	13464	576904	577512	spneumoniae.S_pseudosimplitigsAC.k_16.d_11.M_ones
spneumoniae	pseudosimplitigsAC	16	11	runs	2114070	2169541	2124886	44655	6504	563440	13300	576740	576376	spneumoniae.S_pseudosimplitigsAC.k_16.d_11.M_runs
spneumoniae	pseudosimplitigsAC	16	11	zeros	2114070	2169541	2114070	55471	11461	563440	25112	588552	584260	spneumoniae.S_pseudosimplitigsAC.k_16.d_11.M_zeros
spneumoniae	pseudosimplitigsAC	16	12	default	2114070	2169281	2114070	55211	11299	564504	24360	588864	583896	spneumoniae.S_pseudosimplitigsAC.k_16.d_12.M_default
spneumoniae	pseudosimplitigsAC	16	12	ones	2114070	2169281	2125161	44120	6736	564504	13484	577988	577444	spneumoniae.S_pseudosimplitigsAC.k_16.d_12.M_ones
spneumoniae	pseudosimplitigsAC	16	12	runs	2114070	2169281	2124853	44428	6528	564504	13308	577812	576844	spneumoniae.S_pseudosimplitigsAC.k_16.d_12.M_runs
spneumoniae	pseudosimplitigsAC	16	12	zeros	2114070	2169281	2114070	55211	11483	564504	25148	589652	584392	spneumoniae.S_pseudosimplitigsAC.k_16.d_12.M_zeros
spneumoniae	pseudosimplitigsAC	16	2	default	2114070	2163617	2114070	49547	6161	562724	16292	579016	575376	spneumoniae.S_pseudosimplitigsAC.k_16.d_2.M_default
spneumoniae	pseudosimplitigsAC	16	2	ones	2114070	2163617	2120010	43607	3394	562724	9416	572140	571472	spneumoniae.S_pseudosimplitigsAC.k_16.d_2.M_ones
spneumoniae	pseudosimplitigsAC	16	2	runs	2114070	2163617	2119730	43887	3201	562724	9024	571748	571316	spneumoniae.S_pseudosimplitigsAC.k_16.d_2.M_runs
spneumoniae	pseudosimplitigsAC	16	2	zeros	2114070	2163617	2114070	49547	6266	562724	16640	579364	575796	spneumoniae.S_pseudosimplitigsAC.k_16.d_2.M_zeros
spneumoniae	pseudosimplitigsAC	16	3	default	2114070	2150087	2114070	36017	6312	559632	17028	576660	572744	spneumoniae.S_pseudosimplitigsAC.k_16.d_3.M_default
spneumoniae	pseudosimplitigsAC	16	3	ones	2114070	2150087	2121040	29047	2346	559632	6808	566440	565868	spneumoniae.S_pseudosimplitigsAC.k_16.d_3.M_ones
spneumoniae	pseudosimplitigsAC	16	3	runs	2114070	2150087	2120926	29161	2270	559632	6608	566240	565600	spneumoniae.S_pseudosimplitigsAC.k_16.d_3.M_runs
spneumoniae	pseudosimplitigsAC	16	3	zeros	2114070	2150087	2114070	36017	6335	559632	17064	576696	572468	spneumoniae.S_pseudosimplitigsAC.k_16.d_3.M_zeros
spneumoniae	pseudosimplitigsAC	16	4	default	2114070	2146976	2114070	32906	6543	559272	17872	577144	571800	spneumoniae.S_pseudosimplitigsAC.k_16.d_4.M_default
spneumoniae	pseudosimplitigsAC	16	4	ones	2114070	2146976	2121782	25194	2257	559272	6600	565872	565536	spneumoniae.S_pseudosimplitigsAC.k_16.d_4.M_ones
spneumoniae	pseudosimplitigsAC	16	4	runs	2114070	2146976	2121694	25282	2190	559272	6464	565736	565540	spneumoniae.S_pseudosimplitigsAC.k_16.d_4.M_runs
spneumoniae	pseudosimplitigsAC	16	4	zeros	2114070	2146976	2114070	32906	6557	559272	17928	577200	571604	spneumoniae.S_pseudosimplitigsAC.k_16.d_4.M_zeros
spneumoniae	pseudosimplitigsAC	16	5	default	2114070	2147214	2114070	33144	6949	559096	18788	577884	572708	spneumoniae.S_pseudosimplitigsAC.k_16.d_5.M_default
spneumoniae	pseudosimplitigsAC	16	5	ones	2114070	2147214	2122369	24845	2549	559096	7524	566620	565472	spneumoniae.S_pseudosimplitigsAC.k_16.d_5.M_ones
spneumoniae	pseudosimplitigsAC	16	5	runs	2114070	2147214	2122256	24958	2472	559096	7392	566488	565148	spneumoniae.S_pseudosimplitigsAC.k_16.d_5.M_runs
spneumoniae	pseudosimplitigsAC	16	5	zeros	2114070	2147214	2114070	33144	6952	559096	18772	577868	573664	spneumoniae.S_pseudosimplitigsAC.k_16.d_5.M_zeros
spneumoniae	pseudosimplitigsAC	16	6	default	2114070	2148578	2114070	34508	7503	559752	20020	579772	573592	spneumoniae.S_pseudosimplitigsAC.k_16.d_6.M_default
spneumoniae	pseudosimplitigsAC	16	6	ones	2114070	2148578	2123092	25486	2988	559752	8840	568592	566908	spneumoniae.S_pseudosimplitigsAC.k_16.d_6.M_ones
spneumoniae	pseudosimplitigsAC	16	6	runs	2114070	2148578	2122984	25594	2903	559752	8728	568480	566852	spneumoniae.S_pseudosimplitigsAC.k_16.d_6.M_runs
spneumoniae	pseudosimplitigsAC	16	6	zeros	2114070	2148578	2114070	34508	7517	559752	20100	579852	574036	spneumoniae.S_pseudosimplitigsAC.k_16.d_6.M_zeros
spneumoniae	pseudosimplitigsAC	16	7	default	2114070	2152224	2114070	38154	8268	560616	21284	581900	576376	spneumoniae.S_pseudosimplitigsAC.k_16.d_7.M_default
spneumoniae	pseudosimplitigsAC	16	7	ones	2114070	2152224	2123652	28572	3699	560616	10292	570908	568836	spneumoniae.S_pseudosimplitigsAC.k_16.d_7.M_ones
spneumoniae	pseudosimplitigsAC	16	7	runs	2114070	2152224	2123549	28675	3617	560616	10188	570804	568880	spneumoniae.S_pseudosimplitigsAC.k_16.d_7.M_runs
spneumoniae	pseudosimplitigsAC	16	7	zeros	2114070	2152224	2114070	38154	8281	560616	21332	581948	575968	spneumoniae.S_pseudosimplitigsAC.k_16.d_7.M_zeros
spneumoniae	pseudosimplitigsAC	16	8	default	2114070	2158086	2114070	44016	9306	562096	22568	584664	579132	spneumoniae.S_pseudosimplitigsAC.k_16.d_8.M_default
spneumoniae	pseudosimplitigsAC	16	8	ones	2114070	2158086	2124279	33807	4713	562096	11704	573800	571820	spneumoniae.S_pseudosimplitigsAC.k_16.d_8.M_ones
spneumoniae	pseudosimplitigsAC	16	8	runs	2114070	2158086	2124106	33980	4598	562096	11552	573648	572164	spneumoniae.S_pseudosimplitigsAC.k_16.d_8.M_runs
spneumoniae	pseudosimplitigsAC	16	8	zeros	2114070	2158086	2114070	44016	9352	562096	22840	584936	579264	spneumoniae.S_pseudosimplitigsAC.k_16.d_8.M_zeros
spneumoniae	pseudosimplitigsAC	16	9	default	2114070	2163846	2114070	49776	10259	563368	23484	586852	581968	spneumoniae.S_pseudosimplitigsAC.k_16.d_9.M_default
spneumoniae	pseudosimplitigsAC	16	9	ones	2114070	2163846	2124886	38960	5676	563368	12608	575976	575008	spneumoniae.S_pseudosimplitigsAC.k_16.d_9.M_ones
spneumoniae	pseudosimplitigsAC	16	9	runs	2114070	2163846	2124671	39175	5517	563368	12436	575804	574552	spneumoniae.S_pseudosimplitigsAC.k_16.d_9.M_runs
spneumoniae	pseudosimplitigsAC	16	9	zeros	2114070	2163846	2114070	49776	10342	563368	23928	587296	582224	spneumoniae.S_pseudosimplitigsAC.k_16.d_9.M_zeros
spneumoniae	pseudosimplitigs	17	1	default	2120449	2171601	2120449	51152	3197	564272	8100	572372	572896	spneumoniae.S_pseudosimplitigs.k_17.d_1.M_default
spneumoniae	pseudosimplitigs	17	1	ones	2120449	2171601	2123516	48085	3264	564272	9136	573408	573176	spneumoniae.S_pseudosimplitigs.k_17.d_1.M_ones
spneumoniae	pseudosimplitigs	17	1	runs	2120449	2171601	2123361	48240	3179	564272	8968	573240	573244	spneumoniae.S_pseudosimplitigs.k_17.d_1.M_runs
spneumoniae	pseudosimplitigs	17	1	zeros	2120449	2171601	2120449	51152	3352	564272	8652	572924	573116	spneumoniae.S_pseudosimplitigs.k_17.d_1.M_zeros
spneumoniae	pseudosimplitigs	17	10	default	2120449	2163100	2120449	42651	6525	562608	15336	577944	576884	spneumoniae.S_pseudosimplitigs.k_17.d_10.M_default
spneumoniae	pseudosimplitigs	17	10	ones	2120449	2163100	2127404	35696	4379	562608	10320	572928	571924	spneumoniae.S_pseudosimplitigs.k_17.d_10.M_ones
spneumoniae	pseudosimplitigs	17	10	runs	2120449	2163100	2127288	35812	4302	562608	10256	572864	572204	spneumoniae.S_pseudosimplitigs.k_17.d_10.M_runs
spneumoniae	pseudosimplitigs	17	10	zeros	2120449	2163100	2120449	42651	6554	562608	15476	578084	575468	spneumoniae.S_pseudosimplitigs.k_17.d_10.M_zeros
spneumoniae	pseudosimplitigs	17	11	default	2120449	2168358	2120449	47909	7250	563064	15944	579008	578376	spneumoniae.S_pseudosimplitigs.k_17.d_11.M_default
spneumoniae	pseudosimplitigs	17	11	ones	2120449	2168358	2127625	40733	5121	563064	10912	573976	574400	spneumoniae.S_pseudosimplitigs.k_17.d_11.M_ones
spneumoniae	pseudosimplitigs	17	11	runs	2120449	2168358	2127474	40884	5027	563064	10848	573912	574368	spneumoniae.S_pseudosimplitigs.k_17.d_11.M_runs
spneumoniae	pseudosimplitigs	17	11	zeros	2120449	2168358	2120449	47909	7318	563064	16276	579340	578032	spneumoniae.S_pseudosimplitigs.k_17.d_11.M_zeros
spneumoniae	pseudosimplitigs	17	12	default	2120449	2170754	2120449	50305	7584	564052	16164	580216	578636	spneumoniae.S_pseudosimplitigs.k_17.d_12.M_default
spneumoniae	pseudosimplitigs	17	12	ones	2120449	2170754	2127791	42963	5464	564052	11180	575232	575264	spneumoniae.S_pseudosimplitigs.k_17.d_12.M_ones
spneumoniae	pseudosimplitigs	17	12	runs	2120449	2170754	2127611	43143	5346	564052	11112	575164	575292	spneumoniae.S_pseudosimplitigs.k_17.d_12.M_runs
spneumoniae	pseudosimplitigs	17	12	zeros	2120449	2170754	2120449	50305	7656	564052	16564	580616	578948	spneumoniae.S_pseudosimplitigs.k_17.d_12.M_zeros
spneumoniae	pseudosimplitigs	17	2	default	2120449	2154230	2120449	33781	3256	560520	8912	569432	568684	spneumoniae.S_pseudosimplitigs.k_17.d_2.M_default
spneumoniae	pseudosimplitigs	17	2	ones	2120449	2154230	2123407	30823	2101	560520	6060	566580	566568	spneumoniae.S_pseudosimplitigs.k_17.d_2.M_ones
spneumoniae	pseudosimplitigs	17	2	runs	2120449	2154230	2123360	30870	2066	560520	5972	566492	566660	spneumoniae.S_pseudosimplitigs.k_17.d_2.M_runs
spneumoniae	pseudosimplitigs	17	2	zeros	2120449	2154230	2120449	33781	3296	560520	9068	569588	568552	spneumoniae.S_pseudosimplitigs.k_17.d_2.M_zeros
spneumoniae	pseudosimplitigs	17	3	default	2120449	2149028	2120449	28579	3316	558704	9228	567932	566056	spneumoniae.S_pseudosimplitigs.k_17.d_3.M_default
spneumoniae	pseudosimplitigs	17	3	ones	2120449	2149028	2123844	25184	1756	558704	5020	563724	563340	spneumoniae.S_pseudosimplitigs.k_17.d_3.M_ones
spneumoniae	pseudosimplitigs	17	3	runs	2120449	2149028	2123811	25217	1730	558704	4960	563664	563436	spneumoniae.S_pseudosimplitigs.k_17.d_3.M_runs
spneumoniae	pseudosimplitigs	17	3	zeros	2120449	2149028	2120449	28579	3329	558704	9292	567996	566268	spneumoniae.S_pseudosimplitigs.k_17.d_3.M_zeros
spneumoniae	pseudosimplitigs	17	4	default	2120449	2146641	2120449	26192	3389	558736	9548	568284	565136	spneumoniae.S_pseudosimplitigs.k_17.d_4.M_default
spneumoniae	pseudosimplitigs	17	4	ones	2120449	2146641	2124342	22299	1606	558736	4688	563424	562544	spneumoniae.S_pseudosimplitigs.k_17.d_4.M_ones
spneumoniae	pseudosimplitigs	17	4	runs	2120449	2146641	2124310	22331	1586	558736	4640	563376	562576	spneumoniae.S_pseudosimplitigs.k_17.d_4.M_runs
spneumoniae	pseudosimplitigs	17	4	zeros	2120449	2146641	2120449	26192	3393	558736	9564	568300	565976	spneumoniae.S_pseudosimplitigs.k_17.d_4.M_zeros
spneumoniae	pseudosimplitigs	17	5	default	2120449	2145274	2120449	24825	3505	558196	10032	568228	565984	spneumoniae.S_pseudosimplitigs.k_17.d_5.M_default
spneumoniae	pseudosimplitigs	17	5	ones	2120449	2145274	2124984	20290	1558	558196	4724	562920	562084	spneumoniae.S_pseudosimplitigs.k_17.d_5.M_ones
spneumoniae	pseudosimplitigs	17	5	runs	2120449	2145274	2124958	20316	1536	558196	4684	562880	561920	spneumoniae.S_pseudosimplitigs.k_17.d_5.M_runs
spneumoniae	pseudosimplitigs	17	5	zeros	2120449	2145274	2120449	24825	3513	558196	10072	568268	565572	spneumoniae.S_pseudosimplitigs.k_17.d_5.M_zeros
spneumoniae	pseudosimplitigs	17	6	default	2120449	2145874	2120449	25425	3764	558272	10776	569048	566872	spneumoniae.S_pseudosimplitigs.k_17.d_6.M_default
spneumoniae	pseudosimplitigs	17	6	ones	2120449	2145874	2125333	20541	1757	558272	5424	563696	562808	spneumoniae.S_pseudosimplitigs.k_17.d_6.M_ones
spneumoniae	pseudosimplitigs	17	6	runs	2120449	2145874	2125314	20560	1745	558272	5400	563672	562960	spneumoniae.S_pseudosimplitigs.k_17.d_6.M_runs
spneumoniae	pseudosimplitigs	17	6	zeros	2120449	2145874	2120449	25425	3771	558272	10776	569048	567044	spneumoniae.S_pseudosimplitigs.k_17.d_6.M_zeros
spneumoniae	pseudosimplitigs	17	7	default	2120449	2147848	2120449	27399	4213	559364	11908	571272	568656	spneumoniae.S_pseudosimplitigs.k_17.d_7.M_default
spneumoniae	pseudosimplitigs	17	7	ones	2120449	2147848	2125801	22047	2140	559364	6668	566032	565556	spneumoniae.S_pseudosimplitigs.k_17.d_7.M_ones
spneumoniae	pseudosimplitigs	17	7	runs	2120449	2147848	2125781	22067	2126	559364	6644	566008	565160	spneumoniae.S_pseudosimplitigs.k_17.d_7.M_runs
spneumoniae	pseudosimplitigs	17	7	zeros	2120449	2147848	2120449	27399	4220	559364	11932	571296	569088	spneumoniae.S_pseudosimplitigs.k_17.d_7.M_zeros
spneumoniae	pseudosimplitigs	17	8	default	2120449	2150897	2120449	30448	4771	559456	13132	572588	570428	spneumoniae.S_pseudosimplitigs.k_17.d_8.M_default
spneumoniae	pseudosimplitigs	17	8	ones	2120449	2150897	2126313	24584	2668	559456	8016	567472	566008	spneumoniae.S_pseudosimplitigs.k_17.d_8.M_ones
spneumoniae	pseudosimplitigs	17	8	runs	2120449	2150897	2126285	24612	2647	559456	7984	567440	565976	spneumoniae.S_pseudosimplitigs.k_17.d_8.M_runs
spneumoniae	pseudosimplitigs	17	8	zeros	2120449	2150897	2120449	30448	4775	559456	13164	572620	569388	spneumoniae.S_pseudosimplitigs.k_17.d_8.M_zeros
spneumoniae	pseudosimplitigs	17	9	default	2120449	2156862	2120449	36413	5642	560820	14376	575196	573356	spneumoniae.S_pseudosimplitigs.k_17.d_9.M_default
spneumoniae	pseudosimplitigs	17	9	ones	2120449	2156862	2126977	29885	3516	560820	9392	570212	568828	spneumoniae.S_pseudosimplitigs.k_17.d_9.M_ones
spneumoniae	pseudosimplitigs	17	9	runs	2120449	2156862	2126909	29953	3471	560820	9340	570160	568924	spneumoniae.S_pseudosimplitigs.k_17.d_9.M_runs
spneumoniae	pseudosimplitigs	17	9	zeros	2120449	2156862	2120449	36413	5643	560820	14400	575220	572412	spneumoniae.S_pseudosimplitigs.k_17.d_9.M_zeros
spneumoniae	pseudosimplitigsAC	17	1	default	2120449	2171601	2120449	51152	3197	564144	7988	572132	573348	spneumoniae.S_pseudosimplitigsAC.k_17.d_1.M_default
spneumoniae	pseudosimplitigsAC	17	1	ones	2120449	2171601	2123436	48165	3268	564144	9048	573192	573684	spneumoniae.S_pseudosimplitigsAC.k_17.d_1.M_ones
spneumoniae	pseudosimplitigsAC	17	1	runs	2120449	2171601	2123305	48296	3181	564144	8864	573008	573736	spneumoniae.S_pseudosimplitigsAC.k_17.d_1.M_runs
spneumoniae	pseudosimplitigsAC	17	1	zeros	2120449	2171601	2120449	51152	3332	564144	8512	572656	573556	spneumoniae.S_pseudosimplitigsAC.k_17.d_1.M_zeros
spneumoniae	pseudosimplitigsAC	17	10	default	2120449	2164459	2120449	44010	6623	562244	15124	577368	575800	spneumoniae.S_pseudosimplitigsAC.k_17.d_10.M_default
spneumoniae	pseudosimplitigsAC	17	10	ones	2120449	2164459	2127340	37119	4509	562244	10172	572416	572476	spneumoniae.S_pseudosimplitigsAC.k_17.d_10.M_ones
spneumoniae	pseudosimplitigsAC	17	10	runs	2120449	2164459	2127214	37245	4429	562244	10116	572360	572296	spneumoniae.S_pseudosimplitigsAC.k_17.d_10.M_runs
spneumoniae	pseudosimplitigsAC	17	10	zeros	2120449	2164459	2120449	44010	6647	562244	15240	577484	576144	spneumoniae.S_pseudosimplitigsAC.k_17.d_10.M_zeros
spneumoniae	pseudosimplitigsAC	17	11	default	2120449	2168733	2120449	48284	7279	563440	15736	579176	577952	spneumoniae.S_pseudosimplitigsAC.k_17.d_11.M_default
spneumoniae	pseudosimplitigsAC	17	11	ones	2120449	2168733	2127579	41154	5164	563440	10744	574184	574588	spneumoniae.S_pseudosimplitigsAC.k_17.d_11.M_ones
spneumoniae	pseudosimplitigsAC	17	11	runs	2120449	2168733	2127449	41284	5072	563440	10696	574136	574416	spneumoniae.S_pseudosimplitigsAC.k_17.d_11.M_runs
spneumoniae	pseudosimplitigsAC	17	11	zeros	2120449	2168733	2120449	48284	7350	563440	16080	579520	578320	spneumoniae.S_pseudosimplitigsAC.k_17.d_11.M_zeros
spneumoniae	pseudosimplitigsAC	17	12	default	2120449	2170187	2120449	49738	7508	563824	15936	579760	578552	spneumoniae.S_pseudosimplitigsAC.k_17.d_12.M_default
spneumoniae	pseudosimplitigsAC	17	12	ones	2120449	2170187	2127575	42612	5406	563824	10924	574748	575000	spneumoniae.S_pseudosimplitigsAC.k_17.d_12.M_ones
spneumoniae	pseudosimplitigsAC	17	12	runs	2120449	2170187	2127399	42788	5286	563824	10880	574704	575008	spneumoniae.S_pseudosimplitigsAC.k_17.d_12.M_runs
spneumoniae	pseudosimplitigsAC	17	12	zeros	2120449	2170187	2120449	49738	7644	563824	16576	580400	578772	spneumoniae.S_pseudosimplitigsAC.k_17.d_12.M_zeros
spneumoniae	pseudosimplitigsAC	17	2	default	2120449	2154224	2120449	33775	3250	559812	8788	568600	567216	spneumoniae.S_pseudosimplitigsAC.k_17.d_2.M_default
spneumoniae	pseudosimplitigsAC	17	2	ones	2120449	2154224	2123425	30799	2096	559812	5960	565772	565744	spneumoniae.S_pseudosimplitigsAC.k_17.d_2.M_ones
spneumoniae	pseudosimplitigsAC	17	2	runs	2120449	2154224	2123377	30847	2062	559812	5880	565692	565648	spneumoniae.S_pseudosimplitigsAC.k_17.d_2.M_runs
spneumoniae	pseudosimplitigsAC	17	2	zeros	2120449	2154224	2120449	33775	3290	559812	8956	568768	568012	spneumoniae.S_pseudosimplitigsAC.k_17.d_2.M_zeros
spneumoniae	pseudosimplitigsAC	17	3	default	2120449	2148912	2120449	28463	3300	558652	9140	567792	565964	spneumoniae.S_pseudosimplitigsAC.k_17.d_3.M_default
spneumoniae	pseudosimplitigsAC	17	3	ones	2120449	2148912	2123835	25077	1731	558652	4924	563576	563436	spneumoniae.S_pseudosimplitigsAC.k_17.d_3.M_ones
spneumoniae	pseudosimplitigsAC	17	3	runs	2120449	2148912	2123802	25110	1709	558652	4864	563516	563324	spneumoniae.S_pseudosimplitigsAC.k_17.d_3.M_runs
spneumoniae	pseudosimplitigsAC	17	3	zeros	2120449	2148912	2120449	28463	3309	558652	9180	567832	565868	spneumoniae.S_pseudosimplitigsAC.k_17.d_3.M_zeros
spneumoniae	pseudosimplitigsAC	17	4	default	2120449	2146652	2120449	26203	3377	559716	9492	569208	566104	spneumoniae.S_pseudosimplitigsAC.k_17.d_4.M_default
spneumoniae	pseudosimplitigsAC	17	4	ones	2120449	2146652	2124303	22349	1600	559716	4532	564248	563148	spneumoniae.S_pseudosimplitigsAC.k_17.d_4.M_ones
spneumoniae	pseudosimplitigsAC	17	4	runs	2120449	2146652	2124282	22370	1583	559716	4492	564208	563476	spneumoniae.S_pseudosimplitigsAC.k_17.d_4.M_runs
spneumoniae	pseudosimplitigsAC	17	4	zeros	2120449	2146652	2120449	26203	3388	559716	9504	569220	566060	spneumoniae.S_pseudosimplitigsAC.k_17.d_4.M_zeros
spneumoniae	pseudosimplitigsAC	17	5	default	2120449	2145196	2120449	24747	3473	558908	9832	568740	565928	spneumoniae.S_pseudosimplitigsAC.k_17.d_5.M_default
spneumoniae	pseudosimplitigsAC	17	5	ones	2120449	2145196	2124929	20267	1544	558908	4604	563512	562572	spneumoniae.S_pseudosimplitigsAC.k_17.d_5.M_ones
spneumoniae	pseudosimplitigsAC	17	5	runs	2120449	2145196	2124897	20299	1516	558908	4544	563452	562604	spneumoniae.S_pseudosimplitigsAC.k_17.d_5.M_runs
spneumoniae	pseudosimplitigsAC	17	5	zeros	2120449	2145196	2120449	24747	3478	558908	9880	568788	565712	spneumoniae.S_pseudosimplitigsAC.k_17.d_5.M_zeros
spneumoniae	pseudosimplitigsAC	17	6	default	2120449	2145881	2120449	25432	3745	557988	10772	568760	566320	spneumoniae.S_pseudosimplitigsAC.k_17.d_6.M_default
spneumoniae	pseudosimplitigsAC	17	6	ones	2120449	2145881	2125276	20605	1756	557988	5384	563372	563036	spneumoniae.S_pseudosimplitigsAC.k_17.d_6.M_ones
spneumoniae	pseudosimplitigsAC	17	6	runs	2120449	2145881	2125260	20621	1742	557988	5368	563356	563016	spneumoniae.S_pseudosimplitigsAC.k_17.d_6.M_runs
spneumoniae	pseudosimplitigsAC	17	6	zeros	2120449	2145881	2120449	25432	3752	557988	10788	568776	566484	spneumoniae.S_pseudosimplitigsAC.k_17.d_6.M_zeros
spneumoniae	pseudosimplitigsAC	17	7	default	2120449	2147438	2120449	26989	4135	558028	11732	569760	568152	spneumoniae.S_pseudosimplitigsAC.k_17.d_7.M_default
spneumoniae	pseudosimplitigsAC	17	7	ones	2120449	2147438	2125737	21701	2078	558028	6492	564520	565376	spneumoniae.S_pseudosimplitigsAC.k_17.d_7.M_ones
spneumoniae	pseudosimplitigsAC	17	7	runs	2120449	2147438	2125705	21733	2058	558028	6452	564480	565660	spneumoniae.S_pseudosimplitigsAC.k_17.d_7.M_runs
spneumoniae	pseudosimplitigsAC	17	7	zeros	2120449	2147438	2120449	26989	4139	558028	11732	569760	568012	spneumoniae.S_pseudosimplitigsAC.k_17.d_7.M_zeros
spneumoniae	pseudosimplitigsAC	17	8	default	2120449	2150876	2120449	30427	4744	559116	12916	572032	570220	spneumoniae.S_pseudosimplitigsAC.k_17.d_8.M_default
spneumoniae	pseudosimplitigsAC	17	8	ones	2120449	2150876	2126331	24545	2636	559116	7848	566964	567284	spneumoniae.S_pseudosimplitigsAC.k_17.d_8.M_ones
spneumoniae	pseudosimplitigsAC	17	8	runs	2120449	2150876	2126299	24577	2613	559116	7808	566924	567324	spneumoniae.S_pseudosimplitigsAC.k_17.d_8.M_runs
spneumoniae	pseudosimplitigsAC	17	8	zeros	2120449	2150876	2120449	30427	4750	559116	12928	572044	569876	spneumoniae.S_pseudosimplitigsAC.k_17.d_8.M_zeros
spneumoniae	pseudosimplitigsAC	17	9	default	2120449	2156993	2120449	36544	5634	560644	14216	574860	572628	spneumoniae.S_pseudosimplitigsAC.k_17.d_9.M_default
spneumoniae	pseudosimplitigsAC	17	9	ones	2120449	2156993	2126995	29998	3519	560644	9248	569892	568836	spneumoniae.S_pseudosimplitigsAC.k_17.d_9.M_ones
spneumoniae	pseudosimplitigsAC	17	9	runs	2120449	2156993	2126924	30069	3476	560644	9196	569840	568932	spneumoniae.S_pseudosimplitigsAC.k_17.d_9.M_runs
spneumoniae	pseudosimplitigsAC	17	9	zeros	2120449	2156993	2120449	36544	5652	560644	14312	574956	572416	spneumoniae.S_pseudosimplitigsAC.k_17.d_9.M_zeros
spneumoniae	pseudosimplitigs	18	1	default	2123906	2160507	2123906	36601	2153	560216	5368	565584	566808	spneumoniae.S_pseudosimplitigs.k_18.d_1.M_default
spneumoniae	pseudosimplitigs	18	1	ones	2123906	2160507	2125788	34719	2174	560216	6004	566220	566800	spneumoniae.S_pseudosimplitigs.k_18.d_1.M_ones
spneumoniae	pseudosimplitigs	18	1	runs	2123906	2160507	2125740	34767	2149	560216	5948	566164	566888	spneumoniae.S_pseudosimplitigs.k_18.d_1.M_runs
spneumoniae	pseudosimplitigs	18	1	zeros	2123906	2160507	2123906	36601	2226	560216	5640	565856	567104	spneumoniae.S_pseudosimplitigs.k_18.d_1.M_zeros
spneumoniae	pseudosimplitigs	18	10	default	2123906	2157898	2123906	33992	4203	560696	10792	571488	570300	spneumoniae.S_pseudosimplitigs.k_18.d_10.M_default
spneumoniae	pseudosimplitigs	18	10	ones	2123906	2157898	2129189	28709	3006	560696	8284	568980	568032	spneumoniae.S_pseudosimplitigs.k_18.d_10.M_ones
spneumoniae	pseudosimplitigs	18	10	runs	2123906	2157898	2129116	28782	2969	560696	8228	568924	568176	spneumoniae.S_pseudosimplitigs.k_18.d_10.M_runs
spneumoniae	pseudosimplitigs	18	10	zeros	2123906	2157898	2123906	33992	4227	560696	10940	571636	570088	spneumoniae.S_pseudosimplitigs.k_18.d_10.M_zeros
spneumoniae	pseudosimplitigs	18	11	default	2123906	2166649	2123906	42743	5220	562388	11888	574276	574544	spneumoniae.S_pseudosimplitigs.k_18.d_11.M_default
spneumoniae	pseudosimplitigs	18	11	ones	2123906	2166649	2129622	37027	4014	562388	9376	571764	572448	spneumoniae.S_pseudosimplitigs.k_18.d_11.M_ones
spneumoniae	pseudosimplitigs	18	11	runs	2123906	2166649	2129524	37125	3958	562388	9324	571712	572244	spneumoniae.S_pseudosimplitigs.k_18.d_11.M_runs
spneumoniae	pseudosimplitigs	18	11	zeros	2123906	2166649	2123906	42743	5265	562388	12180	574568	574988	spneumoniae.S_pseudosimplitigs.k_18.d_11.M_zeros
spneumoniae	pseudosimplitigs	18	12	default	2123906	2171118	2123906	47212	5748	563020	12304	575324	575964	spneumoniae.S_pseudosimplitigs.k_18.d_12.M_default
spneumoniae	pseudosimplitigs	18	12	ones	2123906	2171118	2129850	41268	4544	563020	9748	572768	574576	spneumoniae.S_pseudosimplitigs.k_18.d_12.M_ones
spneumoniae	pseudosimplitigs	18	12	runs	2123906	2171118	2129721	41397	4461	563020	9696	572716	573884	spneumoniae.S_pseudosimplitigs.k_18.d_12.M_runs
spneumoniae	pseudosimplitigs	18	12	zeros	2123906	2171118	2123906	47212	5799	563020	12584	575604	576288	spneumoniae.S_pseudosimplitigs.k_18.d_12.M_zeros
spneumoniae	pseudosimplitigs	18	2	default	2123906	2153380	2123906	29474	2194	558728	5748	564476	564724	spneumoniae.S_pseudosimplitigs.k_18.d_2.M_default
spneumoniae	pseudosimplitigs	18	2	ones	2123906	2153380	2125776	27604	1741	558728	4844	563572	564568	spneumoniae.S_pseudosimplitigs.k_18.d_2.M_ones
spneumoniae	pseudosimplitigs	18	2	runs	2123906	2153380	2125745	27635	1718	558728	4792	563520	564540	spneumoniae.S_pseudosimplitigs.k_18.d_2.M_runs
spneumoniae	pseudosimplitigs	18	2	zeros	2123906	2153380	2123906	29474	2218	558728	5844	564572	565336	spneumoniae.S_pseudosimplitigs.k_18.d_2.M_zeros
spneumoniae	pseudosimplitigs	18	3	default	2123906	2150050	2123906	26144	2212	558252	5996	564248	564600	spneumoniae.S_pseudosimplitigs.k_18.d_3.M_default
spneumoniae	pseudosimplitigs	18	3	ones	2123906	2150050	2126124	23926	1519	558252	4264	562516	563632	spneumoniae.S_pseudosimplitigs.k_18.d_3.M_ones
spneumoniae	pseudosimplitigs	18	3	runs	2123906	2150050	2126104	23946	1504	558252	4232	562484	563080	spneumoniae.S_pseudosimplitigs.k_18.d_3.M_runs
spneumoniae	pseudosimplitigs	18	3	zeros	2123906	2150050	2123906	26144	2219	558252	6024	564276	564268	spneumoniae.S_pseudosimplitigs.k_18.d_3.M_zeros
spneumoniae	pseudosimplitigs	18	4	default	2123906	2147842	2123906	23936	2258	558316	6144	564460	563280	spneumoniae.S_pseudosimplitigs.k_18.d_4.M_default
spneumoniae	pseudosimplitigs	18	4	ones	2123906	2147842	2126465	21377	1393	558316	3936	562252	561824	spneumoniae.S_pseudosimplitigs.k_18.d_4.M_ones
spneumoniae	pseudosimplitigs	18	4	runs	2123906	2147842	2126442	21400	1374	558316	3896	562212	561720	spneumoniae.S_pseudosimplitigs.k_18.d_4.M_runs
spneumoniae	pseudosimplitigs	18	4	zeros	2123906	2147842	2123906	23936	2265	558316	6164	564480	563464	spneumoniae.S_pseudosimplitigs.k_18.d_4.M_zeros
spneumoniae	pseudosimplitigs	18	5	default	2123906	2146772	2123906	22866	2310	557116	6388	563504	563296	spneumoniae.S_pseudosimplitigs.k_18.d_5.M_default
spneumoniae	pseudosimplitigs	18	5	ones	2123906	2146772	2126837	19935	1324	557116	3888	561004	561272	spneumoniae.S_pseudosimplitigs.k_18.d_5.M_ones
spneumoniae	pseudosimplitigs	18	5	runs	2123906	2146772	2126827	19945	1316	557116	3868	560984	561296	spneumoniae.S_pseudosimplitigs.k_18.d_5.M_runs
spneumoniae	pseudosimplitigs	18	5	zeros	2123906	2146772	2123906	22866	2316	557116	6448	563564	563424	spneumoniae.S_pseudosimplitigs.k_18.d_5.M_zeros
spneumoniae	pseudosimplitigs	18	6	default	2123906	2146538	2123906	22632	2396	558072	6876	564948	563768	spneumoniae.S_pseudosimplitigs.k_18.d_6.M_default
spneumoniae	pseudosimplitigs	18	6	ones	2123906	2146538	2127177	19361	1363	558072	4184	562256	562020	spneumoniae.S_pseudosimplitigs.k_18.d_6.M_ones
spneumoniae	pseudosimplitigs	18	6	runs	2123906	2146538	2127157	19381	1347	558072	4148	562220	562164	spneumoniae.S_pseudosimplitigs.k_18.d_6.M_runs
spneumoniae	pseudosimplitigs	18	6	zeros	2123906	2146538	2123906	22632	2400	558072	6876	564948	563896	spneumoniae.S_pseudosimplitigs.k_18.d_6.M_zeros
spneumoniae	pseudosimplitigs	18	7	default	2123906	2147095	2123906	23189	2626	557604	7484	565088	564200	spneumoniae.S_pseudosimplitigs.k_18.d_7.M_default
spneumoniae	pseudosimplitigs	18	7	ones	2123906	2147095	2127711	19384	1526	557604	4884	562488	562412	spneumoniae.S_pseudosimplitigs.k_18.d_7.M_ones
spneumoniae	pseudosimplitigs	18	7	runs	2123906	2147095	2127692	19403	1512	557604	4852	562456	562440	spneumoniae.S_pseudosimplitigs.k_18.d_7.M_runs
spneumoniae	pseudosimplitigs	18	7	zeros	2123906	2147095	2123906	23189	2630	557604	7492	565096	564736	spneumoniae.S_pseudosimplitigs.k_18.d_7.M_zeros
spneumoniae	pseudosimplitigs	18	8	default	2123906	2149002	2123906	25096	2994	557524	8596	566120	565548	spneumoniae.S_pseudosimplitigs.k_18.d_8.M_default
spneumoniae	pseudosimplitigs	18	8	ones	2123906	2149002	2128104	20898	1854	557524	5960	563484	563344	spneumoniae.S_pseudosimplitigs.k_18.d_8.M_ones
spneumoniae	pseudosimplitigs	18	8	runs	2123906	2149002	2128087	20915	1840	557524	5940	563464	563504	spneumoniae.S_pseudosimplitigs.k_18.d_8.M_runs
spneumoniae	pseudosimplitigs	18	8	zeros	2123906	2149002	2123906	25096	3002	557524	8660	566184	565568	spneumoniae.S_pseudosimplitigs.k_18.d_8.M_zeros
spneumoniae	pseudosimplitigs	18	9	default	2123906	2152537	2123906	28631	3491	558792	9672	568464	567196	spneumoniae.S_pseudosimplitigs.k_18.d_9.M_default
spneumoniae	pseudosimplitigs	18	9	ones	2123906	2152537	2128524	24013	2317	558792	7004	565796	565712	spneumoniae.S_pseudosimplitigs.k_18.d_9.M_ones
spneumoniae	pseudosimplitigs	18	9	runs	2123906	2152537	2128481	24056	2294	558792	6952	565744	565404	spneumoniae.S_pseudosimplitigs.k_18.d_9.M_runs
spneumoniae	pseudosimplitigs	18	9	zeros	2123906	2152537	2123906	28631	3514	558792	9792	568584	567248	spneumoniae.S_pseudosimplitigs.k_18.d_9.M_zeros
spneumoniae	pseudosimplitigsAC	18	1	default	2123906	2160524	2123906	36618	2154	560304	5304	565608	567252	spneumoniae.S_pseudosimplitigsAC.k_18.d_1.M_default
spneumoniae	pseudosimplitigsAC	18	1	ones	2123906	2160524	2125658	34866	2184	560304	5956	566260	567180	spneumoniae.S_pseudosimplitigsAC.k_18.d_1.M_ones
spneumoniae	pseudosimplitigsAC	18	1	runs	2123906	2160524	2125615	34909	2150	560304	5888	566192	567044	spneumoniae.S_pseudosimplitigsAC.k_18.d_1.M_runs
spneumoniae	pseudosimplitigsAC	18	1	zeros	2123906	2160524	2123906	36618	2216	560304	5556	565860	567064	spneumoniae.S_pseudosimplitigsAC.k_18.d_1.M_zeros
spneumoniae	pseudosimplitigsAC	18	10	default	2123906	2157532	2123906	33626	4132	560228	10532	570760	570060	spneumoniae.S_pseudosimplitigsAC.k_18.d_10.M_default
spneumoniae	pseudosimplitigsAC	18	10	ones	2123906	2157532	2129068	28464	2922	560228	7924	568152	567432	spneumoniae.S_pseudosimplitigsAC.k_18.d_10.M_ones
spneumoniae	pseudosimplitigsAC	18	10	runs	2123906	2157532	2129005	28527	2885	560228	7892	568120	567456	spneumoniae.S_pseudosimplitigsAC.k_18.d_10.M_runs
spneumoniae	pseudosimplitigsAC	18	10	zeros	2123906	2157532	2123906	33626	4152	560228	10596	570824	569984	spneumoniae.S_pseudosimplitigsAC.k_18.d_10.M_zeros
spneumoniae	pseudosimplitigsAC	18	11	default	2123906	2164692	2123906	40786	4974	561516	11408	572924	573500	spneumoniae.S_pseudosimplitigsAC.k_18.d_11.M_default
spneumoniae	pseudosimplitigsAC	18	11	ones	2123906	2164692	2129533	35159	3754	561516	8804	570320	570688	spneumoniae.S_pseudosimplitigsAC.k_18.d_11.M_ones
spneumoniae	pseudosimplitigsAC	18	11	runs	2123906	2164692	2129460	35232	3707	561516	8764	570280	570920	spneumoniae.S_pseudosimplitigsAC.k_18.d_11.M_runs
spneumoniae	pseudosimplitigsAC	18	11	zeros	2123906	2164692	2123906	40786	4999	561516	11460	572976	573428	spneumoniae.S_pseudosimplitigsAC.k_18.d_11.M_zeros
spneumoniae	pseudosimplitigsAC	18	12	default	2123906	2169802	2123906	45896	5596	562808	12076	574884	575716	spneumoniae.S_pseudosimplitigsAC.k_18.d_12.M_default
spneumoniae	pseudosimplitigsAC	18	12	ones	2123906	2169802	2129800	40002	4374	562808	9416	572224	573128	spneumoniae.S_pseudosimplitigsAC.k_18.d_12.M_ones
spneumoniae	pseudosimplitigsAC	18	12	runs	2123906	2169802	2129668	40134	4295	562808	9384	572192	573220	spneumoniae.S_pseudosimplitigsAC.k_18.d_12.M_runs
spneumoniae	pseudosimplitigsAC	18	12	zeros	2123906	2169802	2123906	45896	5706	562808	12576	575384	575700	spneumoniae.S_pseudosimplitigsAC.k_18.d_12.M_zeros
spneumoniae	pseudosimplitigsAC	18	2	default	2123906	2153446	2123906	29540	2196	558740	5688	564428	565044	spneumoniae.S_pseudosimplitigsAC.k_18.d_2.M_default
spneumoniae	pseudosimplitigsAC	18	2	ones	2123906	2153446	2125853	27593	1747	558740	4788	563528	564232	spneumoniae.S_pseudosimplitigsAC.k_18.d_2.M_ones
spneumoniae	pseudosimplitigsAC	18	2	runs	2123906	2153446	2125823	27623	1723	558740	4736	563476	564160	spneumoniae.S_pseudosimplitigsAC.k_18.d_2.M_runs
spneumoniae	pseudosimplitigsAC	18	2	zeros	2123906	2153446	2123906	29540	2211	558740	5764	564504	565132	spneumoniae.S_pseudosimplitigsAC.k_18.d_2.M_zeros
spneumoniae	pseudosimplitigsAC	18	3	default	2123906	2150065	2123906	26159	2229	558148	5976	564124	564228	spneumoniae.S_pseudosimplitigsAC.k_18.d_3.M_default
spneumoniae	pseudosimplitigsAC	18	3	ones	2123906	2150065	2126114	23951	1533	558148	4288	562436	562888	spneumoniae.S_pseudosimplitigsAC.k_18.d_3.M_ones
spneumoniae	pseudosimplitigsAC	18	3	runs	2123906	2150065	2126089	23976	1515	558148	4236	562384	562848	spneumoniae.S_pseudosimplitigsAC.k_18.d_3.M_runs
spneumoniae	pseudosimplitigsAC	18	3	zeros	2123906	2150065	2123906	26159	2240	558148	6024	564172	564404	spneumoniae.S_pseudosimplitigsAC.k_18.d_3.M_zeros
spneumoniae	pseudosimplitigsAC	18	4	default	2123906	2147767	2123906	23861	2252	557304	6112	563416	563980	spneumoniae.S_pseudosimplitigsAC.k_18.d_4.M_default
spneumoniae	pseudosimplitigsAC	18	4	ones	2123906	2147767	2126518	21249	1381	557304	3956	561260	562736	spneumoniae.S_pseudosimplitigsAC.k_18.d_4.M_ones
spneumoniae	pseudosimplitigsAC	18	4	runs	2123906	2147767	2126494	21273	1364	557304	3920	561224	562344	spneumoniae.S_pseudosimplitigsAC.k_18.d_4.M_runs
spneumoniae	pseudosimplitigsAC	18	4	zeros	2123906	2147767	2123906	23861	2261	557304	6140	563444	563912	spneumoniae.S_pseudosimplitigsAC.k_18.d_4.M_zeros
spneumoniae	pseudosimplitigsAC	18	5	default	2123906	2146805	2123906	22899	2298	557560	6344	563904	563132	spneumoniae.S_pseudosimplitigsAC.k_18.d_5.M_default
spneumoniae	pseudosimplitigsAC	18	5	ones	2123906	2146805	2126871	19934	1341	557560	3932	561492	561900	spneumoniae.S_pseudosimplitigsAC.k_18.d_5.M_ones
spneumoniae	pseudosimplitigsAC	18	5	runs	2123906	2146805	2126849	19956	1325	557560	3908	561468	562024	spneumoniae.S_pseudosimplitigsAC.k_18.d_5.M_runs
spneumoniae	pseudosimplitigsAC	18	5	zeros	2123906	2146805	2123906	22899	2307	557560	6372	563932	563624	spneumoniae.S_pseudosimplitigsAC.k_18.d_5.M_zeros
spneumoniae	pseudosimplitigsAC	18	6	default	2123906	2146422	2123906	22516	2360	557648	6644	564292	563372	spneumoniae.S_pseudosimplitigsAC.k_18.d_6.M_default
spneumoniae	pseudosimplitigsAC	18	6	ones	2123906	2146422	2127137	19285	1338	557648	4032	561680	561400	spneumoniae.S_pseudosimplitigsAC.k_18.d_6.M_ones
spneumoniae	pseudosimplitigsAC	18	6	runs	2123906	2146422	2127115	19307	1323	557648	3984	561632	561416	spneumoniae.S_pseudosimplitigsAC.k_18.d_6.M_runs
spneumoniae	pseudosimplitigsAC	18	6	zeros	2123906	2146422	2123906	22516	2363	557648	6672	564320	563692	spneumoniae.S_pseudosimplitigsAC.k_18.d_6.M_zeros
spneumoniae	pseudosimplitigsAC	18	7	default	2123906	2146705	2123906	22799	2574	558004	7380	565384	563960	spneumoniae.S_pseudosimplitigsAC.k_18.d_7.M_default
spneumoniae	pseudosimplitigsAC	18	7	ones	2123906	2146705	2127710	18995	1462	558004	4596	562600	562104	spneumoniae.S_pseudosimplitigsAC.k_18.d_7.M_ones
spneumoniae	pseudosimplitigsAC	18	7	runs	2123906	2146705	2127690	19015	1447	558004	4552	562556	562360	spneumoniae.S_pseudosimplitigsAC.k_18.d_7.M_runs
spneumoniae	pseudosimplitigsAC	18	7	zeros	2123906	2146705	2123906	22799	2583	558004	7428	565432	564104	spneumoniae.S_pseudosimplitigsAC.k_18.d_7.M_zeros
spneumoniae	pseudosimplitigsAC	18	8	default	2123906	2148781	2123906	24875	2927	558220	8432	566652	566168	spneumoniae.S_pseudosimplitigsAC.k_18.d_8.M_default
spneumoniae	pseudosimplitigsAC	18	8	ones	2123906	2148781	2128037	20744	1779	558220	5588	563808	563044	spneumoniae.S_pseudosimplitigsAC.k_18.d_8.M_ones
spneumoniae	pseudosimplitigsAC	18	8	runs	2123906	2148781	2128018	20763	1766	558220	5584	563804	563524	spneumoniae.S_pseudosimplitigsAC.k_18.d_8.M_runs
spneumoniae	pseudosimplitigsAC	18	8	zeros	2123906	2148781	2123906	24875	2941	558220	8428	566648	565900	spneumoniae.S_pseudosimplitigsAC.k_18.d_8.M_zeros
spneumoniae	pseudosimplitigsAC	18	9	default	2123906	2151865	2123906	27959	3415	558940	9448	568388	566916	spneumoniae.S_pseudosimplitigsAC.k_18.d_9.M_default
spneumoniae	pseudosimplitigsAC	18	9	ones	2123906	2151865	2128564	23301	2225	558940	6776	565716	564952	spneumoniae.S_pseudosimplitigsAC.k_18.d_9.M_ones
spneumoniae	pseudosimplitigsAC	18	9	runs	2123906	2151865	2128527	23338	2205	558940	6744	565684	565244	spneumoniae.S_pseudosimplitigsAC.k_18.d_9.M_runs
spneumoniae	pseudosimplitigsAC	18	9	zeros	2123906	2151865	2123906	27959	3432	558940	9472	568412	567180	spneumoniae.S_pseudosimplitigsAC.k_18.d_9.M_zeros
spneumoniae	pseudosimplitigs	19	1	default	2126360	2160704	2126360	34344	1908	558928	4360	563288	564776	spneumoniae.S_pseudosimplitigs.k_19.d_1.M_default
spneumoniae	pseudosimplitigs	19	1	ones	2126360	2160704	2127929	32775	1929	558928	5020	563948	565696	spneumoniae.S_pseudosimplitigs.k_19.d_1.M_ones
spneumoniae	pseudosimplitigs	19	1	runs	2126360	2160704	2127896	32808	1905	558928	4984	563912	566152	spneumoniae.S_pseudosimplitigs.k_19.d_1.M_runs
spneumoniae	pseudosimplitigs	19	1	zeros	2126360	2160704	2126360	34344	1944	558928	4528	563456	565024	spneumoniae.S_pseudosimplitigs.k_19.d_1.M_zeros
spneumoniae	pseudosimplitigs	19	10	default	2126360	2155850	2126360	29490	3172	561232	8792	570024	567456	spneumoniae.S_pseudosimplitigs.k_19.d_10.M_default
spneumoniae	pseudosimplitigs	19	10	ones	2126360	2155850	2131159	24691	2173	561232	6748	567980	565260	spneumoniae.S_pseudosimplitigs.k_19.d_10.M_ones
spneumoniae	pseudosimplitigs	19	10	runs	2126360	2155850	2131153	24697	2167	561232	6728	567960	565276	spneumoniae.S_pseudosimplitigs.k_19.d_10.M_runs
spneumoniae	pseudosimplitigs	19	10	zeros	2126360	2155850	2126360	29490	3197	561232	8900	570132	567544	spneumoniae.S_pseudosimplitigs.k_19.d_10.M_zeros
spneumoniae	pseudosimplitigs	19	11	default	2126360	2162050	2126360	35690	3860	560196	9900	570096	571068	spneumoniae.S_pseudosimplitigs.k_19.d_11.M_default
spneumoniae	pseudosimplitigs	19	11	ones	2126360	2162050	2131563	30487	2867	560196	8052	568248	568508	spneumoniae.S_pseudosimplitigs.k_19.d_11.M_ones
spneumoniae	pseudosimplitigs	19	11	runs	2126360	2162050	2131524	30526	2844	560196	8016	568212	568620	spneumoniae.S_pseudosimplitigs.k_19.d_11.M_runs
spneumoniae	pseudosimplitigs	19	11	zeros	2126360	2162050	2126360	35690	3890	560196	9968	570164	570456	spneumoniae.S_pseudosimplitigs.k_19.d_11.M_zeros
spneumoniae	pseudosimplitigs	19	12	default	2126360	2168574	2126360	42214	4563	561772	10568	572340	573328	spneumoniae.S_pseudosimplitigs.k_19.d_12.M_default
spneumoniae	pseudosimplitigs	19	12	ones	2126360	2168574	2132119	36455	3541	561772	8692	570464	570964	spneumoniae.S_pseudosimplitigs.k_19.d_12.M_ones
spneumoniae	pseudosimplitigs	19	12	runs	2126360	2168574	2132032	36542	3500	561772	8664	570436	570980	spneumoniae.S_pseudosimplitigs.k_19.d_12.M_runs
spneumoniae	pseudosimplitigs	19	12	zeros	2126360	2168574	2126360	42214	4589	561772	10672	572444	573232	spneumoniae.S_pseudosimplitigs.k_19.d_12.M_zeros
spneumoniae	pseudosimplitigs	19	2	default	2126360	2156369	2126360	30009	1942	558628	4628	563256	564068	spneumoniae.S_pseudosimplitigs.k_19.d_2.M_default
spneumoniae	pseudosimplitigs	19	2	ones	2126360	2156369	2127957	28412	1679	558628	4408	563036	563692	spneumoniae.S_pseudosimplitigs.k_19.d_2.M_ones
spneumoniae	pseudosimplitigs	19	2	runs	2126360	2156369	2127932	28437	1661	558628	4376	563004	563484	spneumoniae.S_pseudosimplitigs.k_19.d_2.M_runs
spneumoniae	pseudosimplitigs	19	2	zeros	2126360	2156369	2126360	30009	1954	558628	4688	563316	564224	spneumoniae.S_pseudosimplitigs.k_19.d_2.M_zeros
spneumoniae	pseudosimplitigs	19	3	default	2126360	2152604	2126360	26244	1954	557560	4884	562444	563112	spneumoniae.S_pseudosimplitigs.k_19.d_3.M_default
spneumoniae	pseudosimplitigs	19	3	ones	2126360	2152604	2128216	24388	1438	557560	3912	561472	562300	spneumoniae.S_pseudosimplitigs.k_19.d_3.M_ones
spneumoniae	pseudosimplitigs	19	3	runs	2126360	2152604	2128203	24401	1429	557560	3900	561460	562216	spneumoniae.S_pseudosimplitigs.k_19.d_3.M_runs
spneumoniae	pseudosimplitigs	19	3	zeros	2126360	2152604	2126360	26244	1962	557560	4908	562468	563120	spneumoniae.S_pseudosimplitigs.k_19.d_3.M_zeros
spneumoniae	pseudosimplitigs	19	4	default	2126360	2151097	2126360	24737	1981	558248	5092	563340	562968	spneumoniae.S_pseudosimplitigs.k_19.d_4.M_default
spneumoniae	pseudosimplitigs	19	4	ones	2126360	2151097	2128504	22593	1353	558248	3768	562016	561824	spneumoniae.S_pseudosimplitigs.k_19.d_4.M_ones
spneumoniae	pseudosimplitigs	19	4	runs	2126360	2151097	2128495	22602	1347	558248	3760	562008	561872	spneumoniae.S_pseudosimplitigs.k_19.d_4.M_runs
spneumoniae	pseudosimplitigs	19	4	zeros	2126360	2151097	2126360	24737	1984	558248	5104	563352	563220	spneumoniae.S_pseudosimplitigs.k_19.d_4.M_zeros
spneumoniae	pseudosimplitigs	19	5	default	2126360	2150367	2126360	24007	2015	557432	5248	562680	562508	spneumoniae.S_pseudosimplitigs.k_19.d_5.M_default
spneumoniae	pseudosimplitigs	19	5	ones	2126360	2150367	2128747	21620	1322	557432	3716	561148	561608	spneumoniae.S_pseudosimplitigs.k_19.d_5.M_ones
spneumoniae	pseudosimplitigs	19	5	runs	2126360	2150367	2128735	21632	1314	557432	3700	561132	561380	spneumoniae.S_pseudosimplitigs.k_19.d_5.M_runs
spneumoniae	pseudosimplitigs	19	5	zeros	2126360	2150367	2126360	24007	2018	557432	5264	562696	562544	spneumoniae.S_pseudosimplitigs.k_19.d_5.M_zeros
spneumoniae	pseudosimplitigs	19	6	default	2126360	2148933	2126360	22573	2046	557352	5408	562760	562728	spneumoniae.S_pseudosimplitigs.k_19.d_6.M_default
spneumoniae	pseudosimplitigs	19	6	ones	2126360	2148933	2129434	19499	1233	557352	3660	561012	561216	spneumoniae.S_pseudosimplitigs.k_19.d_6.M_ones
spneumoniae	pseudosimplitigs	19	6	runs	2126360	2148933	2129417	19516	1220	557352	3628	560980	560616	spneumoniae.S_pseudosimplitigs.k_19.d_6.M_runs
spneumoniae	pseudosimplitigs	19	6	zeros	2126360	2148933	2126360	22573	2046	557352	5412	562764	562772	spneumoniae.S_pseudosimplitigs.k_19.d_6.M_zeros
spneumoniae	pseudosimplitigs	19	7	default	2126360	2149080	2126360	22720	2167	557024	5920	562944	562968	spneumoniae.S_pseudosimplitigs.k_19.d_7.M_default
spneumoniae	pseudosimplitigs	19	7	ones	2126360	2149080	2129755	19325	1304	557024	4016	561040	561020	spneumoniae.S_pseudosimplitigs.k_19.d_7.M_ones
spneumoniae	pseudosimplitigs	19	7	runs	2126360	2149080	2129739	19341	1295	557024	4004	561028	561248	spneumoniae.S_pseudosimplitigs.k_19.d_7.M_runs
spneumoniae	pseudosimplitigs	19	7	zeros	2126360	2149080	2126360	22720	2170	557024	5936	562960	562956	spneumoniae.S_pseudosimplitigs.k_19.d_7.M_zeros
spneumoniae	pseudosimplitigs	19	8	default	2126360	2149598	2126360	23238	2310	557380	6412	563792	564084	spneumoniae.S_pseudosimplitigs.k_19.d_8.M_default
spneumoniae	pseudosimplitigs	19	8	ones	2126360	2149598	2130084	19514	1397	557380	4448	561828	562356	spneumoniae.S_pseudosimplitigs.k_19.d_8.M_ones
spneumoniae	pseudosimplitigs	19	8	runs	2126360	2149598	2130071	19527	1390	557380	4432	561812	562312	spneumoniae.S_pseudosimplitigs.k_19.d_8.M_runs
spneumoniae	pseudosimplitigs	19	8	zeros	2126360	2149598	2126360	23238	2317	557380	6440	563820	563676	spneumoniae.S_pseudosimplitigs.k_19.d_8.M_zeros
spneumoniae	pseudosimplitigs	19	9	default	2126360	2152080	2126360	25720	2690	557520	7704	565224	565696	spneumoniae.S_pseudosimplitigs.k_19.d_9.M_default
spneumoniae	pseudosimplitigs	19	9	ones	2126360	2152080	2130770	21310	1739	557520	5708	563228	564216	spneumoniae.S_pseudosimplitigs.k_19.d_9.M_ones
spneumoniae	pseudosimplitigs	19	9	runs	2126360	2152080	2130742	21338	1726	557520	5680	563200	563796	spneumoniae.S_pseudosimplitigs.k_19.d_9.M_runs
spneumoniae	pseudosimplitigs	19	9	zeros	2126360	2152080	2126360	25720	2711	557520	7744	565264	565540	spneumoniae.S_pseudosimplitigs.k_19.d_9.M_zeros
spneumoniae	pseudosimplitigsAC	19	1	default	2126360	2160722	2126360	34362	1909	559636	4368	564004	565012	spneumoniae.S_pseudosimplitigsAC.k_19.d_1.M_default
spneumoniae	pseudosimplitigsAC	19	1	ones	2126360	2160722	2127915	32807	1924	559636	5012	564648	565548	spneumoniae.S_pseudosimplitigsAC.k_19.d_1.M_ones
spneumoniae	pseudosimplitigsAC	19	1	runs	2126360	2160722	2127870	32852	1904	559636	4972	564608	566144	spneumoniae.S_pseudosimplitigsAC.k_19.d_1.M_runs
spneumoniae	pseudosimplitigsAC	19	1	zeros	2126360	2160722	2126360	34362	1961	559636	4600	564236	565684	spneumoniae.S_pseudosimplitigsAC.k_19.d_1.M_zeros
spneumoniae	pseudosimplitigsAC	19	10	default	2126360	2155912	2126360	29552	3132	558892	8556	567448	566736	spneumoniae.S_pseudosimplitigsAC.k_19.d_10.M_default
spneumoniae	pseudosimplitigsAC	19	10	ones	2126360	2155912	2131119	24793	2168	558892	6600	565492	565128	spneumoniae.S_pseudosimplitigsAC.k_19.d_10.M_ones
spneumoniae	pseudosimplitigsAC	19	10	runs	2126360	2155912	2131098	24814	2155	558892	6572	565464	564744	spneumoniae.S_pseudosimplitigsAC.k_19.d_10.M_runs
spneumoniae	pseudosimplitigsAC	19	10	zeros	2126360	2155912	2126360	29552	3141	558892	8600	567492	567632	spneumoniae.S_pseudosimplitigsAC.k_19.d_10.M_zeros
spneumoniae	pseudosimplitigsAC	19	11	default	2126360	2162058	2126360	35698	3837	560468	9644	570112	570424	spneumoniae.S_pseudosimplitigsAC.k_19.d_11.M_default
spneumoniae	pseudosimplitigsAC	19	11	ones	2126360	2162058	2131494	30564	2848	560468	7848	568316	568228	spneumoniae.S_pseudosimplitigsAC.k_19.d_11.M_ones
spneumoniae	pseudosimplitigsAC	19	11	runs	2126360	2162058	2131454	30604	2829	560468	7836	568304	568208	spneumoniae.S_pseudosimplitigsAC.k_19.d_11.M_runs
spneumoniae	pseudosimplitigsAC	19	11	zeros	2126360	2162058	2126360	35698	3857	560468	9752	570220	569740	spneumoniae.S_pseudosimplitigsAC.k_19.d_11.M_zeros
spneumoniae	pseudosimplitigsAC	19	12	default	2126360	2169791	2126360	43431	4665	561996	10560	572556	574076	spneumoniae.S_pseudosimplitigsAC.k_19.d_12.M_default
spneumoniae	pseudosimplitigsAC	19	12	ones	2126360	2169791	2132056	37735	3666	561996	8740	570736	571328	spneumoniae.S_pseudosimplitigsAC.k_19.d_12.M_ones
spneumoniae	pseudosimplitigsAC	19	12	runs	2126360	2169791	2131981	37810	3632	561996	8716	570712	571440	spneumoniae.S_pseudosimplitigsAC.k_19.d_12.M_runs
spneumoniae	pseudosimplitigsAC	19	12	zeros	2126360	2169791	2126360	43431	4707	561996	10780	572776	573512	spneumoniae.S_pseudosimplitigsAC.k_19.d_12.M_zeros
spneumoniae	pseudosimplitigsAC	19	2	default	2126360	2156367	2126360	30007	1940	558876	4608	563484	563924	spneumoniae.S_pseudosimplitigsAC.k_19.d_2.M_default
spneumoniae	pseudosimplitigsAC	19	2	ones	2126360	2156367	2127945	28422	1669	558876	4308	563184	563848	spneumoniae.S_pseudosimplitigsAC.k_19.d_2.M_ones
spneumoniae	pseudosimplitigsAC	19	2	runs	2126360	2156367	2127931	28436	1660	558876	4288	563164	563680	spneumoniae.S_pseudosimplitigsAC.k_19.d_2.M_runs
spneumoniae	pseudosimplitigsAC	19	2	zeros	2126360	2156367	2126360	30007	1953	558876	4672	563548	563756	spneumoniae.S_pseudosimplitigsAC.k_19.d_2.M_zeros
spneumoniae	pseudosimplitigsAC	19	3	default	2126360	2152574	2126360	26214	1949	558020	4848	562868	563296	spneumoniae.S_pseudosimplitigsAC.k_19.d_3.M_default
spneumoniae	pseudosimplitigsAC	19	3	ones	2126360	2152574	2128212	24362	1433	558020	3820	561840	562848	spneumoniae.S_pseudosimplitigsAC.k_19.d_3.M_ones
spneumoniae	pseudosimplitigsAC	19	3	runs	2126360	2152574	2128198	24376	1424	558020	3800	561820	563032	spneumoniae.S_pseudosimplitigsAC.k_19.d_3.M_runs
spneumoniae	pseudosimplitigsAC	19	3	zeros	2126360	2152574	2126360	26214	1959	558020	4880	562900	562892	spneumoniae.S_pseudosimplitigsAC.k_19.d_3.M_zeros
spneumoniae	pseudosimplitigsAC	19	4	default	2126360	2151124	2126360	24764	1980	556888	5048	561936	563232	spneumoniae.S_pseudosimplitigsAC.k_19.d_4.M_default
spneumoniae	pseudosimplitigsAC	19	4	ones	2126360	2151124	2128490	22634	1361	556888	3720	560608	561436	spneumoniae.S_pseudosimplitigsAC.k_19.d_4.M_ones
spneumoniae	pseudosimplitigsAC	19	4	runs	2126360	2151124	2128474	22650	1347	556888	3688	560576	561564	spneumoniae.S_pseudosimplitigsAC.k_19.d_4.M_runs
spneumoniae	pseudosimplitigsAC	19	4	zeros	2126360	2151124	2126360	24764	1987	556888	5072	561960	562412	spneumoniae.S_pseudosimplitigsAC.k_19.d_4.M_zeros
spneumoniae	pseudosimplitigsAC	19	5	default	2126360	2150337	2126360	23977	1996	557352	5080	562432	563296	spneumoniae.S_pseudosimplitigsAC.k_19.d_5.M_default
spneumoniae	pseudosimplitigsAC	19	5	ones	2126360	2150337	2128755	21582	1306	557352	3668	561020	561156	spneumoniae.S_pseudosimplitigsAC.k_19.d_5.M_ones
spneumoniae	pseudosimplitigsAC	19	5	runs	2126360	2150337	2128746	21591	1298	557352	3652	561004	561160	spneumoniae.S_pseudosimplitigsAC.k_19.d_5.M_runs
spneumoniae	pseudosimplitigsAC	19	5	zeros	2126360	2150337	2126360	23977	2003	557352	5120	562472	562876	spneumoniae.S_pseudosimplitigsAC.k_19.d_5.M_zeros
spneumoniae	pseudosimplitigsAC	19	6	default	2126360	2148937	2126360	22577	2035	557012	5364	562376	563536	spneumoniae.S_pseudosimplitigsAC.k_19.d_6.M_default
spneumoniae	pseudosimplitigsAC	19	6	ones	2126360	2148937	2129430	19507	1223	557012	3596	560608	560832	spneumoniae.S_pseudosimplitigsAC.k_19.d_6.M_ones
spneumoniae	pseudosimplitigsAC	19	6	runs	2126360	2148937	2129419	19518	1215	557012	3580	560592	560824	spneumoniae.S_pseudosimplitigsAC.k_19.d_6.M_runs
spneumoniae	pseudosimplitigsAC	19	6	zeros	2126360	2148937	2126360	22577	2041	557012	5376	562388	563340	spneumoniae.S_pseudosimplitigsAC.k_19.d_6.M_zeros
spneumoniae	pseudosimplitigsAC	19	7	default	2126360	2148806	2126360	22446	2102	556980	5676	562656	563384	spneumoniae.S_pseudosimplitigsAC.k_19.d_7.M_default
spneumoniae	pseudosimplitigsAC	19	7	ones	2126360	2148806	2129728	19078	1244	556980	3776	560756	560708	spneumoniae.S_pseudosimplitigsAC.k_19.d_7.M_ones
spneumoniae	pseudosimplitigsAC	19	7	runs	2126360	2148806	2129718	19088	1238	556980	3764	560744	560712	spneumoniae.S_pseudosimplitigsAC.k_19.d_7.M_runs
spneumoniae	pseudosimplitigsAC	19	7	zeros	2126360	2148806	2126360	22446	2105	556980	5676	562656	563472	spneumoniae.S_pseudosimplitigsAC.k_19.d_7.M_zeros
spneumoniae	pseudosimplitigsAC	19	8	default	2126360	2149549	2126360	23189	2286	557032	6280	563312	564508	spneumoniae.S_pseudosimplitigsAC.k_19.d_8.M_default
spneumoniae	pseudosimplitigsAC	19	8	ones	2126360	2149549	2130051	19498	1373	557032	4400	561432	561668	spneumoniae.S_pseudosimplitigsAC.k_19.d_8.M_ones
spneumoniae	pseudosimplitigsAC	19	8	runs	2126360	2149549	2130049	19500	1371	557032	4396	561428	561720	spneumoniae.S_pseudosimplitigsAC.k_19.d_8.M_runs
spneumoniae	pseudosimplitigsAC	19	8	zeros	2126360	2149549	2126360	23189	2290	557032	6332	563364	563756	spneumoniae.S_pseudosimplitigsAC.k_19.d_8.M_zeros
spneumoniae	pseudosimplitigsAC	19	9	default	2126360	2151618	2126360	25258	2604	557756	7308	565064	565672	spneumoniae.S_pseudosimplitigsAC.k_19.d_9.M_default
spneumoniae	pseudosimplitigsAC	19	9	ones	2126360	2151618	2130668	20950	1662	557756	5360	563116	563496	spneumoniae.S_pseudosimplitigsAC.k_19.d_9.M_ones
spneumoniae	pseudosimplitigsAC	19	9	runs	2126360	2151618	2130656	20962	1653	557756	5344	563100	563616	spneumoniae.S_pseudosimplitigsAC.k_19.d_9.M_runs
spneumoniae	pseudosimplitigsAC	19	9	zeros	2126360	2151618	2126360	25258	2608	557756	7324	565080	565240	spneumoniae.S_pseudosimplitigsAC.k_19.d_9.M_zeros
spneumoniae	pseudosimplitigs	20	1	default	2128471	2162044	2128471	33573	1767	558908	3948	562856	564808	spneumoniae.S_pseudosimplitigs.k_20.d_1.M_default
spneumoniae	pseudosimplitigs	20	1	ones	2128471	2162044	2130023	32021	1774	558908	4516	563424	565160	spneumoniae.S_pseudosimplitigs.k_20.d_1.M_ones
spneumoniae	pseudosimplitigs	20	1	runs	2128471	2162044	2129969	32075	1752	558908	4488	563396	565052	spneumoniae.S_pseudosimplitigs.k_20.d_1.M_runs
spneumoniae	pseudosimplitigs	20	1	zeros	2128471	2162044	2128471	33573	1814	558908	4180	563088	564796	spneumoniae.S_pseudosimplitigs.k_20.d_1.M_zeros
spneumoniae	pseudosimplitigs	20	10	default	2128471	2154026	2128471	25555	2499	557852	7072	564924	565004	spneumoniae.S_pseudosimplitigs.k_20.d_10.M_default
spneumoniae	pseudosimplitigs	20	10	ones	2128471	2154026	2132848	21178	1609	557852	5340	563192	563596	spneumoniae.S_pseudosimplitigs.k_20.d_10.M_ones
spneumoniae	pseudosimplitigs	20	10	runs	2128471	2154026	2132834	21192	1601	557852	5328	563180	562984	spneumoniae.S_pseudosimplitigs.k_20.d_10.M_runs
spneumoniae	pseudosimplitigs	20	10	zeros	2128471	2154026	2128471	25555	2513	557852	7124	564976	565272	spneumoniae.S_pseudosimplitigs.k_20.d_10.M_zeros
spneumoniae	pseudosimplitigs	20	11	default	2128471	2157481	2128471	29010	2896	559436	7936	567372	567324	spneumoniae.S_pseudosimplitigs.k_20.d_11.M_default
spneumoniae	pseudosimplitigs	20	11	ones	2128471	2157481	2133511	23970	1962	559436	6192	565628	565208	spneumoniae.S_pseudosimplitigs.k_20.d_11.M_ones
spneumoniae	pseudosimplitigs	20	11	runs	2128471	2157481	2133492	23989	1953	559436	6172	565608	565396	spneumoniae.S_pseudosimplitigs.k_20.d_11.M_runs
spneumoniae	pseudosimplitigs	20	11	zeros	2128471	2157481	2128471	29010	2951	559436	8072	567508	567672	spneumoniae.S_pseudosimplitigs.k_20.d_11.M_zeros
spneumoniae	pseudosimplitigs	20	12	default	2128471	2163552	2128471	35081	3503	560844	9052	569896	570224	spneumoniae.S_pseudosimplitigs.k_20.d_12.M_default
spneumoniae	pseudosimplitigs	20	12	ones	2128471	2163552	2133788	29764	2568	560844	7316	568160	568172	spneumoniae.S_pseudosimplitigs.k_20.d_12.M_ones
spneumoniae	pseudosimplitigs	20	12	runs	2128471	2163552	2133760	29792	2553	560844	7308	568152	568524	spneumoniae.S_pseudosimplitigs.k_20.d_12.M_runs
spneumoniae	pseudosimplitigs	20	12	zeros	2128471	2163552	2128471	35081	3575	560844	9260	570104	570312	spneumoniae.S_pseudosimplitigs.k_20.d_12.M_zeros
spneumoniae	pseudosimplitigs	20	2	default	2128471	2157114	2128471	28643	1805	558032	4304	562336	563820	spneumoniae.S_pseudosimplitigs.k_20.d_2.M_default
spneumoniae	pseudosimplitigs	20	2	ones	2128471	2157114	2129930	27184	1508	558032	4052	562084	563320	spneumoniae.S_pseudosimplitigs.k_20.d_2.M_ones
spneumoniae	pseudosimplitigs	20	2	runs	2128471	2157114	2129923	27191	1503	558032	4048	562080	563288	spneumoniae.S_pseudosimplitigs.k_20.d_2.M_runs
spneumoniae	pseudosimplitigs	20	2	zeros	2128471	2157114	2128471	28643	1815	558032	4348	562380	563780	spneumoniae.S_pseudosimplitigs.k_20.d_2.M_zeros
spneumoniae	pseudosimplitigs	20	3	default	2128471	2155036	2128471	26565	1820	557928	4420	562348	562928	spneumoniae.S_pseudosimplitigs.k_20.d_3.M_default
spneumoniae	pseudosimplitigs	20	3	ones	2128471	2155036	2130137	24899	1394	557928	3824	561752	562560	spneumoniae.S_pseudosimplitigs.k_20.d_3.M_ones
spneumoniae	pseudosimplitigs	20	3	runs	2128471	2155036	2130129	24907	1387	557928	3812	561740	562468	spneumoniae.S_pseudosimplitigs.k_20.d_3.M_runs
spneumoniae	pseudosimplitigs	20	3	zeros	2128471	2155036	2128471	26565	1828	557928	4456	562384	563076	spneumoniae.S_pseudosimplitigs.k_20.d_3.M_zeros
spneumoniae	pseudosimplitigs	20	4	default	2128471	2153975	2128471	25504	1841	557992	4564	562556	562948	spneumoniae.S_pseudosimplitigs.k_20.d_4.M_default
spneumoniae	pseudosimplitigs	20	4	ones	2128471	2153975	2130345	23630	1346	557992	3748	561740	563116	spneumoniae.S_pseudosimplitigs.k_20.d_4.M_ones
spneumoniae	pseudosimplitigs	20	4	runs	2128471	2153975	2130328	23647	1337	557992	3728	561720	563108	spneumoniae.S_pseudosimplitigs.k_20.d_4.M_runs
spneumoniae	pseudosimplitigs	20	4	zeros	2128471	2153975	2128471	25504	1849	557992	4576	562568	563184	spneumoniae.S_pseudosimplitigs.k_20.d_4.M_zeros
spneumoniae	pseudosimplitigs	20	5	default	2128471	2152052	2128471	23581	1867	557644	4760	562404	562320	spneumoniae.S_pseudosimplitigs.k_20.d_5.M_default
spneumoniae	pseudosimplitigs	20	5	ones	2128471	2152052	2130852	21200	1230	557644	3604	561248	562532	spneumoniae.S_pseudosimplitigs.k_20.d_5.M_ones
spneumoniae	pseudosimplitigs	20	5	runs	2128471	2152052	2130845	21207	1224	557644	3584	561228	562624	spneumoniae.S_pseudosimplitigs.k_20.d_5.M_runs
spneumoniae	pseudosimplitigs	20	5	zeros	2128471	2152052	2128471	23581	1872	557644	4772	562416	562880	spneumoniae.S_pseudosimplitigs.k_20.d_5.M_zeros
spneumoniae	pseudosimplitigs	20	6	default	2128471	2151353	2128471	22882	1901	557424	4904	562328	562264	spneumoniae.S_pseudosimplitigs.k_20.d_6.M_default
spneumoniae	pseudosimplitigs	20	6	ones	2128471	2151353	2131186	20167	1197	557424	3548	560972	561728	spneumoniae.S_pseudosimplitigs.k_20.d_6.M_ones
spneumoniae	pseudosimplitigs	20	6	runs	2128471	2151353	2131174	20179	1191	557424	3540	560964	561640	spneumoniae.S_pseudosimplitigs.k_20.d_6.M_runs
spneumoniae	pseudosimplitigs	20	6	zeros	2128471	2151353	2128471	22882	1905	557424	4924	562348	562520	spneumoniae.S_pseudosimplitigs.k_20.d_6.M_zeros
spneumoniae	pseudosimplitigs	20	7	default	2128471	2151121	2128471	22650	1937	557688	5068	562756	562368	spneumoniae.S_pseudosimplitigs.k_20.d_7.M_default
spneumoniae	pseudosimplitigs	20	7	ones	2128471	2151121	2131481	19640	1187	557688	3608	561296	561324	spneumoniae.S_pseudosimplitigs.k_20.d_7.M_ones
spneumoniae	pseudosimplitigs	20	7	runs	2128471	2151121	2131471	19650	1180	557688	3592	561280	561268	spneumoniae.S_pseudosimplitigs.k_20.d_7.M_runs
spneumoniae	pseudosimplitigs	20	7	zeros	2128471	2151121	2128471	22650	1943	557688	5084	562772	562472	spneumoniae.S_pseudosimplitigs.k_20.d_7.M_zeros
spneumoniae	pseudosimplitigs	20	8	default	2128471	2150876	2128471	22405	2022	557824	5376	563200	563392	spneumoniae.S_pseudosimplitigs.k_20.d_8.M_default
spneumoniae	pseudosimplitigs	20	8	ones	2128471	2150876	2131997	18879	1209	557824	3824	561648	561768	spneumoniae.S_pseudosimplitigs.k_20.d_8.M_ones
spneumoniae	pseudosimplitigs	20	8	runs	2128471	2150876	2131979	18897	1199	557824	3804	561628	561808	spneumoniae.S_pseudosimplitigs.k_20.d_8.M_runs
spneumoniae	pseudosimplitigs	20	8	zeros	2128471	2150876	2128471	22405	2022	557824	5388	563212	563180	spneumoniae.S_pseudosimplitigs.k_20.d_8.M_zeros
spneumoniae	pseudosimplitigs	20	9	default	2128471	2151278	2128471	22807	2146	558500	5784	564284	563168	spneumoniae.S_pseudosimplitigs.k_20.d_9.M_default
spneumoniae	pseudosimplitigs	20	9	ones	2128471	2151278	2132426	18852	1287	558500	4160	562660	561800	spneumoniae.S_pseudosimplitigs.k_20.d_9.M_ones
spneumoniae	pseudosimplitigs	20	9	runs	2128471	2151278	2132417	18861	1282	558500	4144	562644	561800	spneumoniae.S_pseudosimplitigs.k_20.d_9.M_runs
spneumoniae	pseudosimplitigs	20	9	zeros	2128471	2151278	2128471	22807	2152	558500	5812	564312	563540	spneumoniae.S_pseudosimplitigs.k_20.d_9.M_zeros
spneumoniae	pseudosimplitigsAC	20	1	default	2128471	2161987	2128471	33516	1764	559872	3952	563824	565152	spneumoniae.S_pseudosimplitigsAC.k_20.d_1.M_default
spneumoniae	pseudosimplitigsAC	20	1	ones	2128471	2161987	2130001	31986	1776	559872	4596	564468	565068	spneumoniae.S_pseudosimplitigsAC.k_20.d_1.M_ones
spneumoniae	pseudosimplitigsAC	20	1	runs	2128471	2161987	2129959	32028	1753	559872	4556	564428	565140	spneumoniae.S_pseudosimplitigsAC.k_20.d_1.M_runs
spneumoniae	pseudosimplitigsAC	20	1	zeros	2128471	2161987	2128471	33516	1804	559872	4140	564012	565184	spneumoniae.S_pseudosimplitigsAC.k_20.d_1.M_zeros
spneumoniae	pseudosimplitigsAC	20	10	default	2128471	2153798	2128471	25327	2472	558060	6996	565056	566088	spneumoniae.S_pseudosimplitigsAC.k_20.d_10.M_default
spneumoniae	pseudosimplitigsAC	20	10	ones	2128471	2153798	2132933	20865	1583	558060	5244	563304	563176	spneumoniae.S_pseudosimplitigsAC.k_20.d_10.M_ones
spneumoniae	pseudosimplitigsAC	20	10	runs	2128471	2153798	2132920	20878	1574	558060	5228	563288	563092	spneumoniae.S_pseudosimplitigsAC.k_20.d_10.M_runs
spneumoniae	pseudosimplitigsAC	20	10	zeros	2128471	2153798	2128471	25327	2498	558060	7088	565148	564712	spneumoniae.S_pseudosimplitigsAC.k_20.d_10.M_zeros
spneumoniae	pseudosimplitigsAC	20	11	default	2128471	2158167	2128471	29696	2963	559112	8276	567388	567600	spneumoniae.S_pseudosimplitigsAC.k_20.d_11.M_default
spneumoniae	pseudosimplitigsAC	20	11	ones	2128471	2158167	2133488	24679	2046	559112	6476	565588	565388	spneumoniae.S_pseudosimplitigsAC.k_20.d_11.M_ones
spneumoniae	pseudosimplitigsAC	20	11	runs	2128471	2158167	2133471	24696	2035	559112	6456	565568	565492	spneumoniae.S_pseudosimplitigsAC.k_20.d_11.M_runs
spneumoniae	pseudosimplitigsAC	20	11	zeros	2128471	2158167	2128471	29696	3015	559112	8404	567516	568068	spneumoniae.S_pseudosimplitigsAC.k_20.d_11.M_zeros
spneumoniae	pseudosimplitigsAC	20	12	default	2128471	2164469	2128471	35998	3588	560760	9292	570052	570292	spneumoniae.S_pseudosimplitigsAC.k_20.d_12.M_default
spneumoniae	pseudosimplitigsAC	20	12	ones	2128471	2164469	2133738	30731	2666	560760	7564	568324	568860	spneumoniae.S_pseudosimplitigsAC.k_20.d_12.M_ones
spneumoniae	pseudosimplitigsAC	20	12	runs	2128471	2164469	2133705	30764	2643	560760	7544	568304	568580	spneumoniae.S_pseudosimplitigsAC.k_20.d_12.M_runs
spneumoniae	pseudosimplitigsAC	20	12	zeros	2128471	2164469	2128471	35998	3640	560760	9424	570184	570516	spneumoniae.S_pseudosimplitigsAC.k_20.d_12.M_zeros
spneumoniae	pseudosimplitigsAC	20	2	default	2128471	2157087	2128471	28616	1796	558792	4292	563084	563928	spneumoniae.S_pseudosimplitigsAC.k_20.d_2.M_default
spneumoniae	pseudosimplitigsAC	20	2	ones	2128471	2157087	2129909	27178	1513	558792	4040	562832	563940	spneumoniae.S_pseudosimplitigsAC.k_20.d_2.M_ones
spneumoniae	pseudosimplitigsAC	20	2	runs	2128471	2157087	2129890	27197	1500	558792	4008	562800	563884	spneumoniae.S_pseudosimplitigsAC.k_20.d_2.M_runs
spneumoniae	pseudosimplitigsAC	20	2	zeros	2128471	2157087	2128471	28616	1806	558792	4332	563124	563716	spneumoniae.S_pseudosimplitigsAC.k_20.d_2.M_zeros
spneumoniae	pseudosimplitigsAC	20	3	default	2128471	2154978	2128471	26507	1814	557968	4444	562412	563388	spneumoniae.S_pseudosimplitigsAC.k_20.d_3.M_default
spneumoniae	pseudosimplitigsAC	20	3	ones	2128471	2154978	2130115	24863	1390	557968	3756	561724	562632	spneumoniae.S_pseudosimplitigsAC.k_20.d_3.M_ones
spneumoniae	pseudosimplitigsAC	20	3	runs	2128471	2154978	2130103	24875	1383	557968	3736	561704	562596	spneumoniae.S_pseudosimplitigsAC.k_20.d_3.M_runs
spneumoniae	pseudosimplitigsAC	20	3	zeros	2128471	2154978	2128471	26507	1820	557968	4472	562440	563684	spneumoniae.S_pseudosimplitigsAC.k_20.d_3.M_zeros
spneumoniae	pseudosimplitigsAC	20	4	default	2128471	2153797	2128471	25326	1837	558160	4576	562736	562984	spneumoniae.S_pseudosimplitigsAC.k_20.d_4.M_default
spneumoniae	pseudosimplitigsAC	20	4	ones	2128471	2153797	2130295	23502	1332	558160	3664	561824	562108	spneumoniae.S_pseudosimplitigsAC.k_20.d_4.M_ones
spneumoniae	pseudosimplitigsAC	20	4	runs	2128471	2153797	2130278	23519	1322	558160	3640	561800	562072	spneumoniae.S_pseudosimplitigsAC.k_20.d_4.M_runs
spneumoniae	pseudosimplitigsAC	20	4	zeros	2128471	2153797	2128471	25326	1839	558160	4584	562744	563620	spneumoniae.S_pseudosimplitigsAC.k_20.d_4.M_zeros
spneumoniae	pseudosimplitigsAC	20	5	default	2128471	2151907	2128471	23436	1861	557100	4772	561872	562672	spneumoniae.S_pseudosimplitigsAC.k_20.d_5.M_default
spneumoniae	pseudosimplitigsAC	20	5	ones	2128471	2151907	2130771	21136	1224	557100	3572	560672	561204	spneumoniae.S_pseudosimplitigsAC.k_20.d_5.M_ones
spneumoniae	pseudosimplitigsAC	20	5	runs	2128471	2151907	2130756	21151	1214	557100	3540	560640	561144	spneumoniae.S_pseudosimplitigsAC.k_20.d_5.M_runs
spneumoniae	pseudosimplitigsAC	20	5	zeros	2128471	2151907	2128471	23436	1863	557100	4776	561876	563156	spneumoniae.S_pseudosimplitigsAC.k_20.d_5.M_zeros
spneumoniae	pseudosimplitigsAC	20	6	default	2128471	2151102	2128471	22631	1877	557084	4876	561960	562560	spneumoniae.S_pseudosimplitigsAC.k_20.d_6.M_default
spneumoniae	pseudosimplitigsAC	20	6	ones	2128471	2151102	2131166	19936	1168	557084	3480	560564	561280	spneumoniae.S_pseudosimplitigsAC.k_20.d_6.M_ones
spneumoniae	pseudosimplitigsAC	20	6	runs	2128471	2151102	2131154	19948	1159	557084	3452	560536	561152	spneumoniae.S_pseudosimplitigsAC.k_20.d_6.M_runs
spneumoniae	pseudosimplitigsAC	20	6	zeros	2128471	2151102	2128471	22631	1881	557084	4896	561980	562216	spneumoniae.S_pseudosimplitigsAC.k_20.d_6.M_zeros
spneumoniae	pseudosimplitigsAC	20	7	default	2128471	2150861	2128471	22390	1932	557156	5112	562268	563272	spneumoniae.S_pseudosimplitigsAC.k_20.d_7.M_default
spneumoniae	pseudosimplitigsAC	20	7	ones	2128471	2150861	2131487	19374	1183	557156	3644	560800	561128	spneumoniae.S_pseudosimplitigsAC.k_20.d_7.M_ones
spneumoniae	pseudosimplitigsAC	20	7	runs	2128471	2150861	2131474	19387	1172	557156	3612	560768	561228	spneumoniae.S_pseudosimplitigsAC.k_20.d_7.M_runs
spneumoniae	pseudosimplitigsAC	20	7	zeros	2128471	2150861	2128471	22390	1940	557156	5156	562312	562452	spneumoniae.S_pseudosimplitigsAC.k_20.d_7.M_zeros
spneumoniae	pseudosimplitigsAC	20	8	default	2128471	2150735	2128471	22264	2019	557396	5444	562840	563084	spneumoniae.S_pseudosimplitigsAC.k_20.d_8.M_default
spneumoniae	pseudosimplitigsAC	20	8	ones	2128471	2150735	2131967	18768	1202	557396	3804	561200	561308	spneumoniae.S_pseudosimplitigsAC.k_20.d_8.M_ones
spneumoniae	pseudosimplitigsAC	20	8	runs	2128471	2150735	2131961	18774	1198	557396	3796	561192	561264	spneumoniae.S_pseudosimplitigsAC.k_20.d_8.M_runs
spneumoniae	pseudosimplitigsAC	20	8	zeros	2128471	2150735	2128471	22264	2026	557396	5456	562852	563428	spneumoniae.S_pseudosimplitigsAC.k_20.d_8.M_zeros
spneumoniae	pseudosimplitigsAC	20	9	default	2128471	2151477	2128471	23006	2164	557660	5996	563656	563776	spneumoniae.S_pseudosimplitigsAC.k_20.d_9.M_default
spneumoniae	pseudosimplitigsAC	20	9	ones	2128471	2151477	2132496	18981	1309	557660	4356	562016	562120	spneumoniae.S_pseudosimplitigsAC.k_20.d_9.M_ones
spneumoniae	pseudosimplitigsAC	20	9	runs	2128471	2151477	2132488	18989	1302	557660	4336	561996	562088	spneumoniae.S_pseudosimplitigsAC.k_20.d_9.M_runs
spneumoniae	pseudosimplitigsAC	20	9	zeros	2128471	2151477	2128471	23006	2178	557660	6004	563664	564520	spneumoniae.S_pseudosimplitigsAC.k_20.d_9.M_zeros
spneumoniae	pseudosimplitigs	21	1	default	2130395	2161975	2130395	31580	1579	558688	3704	562392	563940	spneumoniae.S_pseudosimplitigs.k_21.d_1.M_default
spneumoniae	pseudosimplitigs	21	1	ones	2130395	2161975	2131609	30366	1584	558688	4208	562896	564104	spneumoniae.S_pseudosimplitigs.k_21.d_1.M_ones
spneumoniae	pseudosimplitigs	21	1	runs	2130395	2161975	2131601	30374	1577	558688	4196	562884	564100	spneumoniae.S_pseudosimplitigs.k_21.d_1.M_runs
spneumoniae	pseudosimplitigs	21	1	zeros	2130395	2161975	2130395	31580	1601	558688	3824	562512	563992	spneumoniae.S_pseudosimplitigs.k_21.d_1.M_zeros
spneumoniae	pseudosimplitigs	21	10	default	2130395	2153518	2130395	23123	2006	558112	5740	563852	563608	spneumoniae.S_pseudosimplitigs.k_21.d_10.M_default
spneumoniae	pseudosimplitigs	21	10	ones	2130395	2153518	2134450	19068	1260	558112	4244	562356	561956	spneumoniae.S_pseudosimplitigs.k_21.d_10.M_ones
spneumoniae	pseudosimplitigs	21	10	runs	2130395	2153518	2134439	19079	1251	558112	4232	562344	561728	spneumoniae.S_pseudosimplitigs.k_21.d_10.M_runs
spneumoniae	pseudosimplitigs	21	10	zeros	2130395	2153518	2130395	23123	2015	558112	5800	563912	563540	spneumoniae.S_pseudosimplitigs.k_21.d_10.M_zeros
spneumoniae	pseudosimplitigs	21	11	default	2130395	2155547	2130395	25152	2243	558088	6452	564540	564764	spneumoniae.S_pseudosimplitigs.k_21.d_11.M_default
spneumoniae	pseudosimplitigs	21	11	ones	2130395	2155547	2134793	20754	1474	558088	4968	563056	563028	spneumoniae.S_pseudosimplitigs.k_21.d_11.M_ones
spneumoniae	pseudosimplitigs	21	11	runs	2130395	2155547	2134782	20765	1466	558088	4948	563036	562832	spneumoniae.S_pseudosimplitigs.k_21.d_11.M_runs
spneumoniae	pseudosimplitigs	21	11	zeros	2130395	2155547	2130395	25152	2256	558088	6520	564608	564464	spneumoniae.S_pseudosimplitigs.k_21.d_11.M_zeros
spneumoniae	pseudosimplitigs	21	12	default	2130395	2160480	2130395	30085	2715	559036	7692	566728	566896	spneumoniae.S_pseudosimplitigs.k_21.d_12.M_default
spneumoniae	pseudosimplitigs	21	12	ones	2130395	2160480	2135149	25331	1931	559036	6256	565292	565244	spneumoniae.S_pseudosimplitigs.k_21.d_12.M_ones
spneumoniae	pseudosimplitigs	21	12	runs	2130395	2160480	2135129	25351	1921	559036	6244	565280	565324	spneumoniae.S_pseudosimplitigs.k_21.d_12.M_runs
spneumoniae	pseudosimplitigs	21	12	zeros	2130395	2160480	2130395	30085	2725	559036	7748	566784	567132	spneumoniae.S_pseudosimplitigs.k_21.d_12.M_zeros
spneumoniae	pseudosimplitigs	21	2	default	2130395	2159188	2130395	28793	1604	557980	3912	561892	564244	spneumoniae.S_pseudosimplitigs.k_21.d_2.M_default
spneumoniae	pseudosimplitigs	21	2	ones	2130395	2159188	2131666	27522	1440	557980	3872	561852	563268	spneumoniae.S_pseudosimplitigs.k_21.d_2.M_ones
spneumoniae	pseudosimplitigs	21	2	runs	2130395	2159188	2131661	27527	1436	557980	3864	561844	563228	spneumoniae.S_pseudosimplitigs.k_21.d_2.M_runs
spneumoniae	pseudosimplitigs	21	2	zeros	2130395	2159188	2130395	28793	1616	557980	3964	561944	563692	spneumoniae.S_pseudosimplitigs.k_21.d_2.M_zeros
spneumoniae	pseudosimplitigs	21	3	default	2130395	2157443	2130395	27048	1627	557664	4040	561704	562976	spneumoniae.S_pseudosimplitigs.k_21.d_3.M_default
spneumoniae	pseudosimplitigs	21	3	ones	2130395	2157443	2131848	25595	1361	557664	3784	561448	563044	spneumoniae.S_pseudosimplitigs.k_21.d_3.M_ones
spneumoniae	pseudosimplitigs	21	3	runs	2130395	2157443	2131841	25602	1355	557664	3772	561436	563056	spneumoniae.S_pseudosimplitigs.k_21.d_3.M_runs
spneumoniae	pseudosimplitigs	21	3	zeros	2130395	2157443	2130395	27048	1633	557664	4068	561732	563188	spneumoniae.S_pseudosimplitigs.k_21.d_3.M_zeros
spneumoniae	pseudosimplitigs	21	4	default	2130395	2155051	2130395	24656	1651	557752	4220	561972	562608	spneumoniae.S_pseudosimplitigs.k_21.d_4.M_default
spneumoniae	pseudosimplitigs	21	4	ones	2130395	2155051	2132197	22854	1224	557752	3564	561316	561764	spneumoniae.S_pseudosimplitigs.k_21.d_4.M_ones
spneumoniae	pseudosimplitigs	21	4	runs	2130395	2155051	2132193	22858	1220	557752	3556	561308	561744	spneumoniae.S_pseudosimplitigs.k_21.d_4.M_runs
spneumoniae	pseudosimplitigs	21	4	zeros	2130395	2155051	2130395	24656	1656	557752	4236	561988	562536	spneumoniae.S_pseudosimplitigs.k_21.d_4.M_zeros
spneumoniae	pseudosimplitigs	21	5	default	2130395	2153959	2130395	23564	1666	557252	4372	561624	562724	spneumoniae.S_pseudosimplitigs.k_21.d_5.M_default
spneumoniae	pseudosimplitigs	21	5	ones	2130395	2153959	2132435	21524	1165	557252	3416	560668	561652	spneumoniae.S_pseudosimplitigs.k_21.d_5.M_ones
spneumoniae	pseudosimplitigs	21	5	runs	2130395	2153959	2132429	21530	1159	557252	3408	560660	561780	spneumoniae.S_pseudosimplitigs.k_21.d_5.M_runs
spneumoniae	pseudosimplitigs	21	5	zeros	2130395	2153959	2130395	23564	1672	557252	4372	561624	562660	spneumoniae.S_pseudosimplitigs.k_21.d_5.M_zeros
spneumoniae	pseudosimplitigs	21	6	default	2130395	2153317	2130395	22922	1693	557780	4456	562236	562284	spneumoniae.S_pseudosimplitigs.k_21.d_6.M_default
spneumoniae	pseudosimplitigs	21	6	ones	2130395	2153317	2132743	20574	1138	557780	3428	561208	561436	spneumoniae.S_pseudosimplitigs.k_21.d_6.M_ones
spneumoniae	pseudosimplitigs	21	6	runs	2130395	2153317	2132732	20585	1130	557780	3420	561200	562016	spneumoniae.S_pseudosimplitigs.k_21.d_6.M_runs
spneumoniae	pseudosimplitigs	21	6	zeros	2130395	2153317	2130395	22922	1699	557780	4456	562236	563196	spneumoniae.S_pseudosimplitigs.k_21.d_6.M_zeros
spneumoniae	pseudosimplitigs	21	7	default	2130395	2152672	2130395	22277	1718	557972	4580	562552	562940	spneumoniae.S_pseudosimplitigs.k_21.d_7.M_default
spneumoniae	pseudosimplitigs	21	7	ones	2130395	2152672	2133163	19509	1105	557972	3412	561384	561072	spneumoniae.S_pseudosimplitigs.k_21.d_7.M_ones
spneumoniae	pseudosimplitigs	21	7	runs	2130395	2152672	2133156	19516	1101	557972	3400	561372	561060	spneumoniae.S_pseudosimplitigs.k_21.d_7.M_runs
spneumoniae	pseudosimplitigs	21	7	zeros	2130395	2152672	2130395	22277	1724	557972	4588	562560	562892	spneumoniae.S_pseudosimplitigs.k_21.d_7.M_zeros
spneumoniae	pseudosimplitigs	21	8	default	2130395	2152150	2130395	21755	1740	558396	4752	563148	562304	spneumoniae.S_pseudosimplitigs.k_21.d_8.M_default
spneumoniae	pseudosimplitigs	21	8	ones	2130395	2152150	2133501	18649	1072	558396	3400	561796	561272	spneumoniae.S_pseudosimplitigs.k_21.d_8.M_ones
spneumoniae	pseudosimplitigs	21	8	runs	2130395	2152150	2133493	18657	1065	558396	3396	561792	561084	spneumoniae.S_pseudosimplitigs.k_21.d_8.M_runs
spneumoniae	pseudosimplitigs	21	8	zeros	2130395	2152150	2130395	21755	1746	558396	4772	563168	562960	spneumoniae.S_pseudosimplitigs.k_21.d_8.M_zeros
spneumoniae	pseudosimplitigs	21	9	default	2130395	2152462	2130395	22067	1830	557196	5140	562336	562700	spneumoniae.S_pseudosimplitigs.k_21.d_9.M_default
spneumoniae	pseudosimplitigs	21	9	ones	2130395	2152462	2133875	18587	1131	557196	3656	560852	561716	spneumoniae.S_pseudosimplitigs.k_21.d_9.M_ones
spneumoniae	pseudosimplitigs	21	9	runs	2130395	2152462	2133862	18600	1124	557196	3644	560840	561704	spneumoniae.S_pseudosimplitigs.k_21.d_9.M_runs
spneumoniae	pseudosimplitigs	21	9	zeros	2130395	2152462	2130395	22067	1834	557196	5148	562344	562832	spneumoniae.S_pseudosimplitigs.k_21.d_9.M_zeros
spneumoniae	pseudosimplitigsAC	21	1	default	2130395	2161935	2130395	31540	1577	558820	3648	562468	564340	spneumoniae.S_pseudosimplitigsAC.k_21.d_1.M_default
spneumoniae	pseudosimplitigsAC	21	1	ones	2130395	2161935	2131568	30367	1582	558820	4168	562988	564844	spneumoniae.S_pseudosimplitigsAC.k_21.d_1.M_ones
spneumoniae	pseudosimplitigsAC	21	1	runs	2130395	2161935	2131559	30376	1576	558820	4148	562968	564896	spneumoniae.S_pseudosimplitigsAC.k_21.d_1.M_runs
spneumoniae	pseudosimplitigsAC	21	1	zeros	2130395	2161935	2130395	31540	1601	558820	3756	562576	564788	spneumoniae.S_pseudosimplitigsAC.k_21.d_1.M_zeros
spneumoniae	pseudosimplitigsAC	21	10	default	2130395	2153482	2130395	23087	1987	557776	5668	563444	563692	spneumoniae.S_pseudosimplitigsAC.k_21.d_10.M_default
spneumoniae	pseudosimplitigsAC	21	10	ones	2130395	2153482	2134430	19052	1251	557776	4188	561964	562308	spneumoniae.S_pseudosimplitigsAC.k_21.d_10.M_ones
spneumoniae	pseudosimplitigsAC	21	10	runs	2130395	2153482	2134419	19063	1244	557776	4180	561956	562324	spneumoniae.S_pseudosimplitigsAC.k_21.d_10.M_runs
spneumoniae	pseudosimplitigsAC	21	10	zeros	2130395	2153482	2130395	23087	1996	557776	5724	563500	563696	spneumoniae.S_pseudosimplitigsAC.k_21.d_10.M_zeros
spneumoniae	pseudosimplitigsAC	21	11	default	2130395	2155332	2130395	24937	2219	558560	6396	564956	565036	spneumoniae.S_pseudosimplitigsAC.k_21.d_11.M_default
spneumoniae	pseudosimplitigsAC	21	11	ones	2130395	2155332	2134781	20551	1443	558560	4904	563464	562912	spneumoniae.S_pseudosimplitigsAC.k_21.d_11.M_ones
spneumoniae	pseudosimplitigsAC	21	11	runs	2130395	2155332	2134771	20561	1436	558560	4896	563456	563100	spneumoniae.S_pseudosimplitigsAC.k_21.d_11.M_runs
spneumoniae	pseudosimplitigsAC	21	11	zeros	2130395	2155332	2130395	24937	2235	558560	6464	565024	564988	spneumoniae.S_pseudosimplitigsAC.k_21.d_11.M_zeros
spneumoniae	pseudosimplitigsAC	21	12	default	2130395	2159523	2130395	29128	2642	559384	7488	566872	567212	spneumoniae.S_pseudosimplitigsAC.k_21.d_12.M_default
spneumoniae	pseudosimplitigsAC	21	12	ones	2130395	2159523	2135148	24375	1847	559384	6000	565384	565116	spneumoniae.S_pseudosimplitigsAC.k_21.d_12.M_ones
spneumoniae	pseudosimplitigsAC	21	12	runs	2130395	2159523	2135122	24401	1835	559384	5980	565364	565104	spneumoniae.S_pseudosimplitigsAC.k_21.d_12.M_runs
spneumoniae	pseudosimplitigsAC	21	12	zeros	2130395	2159523	2130395	29128	2680	559384	7624	567008	566952	spneumoniae.S_pseudosimplitigsAC.k_21.d_12.M_zeros
spneumoniae	pseudosimplitigsAC	21	2	default	2130395	2159110	2130395	28715	1602	559268	3848	563116	563660	spneumoniae.S_pseudosimplitigsAC.k_21.d_2.M_default
spneumoniae	pseudosimplitigsAC	21	2	ones	2130395	2159110	2131597	27513	1439	559268	3836	563104	563784	spneumoniae.S_pseudosimplitigsAC.k_21.d_2.M_ones
spneumoniae	pseudosimplitigsAC	21	2	runs	2130395	2159110	2131590	27520	1433	559268	3828	563096	563712	spneumoniae.S_pseudosimplitigsAC.k_21.d_2.M_runs
spneumoniae	pseudosimplitigsAC	21	2	zeros	2130395	2159110	2130395	28715	1607	559268	3880	563148	563600	spneumoniae.S_pseudosimplitigsAC.k_21.d_2.M_zeros
spneumoniae	pseudosimplitigsAC	21	3	default	2130395	2157325	2130395	26930	1618	558052	4016	562068	563360	spneumoniae.S_pseudosimplitigsAC.k_21.d_3.M_default
spneumoniae	pseudosimplitigsAC	21	3	ones	2130395	2157325	2131765	25560	1349	558052	3708	561760	562700	spneumoniae.S_pseudosimplitigsAC.k_21.d_3.M_ones
spneumoniae	pseudosimplitigsAC	21	3	runs	2130395	2157325	2131761	25564	1345	558052	3700	561752	562868	spneumoniae.S_pseudosimplitigsAC.k_21.d_3.M_runs
spneumoniae	pseudosimplitigsAC	21	3	zeros	2130395	2157325	2130395	26930	1624	558052	4052	562104	562876	spneumoniae.S_pseudosimplitigsAC.k_21.d_3.M_zeros
spneumoniae	pseudosimplitigsAC	21	4	default	2130395	2155067	2130395	24672	1658	557500	4212	561712	563264	spneumoniae.S_pseudosimplitigsAC.k_21.d_4.M_default
spneumoniae	pseudosimplitigsAC	21	4	ones	2130395	2155067	2132168	22899	1229	557500	3508	561008	561956	spneumoniae.S_pseudosimplitigsAC.k_21.d_4.M_ones
spneumoniae	pseudosimplitigsAC	21	4	runs	2130395	2155067	2132162	22905	1223	557500	3496	560996	562192	spneumoniae.S_pseudosimplitigsAC.k_21.d_4.M_runs
spneumoniae	pseudosimplitigsAC	21	4	zeros	2130395	2155067	2130395	24672	1663	557500	4228	561728	562808	spneumoniae.S_pseudosimplitigsAC.k_21.d_4.M_zeros
spneumoniae	pseudosimplitigsAC	21	5	default	2130395	2153949	2130395	23554	1680	558008	4368	562376	562824	spneumoniae.S_pseudosimplitigsAC.k_21.d_5.M_default
spneumoniae	pseudosimplitigsAC	21	5	ones	2130395	2153949	2132481	21468	1161	558008	3452	561460	562548	spneumoniae.S_pseudosimplitigsAC.k_21.d_5.M_ones
spneumoniae	pseudosimplitigsAC	21	5	runs	2130395	2153949	2132479	21470	1159	558008	3448	561456	562500	spneumoniae.S_pseudosimplitigsAC.k_21.d_5.M_runs
spneumoniae	pseudosimplitigsAC	21	5	zeros	2130395	2153949	2130395	23554	1685	558008	4396	562404	563028	spneumoniae.S_pseudosimplitigsAC.k_21.d_5.M_zeros
spneumoniae	pseudosimplitigsAC	21	6	default	2130395	2153369	2130395	22974	1700	557604	4448	562052	563416	spneumoniae.S_pseudosimplitigsAC.k_21.d_6.M_default
spneumoniae	pseudosimplitigsAC	21	6	ones	2130395	2153369	2132761	20608	1137	557604	3428	561032	561700	spneumoniae.S_pseudosimplitigsAC.k_21.d_6.M_ones
spneumoniae	pseudosimplitigsAC	21	6	runs	2130395	2153369	2132757	20612	1133	557604	3416	561020	561700	spneumoniae.S_pseudosimplitigsAC.k_21.d_6.M_runs
spneumoniae	pseudosimplitigsAC	21	6	zeros	2130395	2153369	2130395	22974	1705	557604	4468	562072	563564	spneumoniae.S_pseudosimplitigsAC.k_21.d_6.M_zeros
spneumoniae	pseudosimplitigsAC	21	7	default	2130395	2152766	2130395	22371	1734	557904	4632	562536	562732	spneumoniae.S_pseudosimplitigsAC.k_21.d_7.M_default
spneumoniae	pseudosimplitigsAC	21	7	ones	2130395	2152766	2133194	19572	1111	557904	3428	561332	561524	spneumoniae.S_pseudosimplitigsAC.k_21.d_7.M_ones
spneumoniae	pseudosimplitigsAC	21	7	runs	2130395	2152766	2133186	19580	1105	557904	3408	561312	561752	spneumoniae.S_pseudosimplitigsAC.k_21.d_7.M_runs
spneumoniae	pseudosimplitigsAC	21	7	zeros	2130395	2152766	2130395	22371	1739	557904	4644	562548	563376	spneumoniae.S_pseudosimplitigsAC.k_21.d_7.M_zeros
spneumoniae	pseudosimplitigsAC	21	8	default	2130395	2152200	2130395	21805	1756	557588	4784	562372	563064	spneumoniae.S_pseudosimplitigsAC.k_21.d_8.M_default
spneumoniae	pseudosimplitigsAC	21	8	ones	2130395	2152200	2133575	18625	1085	557588	3468	561056	561692	spneumoniae.S_pseudosimplitigsAC.k_21.d_8.M_ones
spneumoniae	pseudosimplitigsAC	21	8	runs	2130395	2152200	2133563	18637	1077	557588	3456	561044	561648	spneumoniae.S_pseudosimplitigsAC.k_21.d_8.M_runs
spneumoniae	pseudosimplitigsAC	21	8	zeros	2130395	2152200	2130395	21805	1763	557588	4808	562396	562936	spneumoniae.S_pseudosimplitigsAC.k_21.d_8.M_zeros
spneumoniae	pseudosimplitigsAC	21	9	default	2130395	2152189	2130395	21794	1819	557240	5016	562256	563496	spneumoniae.S_pseudosimplitigsAC.k_21.d_9.M_default
spneumoniae	pseudosimplitigsAC	21	9	ones	2130395	2152189	2133980	18209	1101	557240	3648	560888	561124	spneumoniae.S_pseudosimplitigsAC.k_21.d_9.M_ones
spneumoniae	pseudosimplitigsAC	21	9	runs	2130395	2152189	2133964	18225	1093	557240	3632	560872	561128	spneumoniae.S_pseudosimplitigsAC.k_21.d_9.M_runs
spneumoniae	pseudosimplitigsAC	21	9	zeros	2130395	2152189	2130395	21794	1822	557240	5032	562272	563032	spneumoniae.S_pseudosimplitigsAC.k_21.d_9.M_zeros
spneumoniae-pangenome	pseudosimplitigs	2	1	default	10	12	10	2	2	68	68	136	68	spneumoniae-pangenome.S_pseudosimplitigs.k_2.d_1.M_default
spneumoniae-pangenome	pseudosimplitigs	2	1	ones	10	12	11	1	1	68	68	136	68	spneumoniae-pangenome.S_pseudosimplitigs.k_2.d_1.M_ones
spneumoniae-pangenome	pseudosimplitigs	2	1	runs	10	12	11	1	1	68	68	136	68	spneumoniae-pangenome.S_pseudosimplitigs.k_2.d_1.M_runs
spneumoniae-pangenome	pseudosimplitigs	2	1	zeros	10	12	10	2	2	68	68	136	68	spneumoniae-pangenome.S_pseudosimplitigs.k_2.d_1.M_zeros
spneumoniae-pangenome	pseudosimplitigsAC	2	1	default	10	11	10	1	1	68	68	136	68	spneumoniae-pangenome.S_pseudosimplitigsAC.k_2.d_1.M_default
spneumoniae-pangenome	pseudosimplitigsAC	2	1	ones	10	11	10	1	1	68	68	136	68	spneumoniae-pangenome.S_pseudosimplitigsAC.k_2.d_1.M_ones
spneumoniae-pangenome	pseudosimplitigsAC	2	1	runs	10	11	10	1	1	68	68	136	68	spneumoniae-pangenome.S_pseudosimplitigsAC.k_2.d_1.M_runs
spneumoniae-pangenome	pseudosimplitigsAC	2	1	zeros	10	11	10	1	1	68	68	136	68	spneumoniae-pangenome.S_pseudosimplitigsAC.k_2.d_1.M_zeros
spneumoniae-pangenome	pseudosimplitigs	3	1	default	32	36	32	4	2	92	72	164	96	spneumoniae-pangenome.S_pseudosimplitigs.k_3.d_1.M_default
spneumoniae-pangenome	pseudosimplitigs	3	1	ones	32	36	34	2	1	92	72	164	96	spneumoniae-pangenome.S_pseudosimplitigs.k_3.d_1.M_ones
spneumoniae-pangenome	pseudosimplitigs	3	1	runs	32	36	34	2	1	92	72	164	96	spneumoniae-pangenome.S_pseudosimplitigs.k_3.d_1.M_runs
spneumoniae-pangenome	pseudosimplitigs	3	1	zeros	32	36	32	4	2	92	72	164	96	spneumoniae-pangenome.S_pseudosimplitigs.k_3.d_1.M_zeros
spneumoniae-pangenome	pseudosimplitigs	3	2	default	32	35	32	3	2	92	72	164	92	spneumoniae-pangenome.S_pseudosimplitigs.k_3.d_2.M_default
spneumoniae-pangenome	pseudosimplitigs	3	2	ones	32	35	33	2	1	92	72	164	96	spneumoniae-pangenome.S_pseudosimplitigs.k_3.d_2.M_ones
spneumoniae-pangenome	pseudosimplitigs	3	2	runs	32	35	33	2	1	92	72	164	96	spneumoniae-pangenome.S_pseudosimplitigs.k_3.d_2.M_runs
spneumoniae-pangenome	pseudosimplitigs	3	2	zeros	32	35	32	3	2	92	72	164	92	spneumoniae-pangenome.S_pseudosimplitigs.k_3.d_2.M_zeros
spneumoniae-pangenome	pseudosimplitigsAC	3	1	default	32	36	32	4	2	92	72	164	92	spneumoniae-pangenome.S_pseudosimplitigsAC.k_3.d_1.M_default
spneumoniae-pangenome	pseudosimplitigsAC	3	1	ones	32	36	34	2	1	92	72	164	96	spneumoniae-pangenome.S_pseudosimplitigsAC.k_3.d_1.M_ones
spneumoniae-pangenome	pseudosimplitigsAC	3	1	runs	32	36	34	2	1	92	72	164	96	spneumoniae-pangenome.S_pseudosimplitigsAC.k_3.d_1.M_runs
spneumoniae-pangenome	pseudosimplitigsAC	3	1	zeros	32	36	32	4	2	92	72	164	92	spneumoniae-pangenome.S_pseudosimplitigsAC.k_3.d_1.M_zeros
spneumoniae-pangenome	pseudosimplitigsAC	3	2	default	32	35	32	3	2	92	72	164	96	spneumoniae-pangenome.S_pseudosimplitigsAC.k_3.d_2.M_default
spneumoniae-pangenome	pseudosimplitigsAC	3	2	ones	32	35	33	2	1	92	72	164	96	spneumoniae-pangenome.S_pseudosimplitigsAC.k_3.d_2.M_ones
spneumoniae-pangenome	pseudosimplitigsAC	3	2	runs	32	35	33	2	1	92	72	164	96	spneumoniae-pangenome.S_pseudosimplitigsAC.k_3.d_2.M_runs
spneumoniae-pangenome	pseudosimplitigsAC	3	2	zeros	32	35	32	3	2	92	72	164	96	spneumoniae-pangenome.S_pseudosimplitigsAC.k_3.d_2.M_zeros
spneumoniae-pangenome	pseudosimplitigs	4	1	default	136	166	136	30	10	152	88	240	172	spneumoniae-pangenome.S_pseudosimplitigs.k_4.d_1.M_default
spneumoniae-pangenome	pseudosimplitigs	4	1	ones	136	166	163	3	1	152	76	228	156	spneumoniae-pangenome.S_pseudosimplitigs.k_4.d_1.M_ones
spneumoniae-pangenome	pseudosimplitigs	4	1	runs	136	166	163	3	1	152	76	228	156	spneumoniae-pangenome.S_pseudosimplitigs.k_4.d_1.M_runs
spneumoniae-pangenome	pseudosimplitigs	4	1	zeros	136	166	136	30	13	152	92	244	176	spneumoniae-pangenome.S_pseudosimplitigs.k_4.d_1.M_zeros
spneumoniae-pangenome	pseudosimplitigs	4	2	default	136	158	136	22	10	152	88	240	168	spneumoniae-pangenome.S_pseudosimplitigs.k_4.d_2.M_default
spneumoniae-pangenome	pseudosimplitigs	4	2	ones	136	158	155	3	1	152	76	228	152	spneumoniae-pangenome.S_pseudosimplitigs.k_4.d_2.M_ones
spneumoniae-pangenome	pseudosimplitigs	4	2	runs	136	158	155	3	1	152	76	228	152	spneumoniae-pangenome.S_pseudosimplitigs.k_4.d_2.M_runs
spneumoniae-pangenome	pseudosimplitigs	4	2	zeros	136	158	136	22	11	152	88	240	168	spneumoniae-pangenome.S_pseudosimplitigs.k_4.d_2.M_zeros
spneumoniae-pangenome	pseudosimplitigs	4	3	default	136	157	136	21	12	152	88	240	164	spneumoniae-pangenome.S_pseudosimplitigs.k_4.d_3.M_default
spneumoniae-pangenome	pseudosimplitigs	4	3	ones	136	157	154	3	1	152	76	228	152	spneumoniae-pangenome.S_pseudosimplitigs.k_4.d_3.M_ones
spneumoniae-pangenome	pseudosimplitigs	4	3	runs	136	157	154	3	1	152	76	228	152	spneumoniae-pangenome.S_pseudosimplitigs.k_4.d_3.M_runs
spneumoniae-pangenome	pseudosimplitigs	4	3	zeros	136	157	136	21	12	152	88	240	164	spneumoniae-pangenome.S_pseudosimplitigs.k_4.d_3.M_zeros
spneumoniae-pangenome	pseudosimplitigsAC	4	1	default	136	160	136	24	8	160	80	240	176	spneumoniae-pangenome.S_pseudosimplitigsAC.k_4.d_1.M_default
spneumoniae-pangenome	pseudosimplitigsAC	4	1	ones	136	160	157	3	1	160	76	236	164	spneumoniae-pangenome.S_pseudosimplitigsAC.k_4.d_1.M_ones
spneumoniae-pangenome	pseudosimplitigsAC	4	1	runs	136	160	157	3	1	160	76	236	164	spneumoniae-pangenome.S_pseudosimplitigsAC.k_4.d_1.M_runs
spneumoniae-pangenome	pseudosimplitigsAC	4	1	zeros	136	160	136	24	9	160	84	244	176	spneumoniae-pangenome.S_pseudosimplitigsAC.k_4.d_1.M_zeros
spneumoniae-pangenome	pseudosimplitigsAC	4	2	default	136	148	136	12	8	156	80	236	164	spneumoniae-pangenome.S_pseudosimplitigsAC.k_4.d_2.M_default
spneumoniae-pangenome	pseudosimplitigsAC	4	2	ones	136	148	145	3	1	156	76	232	156	spneumoniae-pangenome.S_pseudosimplitigsAC.k_4.d_2.M_ones
spneumoniae-pangenome	pseudosimplitigsAC	4	2	runs	136	148	145	3	1	156	76	232	156	spneumoniae-pangenome.S_pseudosimplitigsAC.k_4.d_2.M_runs
spneumoniae-pangenome	pseudosimplitigsAC	4	2	zeros	136	148	136	12	8	156	80	236	164	spneumoniae-pangenome.S_pseudosimplitigsAC.k_4.d_2.M_zeros
spneumoniae-pangenome	pseudosimplitigsAC	4	3	default	136	147	136	11	8	156	80	236	164	spneumoniae-pangenome.S_pseudosimplitigsAC.k_4.d_3.M_default
spneumoniae-pangenome	pseudosimplitigsAC	4	3	ones	136	147	144	3	1	156	76	232	156	spneumoniae-pangenome.S_pseudosimplitigsAC.k_4.d_3.M_ones
spneumoniae-pangenome	pseudosimplitigsAC	4	3	runs	136	147	144	3	1	156	76	232	156	spneumoniae-pangenome.S_pseudosimplitigsAC.k_4.d_3.M_runs
spneumoniae-pangenome	pseudosimplitigsAC	4	3	zeros	136	147	136	11	8	156	84	240	164	spneumoniae-pangenome.S_pseudosimplitigsAC.k_4.d_3.M_zeros
spneumoniae-pangenome	pseudosimplitigs	5	1	default	512	568	512	56	14	272	96	368	320	spneumoniae-pangenome.S_pseudosimplitigs.k_5.d_1.M_default
spneumoniae-pangenome	pseudosimplitigs	5	1	ones	512	568	564	4	1	272	76	348	276	spneumoniae-pangenome.S_pseudosimplitigs.k_5.d_1.M_ones
spneumoniae-pangenome	pseudosimplitigs	5	1	runs	512	568	564	4	1	272	76	348	276	spneumoniae-pangenome.S_pseudosimplitigs.k_5.d_1.M_runs
spneumoniae-pangenome	pseudosimplitigs	5	1	zeros	512	568	512	56	20	272	108	380	320	spneumoniae-pangenome.S_pseudosimplitigs.k_5.d_1.M_zeros
spneumoniae-pangenome	pseudosimplitigs	5	2	default	512	556	512	44	26	272	112	384	312	spneumoniae-pangenome.S_pseudosimplitigs.k_5.d_2.M_default
spneumoniae-pangenome	pseudosimplitigs	5	2	ones	512	556	552	4	1	272	76	348	276	spneumoniae-pangenome.S_pseudosimplitigs.k_5.d_2.M_ones
spneumoniae-pangenome	pseudosimplitigs	5	2	runs	512	556	552	4	1	272	76	348	276	spneumoniae-pangenome.S_pseudosimplitigs.k_5.d_2.M_runs
spneumoniae-pangenome	pseudosimplitigs	5	2	zeros	512	556	512	44	25	272	112	384	308	spneumoniae-pangenome.S_pseudosimplitigs.k_5.d_2.M_zeros
spneumoniae-pangenome	pseudosimplitigs	5	3	default	512	544	512	32	24	256	108	364	288	spneumoniae-pangenome.S_pseudosimplitigs.k_5.d_3.M_default
spneumoniae-pangenome	pseudosimplitigs	5	3	ones	512	544	540	4	1	256	76	332	256	spneumoniae-pangenome.S_pseudosimplitigs.k_5.d_3.M_ones
spneumoniae-pangenome	pseudosimplitigs	5	3	runs	512	544	540	4	1	256	76	332	256	spneumoniae-pangenome.S_pseudosimplitigs.k_5.d_3.M_runs
spneumoniae-pangenome	pseudosimplitigs	5	3	zeros	512	544	512	32	25	256	112	368	284	spneumoniae-pangenome.S_pseudosimplitigs.k_5.d_3.M_zeros
spneumoniae-pangenome	pseudosimplitigs	5	4	default	512	544	512	32	24	256	108	364	288	spneumoniae-pangenome.S_pseudosimplitigs.k_5.d_4.M_default
spneumoniae-pangenome	pseudosimplitigs	5	4	ones	512	544	540	4	1	256	76	332	256	spneumoniae-pangenome.S_pseudosimplitigs.k_5.d_4.M_ones
spneumoniae-pangenome	pseudosimplitigs	5	4	runs	512	544	540	4	1	256	76	332	256	spneumoniae-pangenome.S_pseudosimplitigs.k_5.d_4.M_runs
spneumoniae-pangenome	pseudosimplitigs	5	4	zeros	512	544	512	32	25	256	112	368	284	spneumoniae-pangenome.S_pseudosimplitigs.k_5.d_4.M_zeros
spneumoniae-pangenome	pseudosimplitigsAC	5	1	default	512	528	512	16	4	308	84	392	320	spneumoniae-pangenome.S_pseudosimplitigsAC.k_5.d_1.M_default
spneumoniae-pangenome	pseudosimplitigsAC	5	1	ones	512	528	524	4	1	308	76	384	312	spneumoniae-pangenome.S_pseudosimplitigsAC.k_5.d_1.M_ones
spneumoniae-pangenome	pseudosimplitigsAC	5	1	runs	512	528	524	4	1	308	76	384	312	spneumoniae-pangenome.S_pseudosimplitigsAC.k_5.d_1.M_runs
spneumoniae-pangenome	pseudosimplitigsAC	5	1	zeros	512	528	512	16	4	308	84	392	320	spneumoniae-pangenome.S_pseudosimplitigsAC.k_5.d_1.M_zeros
spneumoniae-pangenome	pseudosimplitigsAC	5	2	default	512	521	512	9	3	300	80	380	312	spneumoniae-pangenome.S_pseudosimplitigsAC.k_5.d_2.M_default
spneumoniae-pangenome	pseudosimplitigsAC	5	2	ones	512	521	517	4	1	300	76	376	304	spneumoniae-pangenome.S_pseudosimplitigsAC.k_5.d_2.M_ones
spneumoniae-pangenome	pseudosimplitigsAC	5	2	runs	512	521	517	4	1	300	76	376	304	spneumoniae-pangenome.S_pseudosimplitigsAC.k_5.d_2.M_runs
spneumoniae-pangenome	pseudosimplitigsAC	5	2	zeros	512	521	512	9	3	300	80	380	308	spneumoniae-pangenome.S_pseudosimplitigsAC.k_5.d_2.M_zeros
spneumoniae-pangenome	pseudosimplitigsAC	5	3	default	512	519	512	7	3	300	80	380	308	spneumoniae-pangenome.S_pseudosimplitigsAC.k_5.d_3.M_default
spneumoniae-pangenome	pseudosimplitigsAC	5	3	ones	512	519	515	4	1	300	76	376	304	spneumoniae-pangenome.S_pseudosimplitigsAC.k_5.d_3.M_ones
spneumoniae-pangenome	pseudosimplitigsAC	5	3	runs	512	519	515	4	1	300	76	376	304	spneumoniae-pangenome.S_pseudosimplitigsAC.k_5.d_3.M_runs
spneumoniae-pangenome	pseudosimplitigsAC	5	3	zeros	512	519	512	7	3	300	80	380	304	spneumoniae-pangenome.S_pseudosimplitigsAC.k_5.d_3.M_zeros
spneumoniae-pangenome	pseudosimplitigsAC	5	4	default	512	519	512	7	3	300	80	380	308	spneumoniae-pangenome.S_pseudosimplitigsAC.k_5.d_4.M_default
spneumoniae-pangenome	pseudosimplitigsAC	5	4	ones	512	519	515	4	1	300	76	376	304	spneumoniae-pangenome.S_pseudosimplitigsAC.k_5.d_4.M_ones
spneumoniae-pangenome	pseudosimplitigsAC	5	4	runs	512	519	515	4	1	300	76	376	304	spneumoniae-pangenome.S_pseudosimplitigsAC.k_5.d_4.M_runs
spneumoniae-pangenome	pseudosimplitigsAC	5	4	zeros	512	519	512	7	3	300	80	380	304	spneumoniae-pangenome.S_pseudosimplitigsAC.k_5.d_4.M_zeros
spneumoniae-pangenome	pseudosimplitigs	6	1	default	2080	2305	2080	225	45	692	152	844	772	spneumoniae-pangenome.S_pseudosimplitigs.k_6.d_1.M_default
spneumoniae-pangenome	pseudosimplitigs	6	1	ones	2080	2305	2300	5	1	692	88	780	696	spneumoniae-pangenome.S_pseudosimplitigs.k_6.d_1.M_ones
spneumoniae-pangenome	pseudosimplitigs	6	1	runs	2080	2305	2300	5	1	692	88	780	696	spneumoniae-pangenome.S_pseudosimplitigs.k_6.d_1.M_runs
spneumoniae-pangenome	pseudosimplitigs	6	1	zeros	2080	2305	2080	225	64	692	192	884	796	spneumoniae-pangenome.S_pseudosimplitigs.k_6.d_1.M_zeros
spneumoniae-pangenome	pseudosimplitigs	6	2	default	2080	2259	2080	179	79	684	196	880	772	spneumoniae-pangenome.S_pseudosimplitigs.k_6.d_2.M_default
spneumoniae-pangenome	pseudosimplitigs	6	2	ones	2080	2259	2254	5	1	684	88	772	688	spneumoniae-pangenome.S_pseudosimplitigs.k_6.d_2.M_ones
spneumoniae-pangenome	pseudosimplitigs	6	2	runs	2080	2259	2254	5	1	684	88	772	688	spneumoniae-pangenome.S_pseudosimplitigs.k_6.d_2.M_runs
spneumoniae-pangenome	pseudosimplitigs	6	2	zeros	2080	2259	2080	179	80	684	208	892	772	spneumoniae-pangenome.S_pseudosimplitigs.k_6.d_2.M_zeros
spneumoniae-pangenome	pseudosimplitigs	6	3	default	2080	2314	2080	234	157	700	224	924	812	spneumoniae-pangenome.S_pseudosimplitigs.k_6.d_3.M_default
spneumoniae-pangenome	pseudosimplitigs	6	3	ones	2080	2314	2309	5	1	700	88	788	700	spneumoniae-pangenome.S_pseudosimplitigs.k_6.d_3.M_ones
spneumoniae-pangenome	pseudosimplitigs	6	3	runs	2080	2314	2309	5	1	700	88	788	700	spneumoniae-pangenome.S_pseudosimplitigs.k_6.d_3.M_runs
spneumoniae-pangenome	pseudosimplitigs	6	3	zeros	2080	2314	2080	234	150	700	248	948	832	spneumoniae-pangenome.S_pseudosimplitigs.k_6.d_3.M_zeros
spneumoniae-pangenome	pseudosimplitigs	6	4	default	2080	2311	2080	231	161	684	240	924	812	spneumoniae-pangenome.S_pseudosimplitigs.k_6.d_4.M_default
spneumoniae-pangenome	pseudosimplitigs	6	4	ones	2080	2311	2306	5	1	684	88	772	688	spneumoniae-pangenome.S_pseudosimplitigs.k_6.d_4.M_ones
spneumoniae-pangenome	pseudosimplitigs	6	4	runs	2080	2311	2306	5	1	684	88	772	688	spneumoniae-pangenome.S_pseudosimplitigs.k_6.d_4.M_runs
spneumoniae-pangenome	pseudosimplitigs	6	4	zeros	2080	2311	2080	231	157	684	264	948	836	spneumoniae-pangenome.S_pseudosimplitigs.k_6.d_4.M_zeros
spneumoniae-pangenome	pseudosimplitigs	6	5	default	2080	2307	2080	227	161	684	240	924	812	spneumoniae-pangenome.S_pseudosimplitigs.k_6.d_5.M_default
spneumoniae-pangenome	pseudosimplitigs	6	5	ones	2080	2307	2302	5	1	684	88	772	688	spneumoniae-pangenome.S_pseudosimplitigs.k_6.d_5.M_ones
spneumoniae-pangenome	pseudosimplitigs	6	5	runs	2080	2307	2302	5	1	684	88	772	688	spneumoniae-pangenome.S_pseudosimplitigs.k_6.d_5.M_runs
spneumoniae-pangenome	pseudosimplitigs	6	5	zeros	2080	2307	2080	227	157	684	264	948	832	spneumoniae-pangenome.S_pseudosimplitigs.k_6.d_5.M_zeros
spneumoniae-pangenome	pseudosimplitigsAC	6	1	default	2080	2235	2080	155	31	876	124	1000	932	spneumoniae-pangenome.S_pseudosimplitigsAC.k_6.d_1.M_default
spneumoniae-pangenome	pseudosimplitigsAC	6	1	ones	2080	2235	2230	5	1	876	88	964	880	spneumoniae-pangenome.S_pseudosimplitigsAC.k_6.d_1.M_ones
spneumoniae-pangenome	pseudosimplitigsAC	6	1	runs	2080	2235	2230	5	1	876	88	964	880	spneumoniae-pangenome.S_pseudosimplitigsAC.k_6.d_1.M_runs
spneumoniae-pangenome	pseudosimplitigsAC	6	1	zeros	2080	2235	2080	155	47	876	156	1032	952	spneumoniae-pangenome.S_pseudosimplitigsAC.k_6.d_1.M_zeros
spneumoniae-pangenome	pseudosimplitigsAC	6	2	default	2080	2216	2080	136	52	868	156	1024	952	spneumoniae-pangenome.S_pseudosimplitigsAC.k_6.d_2.M_default
spneumoniae-pangenome	pseudosimplitigsAC	6	2	ones	2080	2216	2211	5	1	868	88	956	872	spneumoniae-pangenome.S_pseudosimplitigsAC.k_6.d_2.M_ones
spneumoniae-pangenome	pseudosimplitigsAC	6	2	runs	2080	2216	2211	5	1	868	88	956	872	spneumoniae-pangenome.S_pseudosimplitigsAC.k_6.d_2.M_runs
spneumoniae-pangenome	pseudosimplitigsAC	6	2	zeros	2080	2216	2080	136	53	868	156	1024	936	spneumoniae-pangenome.S_pseudosimplitigsAC.k_6.d_2.M_zeros
spneumoniae-pangenome	pseudosimplitigsAC	6	3	default	2080	2180	2080	100	53	856	160	1016	924	spneumoniae-pangenome.S_pseudosimplitigsAC.k_6.d_3.M_default
spneumoniae-pangenome	pseudosimplitigsAC	6	3	ones	2080	2180	2175	5	1	856	84	940	860	spneumoniae-pangenome.S_pseudosimplitigsAC.k_6.d_3.M_ones
spneumoniae-pangenome	pseudosimplitigsAC	6	3	runs	2080	2180	2175	5	1	856	84	940	860	spneumoniae-pangenome.S_pseudosimplitigsAC.k_6.d_3.M_runs
spneumoniae-pangenome	pseudosimplitigsAC	6	3	zeros	2080	2180	2080	100	52	856	156	1012	920	spneumoniae-pangenome.S_pseudosimplitigsAC.k_6.d_3.M_zeros
spneumoniae-pangenome	pseudosimplitigsAC	6	4	default	2080	2175	2080	95	53	856	156	1012	924	spneumoniae-pangenome.S_pseudosimplitigsAC.k_6.d_4.M_default
spneumoniae-pangenome	pseudosimplitigsAC	6	4	ones	2080	2175	2170	5	1	856	84	940	860	spneumoniae-pangenome.S_pseudosimplitigsAC.k_6.d_4.M_ones
spneumoniae-pangenome	pseudosimplitigsAC	6	4	runs	2080	2175	2170	5	1	856	84	940	860	spneumoniae-pangenome.S_pseudosimplitigsAC.k_6.d_4.M_runs
spneumoniae-pangenome	pseudosimplitigsAC	6	4	zeros	2080	2175	2080	95	52	856	152	1008	916	spneumoniae-pangenome.S_pseudosimplitigsAC.k_6.d_4.M_zeros
spneumoniae-pangenome	pseudosimplitigsAC	6	5	default	2080	2174	2080	94	53	852	156	1008	920	spneumoniae-pangenome.S_pseudosimplitigsAC.k_6.d_5.M_default
spneumoniae-pangenome	pseudosimplitigsAC	6	5	ones	2080	2174	2169	5	1	852	84	936	856	spneumoniae-pangenome.S_pseudosimplitigsAC.k_6.d_5.M_ones
spneumoniae-pangenome	pseudosimplitigsAC	6	5	runs	2080	2174	2169	5	1	852	84	936	856	spneumoniae-pangenome.S_pseudosimplitigsAC.k_6.d_5.M_runs
spneumoniae-pangenome	pseudosimplitigsAC	6	5	zeros	2080	2174	2080	94	52	852	156	1008	916	spneumoniae-pangenome.S_pseudosimplitigsAC.k_6.d_5.M_zeros
spneumoniae-pangenome	pseudosimplitigs	7	1	default	8192	8576	8192	384	64	1524	200	1724	1744	spneumoniae-pangenome.S_pseudosimplitigs.k_7.d_1.M_default
spneumoniae-pangenome	pseudosimplitigs	7	1	ones	8192	8576	8570	6	1	1524	108	1632	1532	spneumoniae-pangenome.S_pseudosimplitigs.k_7.d_1.M_ones
spneumoniae-pangenome	pseudosimplitigs	7	1	runs	8192	8576	8570	6	1	1524	108	1632	1532	spneumoniae-pangenome.S_pseudosimplitigs.k_7.d_1.M_runs
spneumoniae-pangenome	pseudosimplitigs	7	1	zeros	8192	8576	8192	384	101	1524	280	1804	1792	spneumoniae-pangenome.S_pseudosimplitigs.k_7.d_1.M_zeros
spneumoniae-pangenome	pseudosimplitigs	7	2	default	8192	8399	8192	207	67	1440	208	1648	1616	spneumoniae-pangenome.S_pseudosimplitigs.k_7.d_2.M_default
spneumoniae-pangenome	pseudosimplitigs	7	2	ones	8192	8399	8393	6	1	1440	108	1548	1444	spneumoniae-pangenome.S_pseudosimplitigs.k_7.d_2.M_ones
spneumoniae-pangenome	pseudosimplitigs	7	2	runs	8192	8399	8393	6	1	1440	108	1548	1444	spneumoniae-pangenome.S_pseudosimplitigs.k_7.d_2.M_runs
spneumoniae-pangenome	pseudosimplitigs	7	2	zeros	8192	8399	8192	207	63	1440	224	1664	1592	spneumoniae-pangenome.S_pseudosimplitigs.k_7.d_2.M_zeros
spneumoniae-pangenome	pseudosimplitigs	7	3	default	8192	8377	8192	185	105	1468	252	1720	1480	spneumoniae-pangenome.S_pseudosimplitigs.k_7.d_3.M_default
spneumoniae-pangenome	pseudosimplitigs	7	3	ones	8192	8377	8371	6	1	1468	108	1576	1472	spneumoniae-pangenome.S_pseudosimplitigs.k_7.d_3.M_ones
spneumoniae-pangenome	pseudosimplitigs	7	3	runs	8192	8377	8371	6	1	1468	108	1576	1472	spneumoniae-pangenome.S_pseudosimplitigs.k_7.d_3.M_runs
spneumoniae-pangenome	pseudosimplitigs	7	3	zeros	8192	8377	8192	185	88	1468	268	1736	1468	spneumoniae-pangenome.S_pseudosimplitigs.k_7.d_3.M_zeros
spneumoniae-pangenome	pseudosimplitigs	7	4	default	8192	8365	8192	173	110	1476	260	1736	1464	spneumoniae-pangenome.S_pseudosimplitigs.k_7.d_4.M_default
spneumoniae-pangenome	pseudosimplitigs	7	4	ones	8192	8365	8359	6	1	1476	108	1584	1484	spneumoniae-pangenome.S_pseudosimplitigs.k_7.d_4.M_ones
spneumoniae-pangenome	pseudosimplitigs	7	4	runs	8192	8365	8359	6	1	1476	108	1584	1484	spneumoniae-pangenome.S_pseudosimplitigs.k_7.d_4.M_runs
spneumoniae-pangenome	pseudosimplitigs	7	4	zeros	8192	8365	8192	173	92	1476	284	1760	1436	spneumoniae-pangenome.S_pseudosimplitigs.k_7.d_4.M_zeros
spneumoniae-pangenome	pseudosimplitigs	7	5	default	8192	8373	8192	181	113	1476	260	1736	1468	spneumoniae-pangenome.S_pseudosimplitigs.k_7.d_5.M_default
spneumoniae-pangenome	pseudosimplitigs	7	5	ones	8192	8373	8367	6	1	1476	108	1584	1484	spneumoniae-pangenome.S_pseudosimplitigs.k_7.d_5.M_ones
spneumoniae-pangenome	pseudosimplitigs	7	5	runs	8192	8373	8367	6	1	1476	108	1584	1484	spneumoniae-pangenome.S_pseudosimplitigs.k_7.d_5.M_runs
spneumoniae-pangenome	pseudosimplitigs	7	5	zeros	8192	8373	8192	181	95	1476	284	1760	1440	spneumoniae-pangenome.S_pseudosimplitigs.k_7.d_5.M_zeros
spneumoniae-pangenome	pseudosimplitigs	7	6	default	8192	8373	8192	181	113	1476	260	1736	1468	spneumoniae-pangenome.S_pseudosimplitigs.k_7.d_6.M_default
spneumoniae-pangenome	pseudosimplitigs	7	6	ones	8192	8373	8367	6	1	1476	108	1584	1484	spneumoniae-pangenome.S_pseudosimplitigs.k_7.d_6.M_ones
spneumoniae-pangenome	pseudosimplitigs	7	6	runs	8192	8373	8367	6	1	1476	108	1584	1484	spneumoniae-pangenome.S_pseudosimplitigs.k_7.d_6.M_runs
spneumoniae-pangenome	pseudosimplitigs	7	6	zeros	8192	8373	8192	181	95	1476	284	1760	1440	spneumoniae-pangenome.S_pseudosimplitigs.k_7.d_6.M_zeros
spneumoniae-pangenome	pseudosimplitigsAC	7	1	default	8192	8228	8192	36	6	2636	120	2756	2664	spneumoniae-pangenome.S_pseudosimplitigsAC.k_7.d_1.M_default
spneumoniae-pangenome	pseudosimplitigsAC	7	1	ones	8192	8228	8222	6	1	2636	108	2744	2640	spneumoniae-pangenome.S_pseudosimplitigsAC.k_7.d_1.M_ones
spneumoniae-pangenome	pseudosimplitigsAC	7	1	runs	8192	8228	8222	6	1	2636	108	2744	2640	spneumoniae-pangenome.S_pseudosimplitigsAC.k_7.d_1.M_runs
spneumoniae-pangenome	pseudosimplitigsAC	7	1	zeros	8192	8228	8192	36	11	2636	136	2772	2664	spneumoniae-pangenome.S_pseudosimplitigsAC.k_7.d_1.M_zeros
spneumoniae-pangenome	pseudosimplitigsAC	7	2	default	8192	8218	8192	26	6	2628	124	2752	2640	spneumoniae-pangenome.S_pseudosimplitigsAC.k_7.d_2.M_default
spneumoniae-pangenome	pseudosimplitigsAC	7	2	ones	8192	8218	8212	6	1	2628	108	2736	2632	spneumoniae-pangenome.S_pseudosimplitigsAC.k_7.d_2.M_ones
spneumoniae-pangenome	pseudosimplitigsAC	7	2	runs	8192	8218	8212	6	1	2628	108	2736	2632	spneumoniae-pangenome.S_pseudosimplitigsAC.k_7.d_2.M_runs
spneumoniae-pangenome	pseudosimplitigsAC	7	2	zeros	8192	8218	8192	26	6	2628	124	2752	2640	spneumoniae-pangenome.S_pseudosimplitigsAC.k_7.d_2.M_zeros
spneumoniae-pangenome	pseudosimplitigsAC	7	3	default	8192	8214	8192	22	6	2628	124	2752	2636	spneumoniae-pangenome.S_pseudosimplitigsAC.k_7.d_3.M_default
spneumoniae-pangenome	pseudosimplitigsAC	7	3	ones	8192	8214	8208	6	1	2628	108	2736	2628	spneumoniae-pangenome.S_pseudosimplitigsAC.k_7.d_3.M_ones
spneumoniae-pangenome	pseudosimplitigsAC	7	3	runs	8192	8214	8208	6	1	2628	108	2736	2628	spneumoniae-pangenome.S_pseudosimplitigsAC.k_7.d_3.M_runs
spneumoniae-pangenome	pseudosimplitigsAC	7	3	zeros	8192	8214	8192	22	6	2628	124	2752	2636	spneumoniae-pangenome.S_pseudosimplitigsAC.k_7.d_3.M_zeros
spneumoniae-pangenome	pseudosimplitigsAC	7	4	default	8192	8214	8192	22	6	2628	124	2752	2636	spneumoniae-pangenome.S_pseudosimplitigsAC.k_7.d_4.M_default
spneumoniae-pangenome	pseudosimplitigsAC	7	4	ones	8192	8214	8208	6	1	2628	108	2736	2628	spneumoniae-pangenome.S_pseudosimplitigsAC.k_7.d_4.M_ones
spneumoniae-pangenome	pseudosimplitigsAC	7	4	runs	8192	8214	8208	6	1	2628	108	2736	2628	spneumoniae-pangenome.S_pseudosimplitigsAC.k_7.d_4.M_runs
spneumoniae-pangenome	pseudosimplitigsAC	7	4	zeros	8192	8214	8192	22	6	2628	124	2752	2636	spneumoniae-pangenome.S_pseudosimplitigsAC.k_7.d_4.M_zeros
spneumoniae-pangenome	pseudosimplitigsAC	7	5	default	8192	8212	8192	20	6	2628	124	2752	2636	spneumoniae-pangenome.S_pseudosimplitigsAC.k_7.d_5.M_default
spneumoniae-pangenome	pseudosimplitigsAC	7	5	ones	8192	8212	8206	6	1	2628	108	2736	2632	spneumoniae-pangenome.S_pseudosimplitigsAC.k_7.d_5.M_ones
spneumoniae-pangenome	pseudosimplitigsAC	7	5	runs	8192	8212	8206	6	1	2628	108	2736	2632	spneumoniae-pangenome.S_pseudosimplitigsAC.k_7.d_5.M_runs
spneumoniae-pangenome	pseudosimplitigsAC	7	5	zeros	8192	8212	8192	20	6	2628	124	2752	2636	spneumoniae-pangenome.S_pseudosimplitigsAC.k_7.d_5.M_zeros
spneumoniae-pangenome	pseudosimplitigsAC	7	6	default	8192	8211	8192	19	6	2628	124	2752	2636	spneumoniae-pangenome.S_pseudosimplitigsAC.k_7.d_6.M_default
spneumoniae-pangenome	pseudosimplitigsAC	7	6	ones	8192	8211	8205	6	1	2628	108	2736	2628	spneumoniae-pangenome.S_pseudosimplitigsAC.k_7.d_6.M_ones
spneumoniae-pangenome	pseudosimplitigsAC	7	6	runs	8192	8211	8205	6	1	2628	108	2736	2628	spneumoniae-pangenome.S_pseudosimplitigsAC.k_7.d_6.M_runs
spneumoniae-pangenome	pseudosimplitigsAC	7	6	zeros	8192	8211	8192	19	6	2628	124	2752	2636	spneumoniae-pangenome.S_pseudosimplitigsAC.k_7.d_6.M_zeros
spneumoniae-pangenome	pseudosimplitigs	8	1	default	32894	35169	32894	2275	325	4580	556	5136	5460	spneumoniae-pangenome.S_pseudosimplitigs.k_8.d_1.M_default
spneumoniae-pangenome	pseudosimplitigs	8	1	ones	32894	35169	35160	9	3	4580	144	4724	4584	spneumoniae-pangenome.S_pseudosimplitigs.k_8.d_1.M_ones
spneumoniae-pangenome	pseudosimplitigs	8	1	runs	32894	35169	35160	9	3	4580	144	4724	4584	spneumoniae-pangenome.S_pseudosimplitigs.k_8.d_1.M_runs
spneumoniae-pangenome	pseudosimplitigs	8	1	zeros	32894	35169	32894	2275	559	4580	976	5556	5704	spneumoniae-pangenome.S_pseudosimplitigs.k_8.d_1.M_zeros
spneumoniae-pangenome	pseudosimplitigs	8	2	default	32894	34436	32894	1542	450	4328	760	5088	5228	spneumoniae-pangenome.S_pseudosimplitigs.k_8.d_2.M_default
spneumoniae-pangenome	pseudosimplitigs	8	2	ones	32894	34436	34428	8	2	4328	140	4468	4332	spneumoniae-pangenome.S_pseudosimplitigs.k_8.d_2.M_ones
spneumoniae-pangenome	pseudosimplitigs	8	2	runs	32894	34436	34428	8	2	4328	140	4468	4332	spneumoniae-pangenome.S_pseudosimplitigs.k_8.d_2.M_runs
spneumoniae-pangenome	pseudosimplitigs	8	2	zeros	32894	34436	32894	1542	486	4328	868	5196	5212	spneumoniae-pangenome.S_pseudosimplitigs.k_8.d_2.M_zeros
spneumoniae-pangenome	pseudosimplitigs	8	3	default	32894	34474	32894	1580	903	4688	1144	5832	5920	spneumoniae-pangenome.S_pseudosimplitigs.k_8.d_3.M_default
spneumoniae-pangenome	pseudosimplitigs	8	3	ones	32894	34474	34465	9	3	4688	140	4828	4692	spneumoniae-pangenome.S_pseudosimplitigs.k_8.d_3.M_ones
spneumoniae-pangenome	pseudosimplitigs	8	3	runs	32894	34474	34465	9	3	4688	140	4828	4692	spneumoniae-pangenome.S_pseudosimplitigs.k_8.d_3.M_runs
spneumoniae-pangenome	pseudosimplitigs	8	3	zeros	32894	34474	32894	1580	842	4688	1136	5824	5832	spneumoniae-pangenome.S_pseudosimplitigs.k_8.d_3.M_zeros
spneumoniae-pangenome	pseudosimplitigs	8	4	default	32894	34659	32894	1765	1206	4628	1360	5988	6308	spneumoniae-pangenome.S_pseudosimplitigs.k_8.d_4.M_default
spneumoniae-pangenome	pseudosimplitigs	8	4	ones	32894	34659	34650	9	3	4628	144	4772	4636	spneumoniae-pangenome.S_pseudosimplitigs.k_8.d_4.M_ones
spneumoniae-pangenome	pseudosimplitigs	8	4	runs	32894	34659	34650	9	3	4628	144	4772	4636	spneumoniae-pangenome.S_pseudosimplitigs.k_8.d_4.M_runs
spneumoniae-pangenome	pseudosimplitigs	8	4	zeros	32894	34659	32894	1765	1189	4628	1384	6012	6284	spneumoniae-pangenome.S_pseudosimplitigs.k_8.d_4.M_zeros
spneumoniae-pangenome	pseudosimplitigs	8	5	default	32894	34849	32894	1955	1389	4760	1432	6192	6300	spneumoniae-pangenome.S_pseudosimplitigs.k_8.d_5.M_default
spneumoniae-pangenome	pseudosimplitigs	8	5	ones	32894	34849	34839	10	4	4760	144	4904	4772	spneumoniae-pangenome.S_pseudosimplitigs.k_8.d_5.M_ones
spneumoniae-pangenome	pseudosimplitigs	8	5	runs	32894	34849	34839	10	4	4760	144	4904	4772	spneumoniae-pangenome.S_pseudosimplitigs.k_8.d_5.M_runs
spneumoniae-pangenome	pseudosimplitigs	8	5	zeros	32894	34849	32894	1955	1393	4760	1444	6204	6588	spneumoniae-pangenome.S_pseudosimplitigs.k_8.d_5.M_zeros
spneumoniae-pangenome	pseudosimplitigs	8	6	default	32894	34844	32894	1950	1386	4908	1432	6340	6304	spneumoniae-pangenome.S_pseudosimplitigs.k_8.d_6.M_default
spneumoniae-pangenome	pseudosimplitigs	8	6	ones	32894	34844	34836	8	2	4908	140	5048	4912	spneumoniae-pangenome.S_pseudosimplitigs.k_8.d_6.M_ones
spneumoniae-pangenome	pseudosimplitigs	8	6	runs	32894	34844	34836	8	2	4908	140	5048	4912	spneumoniae-pangenome.S_pseudosimplitigs.k_8.d_6.M_runs
spneumoniae-pangenome	pseudosimplitigs	8	6	zeros	32894	34844	32894	1950	1403	4908	1456	6364	6668	spneumoniae-pangenome.S_pseudosimplitigs.k_8.d_6.M_zeros
spneumoniae-pangenome	pseudosimplitigs	8	7	default	32894	34842	32894	1948	1387	4848	1432	6280	6396	spneumoniae-pangenome.S_pseudosimplitigs.k_8.d_7.M_default
spneumoniae-pangenome	pseudosimplitigs	8	7	ones	32894	34842	34834	8	2	4848	140	4988	4856	spneumoniae-pangenome.S_pseudosimplitigs.k_8.d_7.M_ones
spneumoniae-pangenome	pseudosimplitigs	8	7	runs	32894	34842	34834	8	2	4848	140	4988	4856	spneumoniae-pangenome.S_pseudosimplitigs.k_8.d_7.M_runs
spneumoniae-pangenome	pseudosimplitigs	8	7	zeros	32894	34842	32894	1948	1407	4848	1456	6304	6688	spneumoniae-pangenome.S_pseudosimplitigs.k_8.d_7.M_zeros
spneumoniae-pangenome	pseudosimplitigsAC	8	1	default	32894	33804	32894	910	130	9832	308	10140	10100	spneumoniae-pangenome.S_pseudosimplitigsAC.k_8.d_1.M_default
spneumoniae-pangenome	pseudosimplitigsAC	8	1	ones	32894	33804	33795	9	3	9832	144	9976	9836	spneumoniae-pangenome.S_pseudosimplitigsAC.k_8.d_1.M_ones
spneumoniae-pangenome	pseudosimplitigsAC	8	1	runs	32894	33804	33795	9	3	9832	144	9976	9836	spneumoniae-pangenome.S_pseudosimplitigsAC.k_8.d_1.M_runs
spneumoniae-pangenome	pseudosimplitigsAC	8	1	zeros	32894	33804	32894	910	167	9832	412	10244	10140	spneumoniae-pangenome.S_pseudosimplitigsAC.k_8.d_1.M_zeros
spneumoniae-pangenome	pseudosimplitigsAC	8	2	default	32894	33813	32894	919	211	9832	480	10312	10272	spneumoniae-pangenome.S_pseudosimplitigsAC.k_8.d_2.M_default
spneumoniae-pangenome	pseudosimplitigsAC	8	2	ones	32894	33813	33805	8	2	9832	140	9972	9840	spneumoniae-pangenome.S_pseudosimplitigsAC.k_8.d_2.M_ones
spneumoniae-pangenome	pseudosimplitigsAC	8	2	runs	32894	33813	33805	8	2	9832	140	9972	9840	spneumoniae-pangenome.S_pseudosimplitigsAC.k_8.d_2.M_runs
spneumoniae-pangenome	pseudosimplitigsAC	8	2	zeros	32894	33813	32894	919	213	9832	488	10320	10216	spneumoniae-pangenome.S_pseudosimplitigsAC.k_8.d_2.M_zeros
spneumoniae-pangenome	pseudosimplitigsAC	8	3	default	32894	33738	32894	844	271	9804	580	10384	10320	spneumoniae-pangenome.S_pseudosimplitigsAC.k_8.d_3.M_default
spneumoniae-pangenome	pseudosimplitigsAC	8	3	ones	32894	33738	33730	8	2	9804	140	9944	9808	spneumoniae-pangenome.S_pseudosimplitigsAC.k_8.d_3.M_ones
spneumoniae-pangenome	pseudosimplitigsAC	8	3	runs	32894	33738	33730	8	2	9804	140	9944	9808	spneumoniae-pangenome.S_pseudosimplitigsAC.k_8.d_3.M_runs
spneumoniae-pangenome	pseudosimplitigsAC	8	3	zeros	32894	33738	32894	844	277	9804	600	10404	10264	spneumoniae-pangenome.S_pseudosimplitigsAC.k_8.d_3.M_zeros
spneumoniae-pangenome	pseudosimplitigsAC	8	4	default	32894	33657	32894	763	306	9772	624	10396	10356	spneumoniae-pangenome.S_pseudosimplitigsAC.k_8.d_4.M_default
spneumoniae-pangenome	pseudosimplitigsAC	8	4	ones	32894	33657	33649	8	2	9772	140	9912	9776	spneumoniae-pangenome.S_pseudosimplitigsAC.k_8.d_4.M_ones
spneumoniae-pangenome	pseudosimplitigsAC	8	4	runs	32894	33657	33649	8	2	9772	140	9912	9776	spneumoniae-pangenome.S_pseudosimplitigsAC.k_8.d_4.M_runs
spneumoniae-pangenome	pseudosimplitigsAC	8	4	zeros	32894	33657	32894	763	313	9772	648	10420	10244	spneumoniae-pangenome.S_pseudosimplitigsAC.k_8.d_4.M_zeros
spneumoniae-pangenome	pseudosimplitigsAC	8	5	default	32894	33614	32894	720	309	9724	624	10348	10292	spneumoniae-pangenome.S_pseudosimplitigsAC.k_8.d_5.M_default
spneumoniae-pangenome	pseudosimplitigsAC	8	5	ones	32894	33614	33606	8	2	9724	140	9864	9732	spneumoniae-pangenome.S_pseudosimplitigsAC.k_8.d_5.M_ones
spneumoniae-pangenome	pseudosimplitigsAC	8	5	runs	32894	33614	33606	8	2	9724	140	9864	9732	spneumoniae-pangenome.S_pseudosimplitigsAC.k_8.d_5.M_runs
spneumoniae-pangenome	pseudosimplitigsAC	8	5	zeros	32894	33614	32894	720	320	9724	664	10388	10252	spneumoniae-pangenome.S_pseudosimplitigsAC.k_8.d_5.M_zeros
spneumoniae-pangenome	pseudosimplitigsAC	8	6	default	32894	33631	32894	737	316	9756	628	10384	10268	spneumoniae-pangenome.S_pseudosimplitigsAC.k_8.d_6.M_default
spneumoniae-pangenome	pseudosimplitigsAC	8	6	ones	32894	33631	33623	8	2	9756	140	9896	9768	spneumoniae-pangenome.S_pseudosimplitigsAC.k_8.d_6.M_ones
spneumoniae-pangenome	pseudosimplitigsAC	8	6	runs	32894	33631	33623	8	2	9756	140	9896	9768	spneumoniae-pangenome.S_pseudosimplitigsAC.k_8.d_6.M_runs
spneumoniae-pangenome	pseudosimplitigsAC	8	6	zeros	32894	33631	32894	737	330	9756	676	10432	10268	spneumoniae-pangenome.S_pseudosimplitigsAC.k_8.d_6.M_zeros
spneumoniae-pangenome	pseudosimplitigsAC	8	7	default	32894	33628	32894	734	316	9732	632	10364	10260	spneumoniae-pangenome.S_pseudosimplitigsAC.k_8.d_7.M_default
spneumoniae-pangenome	pseudosimplitigsAC	8	7	ones	32894	33628	33620	8	2	9732	140	9872	9740	spneumoniae-pangenome.S_pseudosimplitigsAC.k_8.d_7.M_ones
spneumoniae-pangenome	pseudosimplitigsAC	8	7	runs	32894	33628	33620	8	2	9732	140	9872	9740	spneumoniae-pangenome.S_pseudosimplitigsAC.k_8.d_7.M_runs
spneumoniae-pangenome	pseudosimplitigsAC	8	7	zeros	32894	33628	32894	734	333	9732	688	10420	10264	spneumoniae-pangenome.S_pseudosimplitigsAC.k_8.d_7.M_zeros
spneumoniae-pangenome	pseudosimplitigs	9	1	default	130556	138044	130556	7488	936	16676	1428	18104	19548	spneumoniae-pangenome.S_pseudosimplitigs.k_9.d_1.M_default
spneumoniae-pangenome	pseudosimplitigs	9	1	ones	130556	138044	137636	408	309	16676	848	17524	17156	spneumoniae-pangenome.S_pseudosimplitigs.k_9.d_1.M_ones
spneumoniae-pangenome	pseudosimplitigs	9	1	runs	130556	138044	137374	670	215	16676	808	17484	17104	spneumoniae-pangenome.S_pseudosimplitigs.k_9.d_1.M_runs
spneumoniae-pangenome	pseudosimplitigs	9	1	zeros	130556	138044	130556	7488	1633	16676	2748	19424	20396	spneumoniae-pangenome.S_pseudosimplitigs.k_9.d_1.M_zeros
spneumoniae-pangenome	pseudosimplitigs	9	2	default	130556	134762	130556	4206	1392	16116	2224	18340	18948	spneumoniae-pangenome.S_pseudosimplitigs.k_9.d_2.M_default
spneumoniae-pangenome	pseudosimplitigs	9	2	ones	130556	134762	134466	296	268	16116	840	16956	16512	spneumoniae-pangenome.S_pseudosimplitigs.k_9.d_2.M_ones
spneumoniae-pangenome	pseudosimplitigs	9	2	runs	130556	134762	134427	335	246	16116	836	16952	16500	spneumoniae-pangenome.S_pseudosimplitigs.k_9.d_2.M_runs
spneumoniae-pangenome	pseudosimplitigs	9	2	zeros	130556	134762	130556	4206	1404	16116	2384	18500	18804	spneumoniae-pangenome.S_pseudosimplitigs.k_9.d_2.M_zeros
spneumoniae-pangenome	pseudosimplitigs	9	3	default	130556	135412	130556	4856	3113	16468	3636	20104	20016	spneumoniae-pangenome.S_pseudosimplitigs.k_9.d_3.M_default
spneumoniae-pangenome	pseudosimplitigs	9	3	ones	130556	135412	135135	277	247	16468	768	17236	16904	spneumoniae-pangenome.S_pseudosimplitigs.k_9.d_3.M_ones
spneumoniae-pangenome	pseudosimplitigs	9	3	runs	130556	135412	135118	294	240	16468	772	17240	16904	spneumoniae-pangenome.S_pseudosimplitigs.k_9.d_3.M_runs
spneumoniae-pangenome	pseudosimplitigs	9	3	zeros	130556	135412	130556	4856	2983	16468	3640	20108	20076	spneumoniae-pangenome.S_pseudosimplitigs.k_9.d_3.M_zeros
spneumoniae-pangenome	pseudosimplitigs	9	4	default	130556	136268	130556	5712	4152	16684	4260	20944	21380	spneumoniae-pangenome.S_pseudosimplitigs.k_9.d_4.M_default
spneumoniae-pangenome	pseudosimplitigs	9	4	ones	130556	136268	136014	254	216	16684	692	17376	17144	spneumoniae-pangenome.S_pseudosimplitigs.k_9.d_4.M_ones
spneumoniae-pangenome	pseudosimplitigs	9	4	runs	130556	136268	135995	273	206	16684	688	17372	17152	spneumoniae-pangenome.S_pseudosimplitigs.k_9.d_4.M_runs
spneumoniae-pangenome	pseudosimplitigs	9	4	zeros	130556	136268	130556	5712	4137	16684	4268	20952	21428	spneumoniae-pangenome.S_pseudosimplitigs.k_9.d_4.M_zeros
spneumoniae-pangenome	pseudosimplitigs	9	5	default	130556	136248	130556	5692	4168	15868	4284	20152	21608	spneumoniae-pangenome.S_pseudosimplitigs.k_9.d_5.M_default
spneumoniae-pangenome	pseudosimplitigs	9	5	ones	130556	136248	136016	232	203	15868	680	16548	16088	spneumoniae-pangenome.S_pseudosimplitigs.k_9.d_5.M_ones
spneumoniae-pangenome	pseudosimplitigs	9	5	runs	130556	136248	136014	234	201	15868	672	16540	16124	spneumoniae-pangenome.S_pseudosimplitigs.k_9.d_5.M_runs
spneumoniae-pangenome	pseudosimplitigs	9	5	zeros	130556	136248	130556	5692	4236	15868	4468	20336	21408	spneumoniae-pangenome.S_pseudosimplitigs.k_9.d_5.M_zeros
spneumoniae-pangenome	pseudosimplitigs	9	6	default	130556	136229	130556	5673	4176	15864	4300	20164	21612	spneumoniae-pangenome.S_pseudosimplitigs.k_9.d_6.M_default
spneumoniae-pangenome	pseudosimplitigs	9	6	ones	130556	136229	135991	238	207	15864	684	16548	16084	spneumoniae-pangenome.S_pseudosimplitigs.k_9.d_6.M_ones
spneumoniae-pangenome	pseudosimplitigs	9	6	runs	130556	136229	135978	251	202	15864	684	16548	16088	spneumoniae-pangenome.S_pseudosimplitigs.k_9.d_6.M_runs
spneumoniae-pangenome	pseudosimplitigs	9	6	zeros	130556	136229	130556	5673	4246	15864	4476	20340	21420	spneumoniae-pangenome.S_pseudosimplitigs.k_9.d_6.M_zeros
spneumoniae-pangenome	pseudosimplitigs	9	7	default	130556	136228	130556	5672	4177	15868	4300	20168	21484	spneumoniae-pangenome.S_pseudosimplitigs.k_9.d_7.M_default
spneumoniae-pangenome	pseudosimplitigs	9	7	ones	130556	136228	135991	237	205	15868	684	16552	16040	spneumoniae-pangenome.S_pseudosimplitigs.k_9.d_7.M_ones
spneumoniae-pangenome	pseudosimplitigs	9	7	runs	130556	136228	135984	244	202	15868	684	16552	16040	spneumoniae-pangenome.S_pseudosimplitigs.k_9.d_7.M_runs
spneumoniae-pangenome	pseudosimplitigs	9	7	zeros	130556	136228	130556	5672	4252	15868	4488	20356	21480	spneumoniae-pangenome.S_pseudosimplitigs.k_9.d_7.M_zeros
spneumoniae-pangenome	pseudosimplitigs	9	8	default	130556	136236	130556	5680	4179	15872	4300	20172	21488	spneumoniae-pangenome.S_pseudosimplitigs.k_9.d_8.M_default
spneumoniae-pangenome	pseudosimplitigs	9	8	ones	130556	136236	135995	241	207	15872	684	16556	16044	spneumoniae-pangenome.S_pseudosimplitigs.k_9.d_8.M_ones
spneumoniae-pangenome	pseudosimplitigs	9	8	runs	130556	136236	135984	252	204	15872	684	16556	16048	spneumoniae-pangenome.S_pseudosimplitigs.k_9.d_8.M_runs
spneumoniae-pangenome	pseudosimplitigs	9	8	zeros	130556	136236	130556	5680	4254	15872	4488	20360	21480	spneumoniae-pangenome.S_pseudosimplitigs.k_9.d_8.M_zeros
spneumoniae-pangenome	pseudosimplitigsAC	9	1	default	130556	132932	130556	2376	297	37268	872	38140	37960	spneumoniae-pangenome.S_pseudosimplitigsAC.k_9.d_1.M_default
spneumoniae-pangenome	pseudosimplitigsAC	9	1	ones	130556	132932	132403	529	368	37268	932	38200	37764	spneumoniae-pangenome.S_pseudosimplitigsAC.k_9.d_1.M_ones
spneumoniae-pangenome	pseudosimplitigsAC	9	1	runs	130556	132932	132004	928	224	37268	860	38128	37724	spneumoniae-pangenome.S_pseudosimplitigsAC.k_9.d_1.M_runs
spneumoniae-pangenome	pseudosimplitigsAC	9	1	zeros	130556	132932	130556	2376	493	37268	1252	38520	38100	spneumoniae-pangenome.S_pseudosimplitigsAC.k_9.d_1.M_zeros
spneumoniae-pangenome	pseudosimplitigsAC	9	2	default	130556	131935	130556	1379	497	36980	1260	38240	38100	spneumoniae-pangenome.S_pseudosimplitigsAC.k_9.d_2.M_default
spneumoniae-pangenome	pseudosimplitigsAC	9	2	ones	130556	131935	131640	295	242	36980	808	37788	37608	spneumoniae-pangenome.S_pseudosimplitigsAC.k_9.d_2.M_ones
spneumoniae-pangenome	pseudosimplitigsAC	9	2	runs	130556	131935	131580	355	215	36980	800	37780	37596	spneumoniae-pangenome.S_pseudosimplitigsAC.k_9.d_2.M_runs
spneumoniae-pangenome	pseudosimplitigsAC	9	2	zeros	130556	131935	130556	1379	510	36980	1292	38272	38120	spneumoniae-pangenome.S_pseudosimplitigsAC.k_9.d_2.M_zeros
spneumoniae-pangenome	pseudosimplitigsAC	9	3	default	130556	131834	130556	1278	563	36952	1340	38292	38144	spneumoniae-pangenome.S_pseudosimplitigsAC.k_9.d_3.M_default
spneumoniae-pangenome	pseudosimplitigsAC	9	3	ones	130556	131834	131594	240	210	36952	756	37708	37544	spneumoniae-pangenome.S_pseudosimplitigsAC.k_9.d_3.M_ones
spneumoniae-pangenome	pseudosimplitigsAC	9	3	runs	130556	131834	131587	247	208	36952	756	37708	37548	spneumoniae-pangenome.S_pseudosimplitigsAC.k_9.d_3.M_runs
spneumoniae-pangenome	pseudosimplitigsAC	9	3	zeros	130556	131834	130556	1278	564	36952	1344	38296	38148	spneumoniae-pangenome.S_pseudosimplitigsAC.k_9.d_3.M_zeros
spneumoniae-pangenome	pseudosimplitigsAC	9	4	default	130556	131860	130556	1304	596	36956	1384	38340	38192	spneumoniae-pangenome.S_pseudosimplitigsAC.k_9.d_4.M_default
spneumoniae-pangenome	pseudosimplitigsAC	9	4	ones	130556	131860	131600	260	219	36956	776	37732	37568	spneumoniae-pangenome.S_pseudosimplitigsAC.k_9.d_4.M_ones
spneumoniae-pangenome	pseudosimplitigsAC	9	4	runs	130556	131860	131586	274	212	36956	772	37728	37572	spneumoniae-pangenome.S_pseudosimplitigsAC.k_9.d_4.M_runs
spneumoniae-pangenome	pseudosimplitigsAC	9	4	zeros	130556	131860	130556	1304	595	36956	1392	38348	38204	spneumoniae-pangenome.S_pseudosimplitigsAC.k_9.d_4.M_zeros
spneumoniae-pangenome	pseudosimplitigsAC	9	5	default	130556	131965	130556	1409	646	36992	1448	38440	38380	spneumoniae-pangenome.S_pseudosimplitigsAC.k_9.d_5.M_default
spneumoniae-pangenome	pseudosimplitigsAC	9	5	ones	130556	131965	131713	252	216	36992	772	37764	37504	spneumoniae-pangenome.S_pseudosimplitigsAC.k_9.d_5.M_ones
spneumoniae-pangenome	pseudosimplitigsAC	9	5	runs	130556	131965	131699	266	210	36992	776	37768	37512	spneumoniae-pangenome.S_pseudosimplitigsAC.k_9.d_5.M_runs
spneumoniae-pangenome	pseudosimplitigsAC	9	5	zeros	130556	131965	130556	1409	657	36992	1488	38480	38076	spneumoniae-pangenome.S_pseudosimplitigsAC.k_9.d_5.M_zeros
spneumoniae-pangenome	pseudosimplitigsAC	9	6	default	130556	131996	130556	1440	666	37032	1464	38496	37992	spneumoniae-pangenome.S_pseudosimplitigsAC.k_9.d_6.M_default
spneumoniae-pangenome	pseudosimplitigsAC	9	6	ones	130556	131996	131744	252	215	37032	768	37800	37508	spneumoniae-pangenome.S_pseudosimplitigsAC.k_9.d_6.M_ones
spneumoniae-pangenome	pseudosimplitigsAC	9	6	runs	130556	131996	131739	257	211	37032	768	37800	37508	spneumoniae-pangenome.S_pseudosimplitigsAC.k_9.d_6.M_runs
spneumoniae-pangenome	pseudosimplitigsAC	9	6	zeros	130556	131996	130556	1440	720	37032	1644	38676	38148	spneumoniae-pangenome.S_pseudosimplitigsAC.k_9.d_6.M_zeros
spneumoniae-pangenome	pseudosimplitigsAC	9	7	default	130556	132025	130556	1469	674	37036	1460	38496	37980	spneumoniae-pangenome.S_pseudosimplitigsAC.k_9.d_7.M_default
spneumoniae-pangenome	pseudosimplitigsAC	9	7	ones	130556	132025	131770	255	215	37036	772	37808	37728	spneumoniae-pangenome.S_pseudosimplitigsAC.k_9.d_7.M_ones
spneumoniae-pangenome	pseudosimplitigsAC	9	7	runs	130556	132025	131766	259	212	37036	772	37808	37728	spneumoniae-pangenome.S_pseudosimplitigsAC.k_9.d_7.M_runs
spneumoniae-pangenome	pseudosimplitigsAC	9	7	zeros	130556	132025	130556	1469	735	37036	1648	38684	38164	spneumoniae-pangenome.S_pseudosimplitigsAC.k_9.d_7.M_zeros
spneumoniae-pangenome	pseudosimplitigsAC	9	8	default	130556	132023	130556	1467	674	37032	1468	38500	37980	spneumoniae-pangenome.S_pseudosimplitigsAC.k_9.d_8.M_default
spneumoniae-pangenome	pseudosimplitigsAC	9	8	ones	130556	132023	131770	253	215	37032	768	37800	37724	spneumoniae-pangenome.S_pseudosimplitigsAC.k_9.d_8.M_ones
spneumoniae-pangenome	pseudosimplitigsAC	9	8	runs	130556	132023	131766	257	212	37032	768	37800	37724	spneumoniae-pangenome.S_pseudosimplitigsAC.k_9.d_8.M_runs
spneumoniae-pangenome	pseudosimplitigsAC	9	8	zeros	130556	132023	130556	1467	735	37032	1656	38688	38164	spneumoniae-pangenome.S_pseudosimplitigsAC.k_9.d_8.M_zeros
spneumoniae-pangenome	pseudosimplitigs	10	1	default	496846	593740	496846	96894	10766	109996	12776	122772	127232	spneumoniae-pangenome.S_pseudosimplitigs.k_10.d_1.M_default
spneumoniae-pangenome	pseudosimplitigs	10	1	ones	496846	593740	571360	22380	13875	109996	17112	127108	123444	spneumoniae-pangenome.S_pseudosimplitigs.k_10.d_1.M_ones
spneumoniae-pangenome	pseudosimplitigs	10	1	runs	496846	593740	554798	38942	7733	109996	14572	124568	121784	spneumoniae-pangenome.S_pseudosimplitigs.k_10.d_1.M_runs
spneumoniae-pangenome	pseudosimplitigs	10	1	zeros	496846	593740	496846	96894	17759	109996	22304	132300	133584	spneumoniae-pangenome.S_pseudosimplitigs.k_10.d_1.M_zeros
spneumoniae-pangenome	pseudosimplitigs	10	2	default	496846	550538	496846	53692	17868	93612	18832	112444	113688	spneumoniae-pangenome.S_pseudosimplitigs.k_10.d_2.M_default
spneumoniae-pangenome	pseudosimplitigs	10	2	ones	496846	550538	536779	13759	10293	93612	14480	108092	103984	spneumoniae-pangenome.S_pseudosimplitigs.k_10.d_2.M_ones
spneumoniae-pangenome	pseudosimplitigs	10	2	runs	496846	550538	532705	17833	8465	93612	14076	107688	103652	spneumoniae-pangenome.S_pseudosimplitigs.k_10.d_2.M_runs
spneumoniae-pangenome	pseudosimplitigs	10	2	zeros	496846	550538	496846	53692	18321	93612	19964	113576	113904	spneumoniae-pangenome.S_pseudosimplitigs.k_10.d_2.M_zeros
spneumoniae-pangenome	pseudosimplitigs	10	3	default	496846	540534	496846	43688	20559	90696	21108	111804	111424	spneumoniae-pangenome.S_pseudosimplitigs.k_10.d_3.M_default
spneumoniae-pangenome	pseudosimplitigs	10	3	ones	496846	540534	529059	11475	9114	90696	13268	103964	99676	spneumoniae-pangenome.S_pseudosimplitigs.k_10.d_3.M_ones
spneumoniae-pangenome	pseudosimplitigs	10	3	runs	496846	540534	527284	13250	8262	90696	13132	103828	99776	spneumoniae-pangenome.S_pseudosimplitigs.k_10.d_3.M_runs
spneumoniae-pangenome	pseudosimplitigs	10	3	zeros	496846	540534	496846	43688	20466	90696	21272	111968	111332	spneumoniae-pangenome.S_pseudosimplitigs.k_10.d_3.M_zeros
spneumoniae-pangenome	pseudosimplitigs	10	4	default	496846	538785	496846	41939	22453	89500	22448	111948	111936	spneumoniae-pangenome.S_pseudosimplitigs.k_10.d_4.M_default
spneumoniae-pangenome	pseudosimplitigs	10	4	ones	496846	538785	528148	10637	8632	89500	12688	102188	98496	spneumoniae-pangenome.S_pseudosimplitigs.k_10.d_4.M_ones
spneumoniae-pangenome	pseudosimplitigs	10	4	runs	496846	538785	526950	11835	8034	89500	12644	102144	98272	spneumoniae-pangenome.S_pseudosimplitigs.k_10.d_4.M_runs
spneumoniae-pangenome	pseudosimplitigs	10	4	zeros	496846	538785	496846	41939	22251	89500	22720	112220	112040	spneumoniae-pangenome.S_pseudosimplitigs.k_10.d_4.M_zeros
spneumoniae-pangenome	pseudosimplitigs	10	5	default	496846	537571	496846	40725	22989	89580	23064	112644	112416	spneumoniae-pangenome.S_pseudosimplitigs.k_10.d_5.M_default
spneumoniae-pangenome	pseudosimplitigs	10	5	ones	496846	537571	527309	10262	8481	89580	12740	102320	97992	spneumoniae-pangenome.S_pseudosimplitigs.k_10.d_5.M_ones
spneumoniae-pangenome	pseudosimplitigs	10	5	runs	496846	537571	526491	11080	8031	89580	12720	102300	98296	spneumoniae-pangenome.S_pseudosimplitigs.k_10.d_5.M_runs
spneumoniae-pangenome	pseudosimplitigs	10	5	zeros	496846	537571	496846	40725	23227	89580	24424	114004	114388	spneumoniae-pangenome.S_pseudosimplitigs.k_10.d_5.M_zeros
spneumoniae-pangenome	pseudosimplitigs	10	6	default	496846	537328	496846	40482	23037	89348	23168	112516	112340	spneumoniae-pangenome.S_pseudosimplitigs.k_10.d_6.M_default
spneumoniae-pangenome	pseudosimplitigs	10	6	ones	496846	537328	527292	10036	8367	89348	12776	102124	99372	spneumoniae-pangenome.S_pseudosimplitigs.k_10.d_6.M_ones
spneumoniae-pangenome	pseudosimplitigs	10	6	runs	496846	537328	526623	10705	7981	89348	12800	102148	98724	spneumoniae-pangenome.S_pseudosimplitigs.k_10.d_6.M_runs
spneumoniae-pangenome	pseudosimplitigs	10	6	zeros	496846	537328	496846	40482	24621	89348	26272	115620	118028	spneumoniae-pangenome.S_pseudosimplitigs.k_10.d_6.M_zeros
spneumoniae-pangenome	pseudosimplitigs	10	7	default	496846	537252	496846	40406	23064	89628	23160	112788	112868	spneumoniae-pangenome.S_pseudosimplitigs.k_10.d_7.M_default
spneumoniae-pangenome	pseudosimplitigs	10	7	ones	496846	537252	527092	10160	8418	89628	12832	102460	100624	spneumoniae-pangenome.S_pseudosimplitigs.k_10.d_7.M_ones
spneumoniae-pangenome	pseudosimplitigs	10	7	runs	496846	537252	526425	10827	8025	89628	12776	102404	100792	spneumoniae-pangenome.S_pseudosimplitigs.k_10.d_7.M_runs
spneumoniae-pangenome	pseudosimplitigs	10	7	zeros	496846	537252	496846	40406	24688	89628	26332	115960	119544	spneumoniae-pangenome.S_pseudosimplitigs.k_10.d_7.M_zeros
spneumoniae-pangenome	pseudosimplitigs	10	8	default	496846	537435	496846	40589	23067	89636	23188	112824	112884	spneumoniae-pangenome.S_pseudosimplitigs.k_10.d_8.M_default
spneumoniae-pangenome	pseudosimplitigs	10	8	ones	496846	537435	527324	10111	8375	89636	12816	102452	100632	spneumoniae-pangenome.S_pseudosimplitigs.k_10.d_8.M_ones
spneumoniae-pangenome	pseudosimplitigs	10	8	runs	496846	537435	526704	10731	8006	89636	12808	102444	100232	spneumoniae-pangenome.S_pseudosimplitigs.k_10.d_8.M_runs
spneumoniae-pangenome	pseudosimplitigs	10	8	zeros	496846	537435	496846	40589	24694	89636	26360	115996	119556	spneumoniae-pangenome.S_pseudosimplitigs.k_10.d_8.M_zeros
spneumoniae-pangenome	pseudosimplitigs	10	9	default	496846	537423	496846	40577	23058	89604	23172	112776	112828	spneumoniae-pangenome.S_pseudosimplitigs.k_10.d_9.M_default
spneumoniae-pangenome	pseudosimplitigs	10	9	ones	496846	537423	527284	10139	8390	89604	12828	102432	100624	spneumoniae-pangenome.S_pseudosimplitigs.k_10.d_9.M_ones
spneumoniae-pangenome	pseudosimplitigs	10	9	runs	496846	537423	526641	10782	8000	89604	12728	102332	103416	spneumoniae-pangenome.S_pseudosimplitigs.k_10.d_9.M_runs
spneumoniae-pangenome	pseudosimplitigs	10	9	zeros	496846	537423	496846	40577	24688	89604	26344	115948	119504	spneumoniae-pangenome.S_pseudosimplitigs.k_10.d_9.M_zeros
spneumoniae-pangenome	pseudosimplitigsAC	10	1	default	496846	588205	496846	91359	10151	162904	11800	174704	176348	spneumoniae-pangenome.S_pseudosimplitigsAC.k_10.d_1.M_default
spneumoniae-pangenome	pseudosimplitigsAC	10	1	ones	496846	588205	565109	23096	14188	162904	16880	179784	175400	spneumoniae-pangenome.S_pseudosimplitigsAC.k_10.d_1.M_ones
spneumoniae-pangenome	pseudosimplitigsAC	10	1	runs	496846	588205	547655	40550	7778	162904	14316	177220	173972	spneumoniae-pangenome.S_pseudosimplitigsAC.k_10.d_1.M_runs
spneumoniae-pangenome	pseudosimplitigsAC	10	1	zeros	496846	588205	496846	91359	16834	162904	20392	183296	181348	spneumoniae-pangenome.S_pseudosimplitigsAC.k_10.d_1.M_zeros
spneumoniae-pangenome	pseudosimplitigsAC	10	2	default	496846	548333	496846	51487	16135	152056	16512	168568	168224	spneumoniae-pangenome.S_pseudosimplitigsAC.k_10.d_2.M_default
spneumoniae-pangenome	pseudosimplitigsAC	10	2	ones	496846	548333	535229	13104	9513	152056	12752	164808	161740	spneumoniae-pangenome.S_pseudosimplitigsAC.k_10.d_2.M_ones
spneumoniae-pangenome	pseudosimplitigsAC	10	2	runs	496846	548333	530956	17377	7633	152056	12304	164360	161076	spneumoniae-pangenome.S_pseudosimplitigsAC.k_10.d_2.M_runs
spneumoniae-pangenome	pseudosimplitigsAC	10	2	zeros	496846	548333	496846	51487	16622	152056	17600	169656	168024	spneumoniae-pangenome.S_pseudosimplitigsAC.k_10.d_2.M_zeros
spneumoniae-pangenome	pseudosimplitigsAC	10	3	default	496846	538638	496846	41792	18368	149504	17940	167444	165604	spneumoniae-pangenome.S_pseudosimplitigsAC.k_10.d_3.M_default
spneumoniae-pangenome	pseudosimplitigsAC	10	3	ones	496846	538638	528252	10386	8302	149504	11656	161160	157956	spneumoniae-pangenome.S_pseudosimplitigsAC.k_10.d_3.M_ones
spneumoniae-pangenome	pseudosimplitigsAC	10	3	runs	496846	538638	526664	11974	7552	149504	11532	161036	157172	spneumoniae-pangenome.S_pseudosimplitigsAC.k_10.d_3.M_runs
spneumoniae-pangenome	pseudosimplitigsAC	10	3	zeros	496846	538638	496846	41792	18392	149504	18108	167612	165436	spneumoniae-pangenome.S_pseudosimplitigsAC.k_10.d_3.M_zeros
spneumoniae-pangenome	pseudosimplitigsAC	10	4	default	496846	534356	496846	37510	19199	148372	18496	166868	162612	spneumoniae-pangenome.S_pseudosimplitigsAC.k_10.d_4.M_default
spneumoniae-pangenome	pseudosimplitigsAC	10	4	ones	496846	534356	524891	9465	7810	148372	11248	159620	157428	spneumoniae-pangenome.S_pseudosimplitigsAC.k_10.d_4.M_ones
spneumoniae-pangenome	pseudosimplitigsAC	10	4	runs	496846	534356	524156	10200	7432	148372	11220	159592	157136	spneumoniae-pangenome.S_pseudosimplitigsAC.k_10.d_4.M_runs
spneumoniae-pangenome	pseudosimplitigsAC	10	4	zeros	496846	534356	496846	37510	19254	148372	18772	167144	164392	spneumoniae-pangenome.S_pseudosimplitigsAC.k_10.d_4.M_zeros
spneumoniae-pangenome	pseudosimplitigsAC	10	5	default	496846	532967	496846	36121	19461	147844	18732	166576	163212	spneumoniae-pangenome.S_pseudosimplitigsAC.k_10.d_5.M_default
spneumoniae-pangenome	pseudosimplitigsAC	10	5	ones	496846	532967	523593	9374	7769	147844	11260	159104	156212	spneumoniae-pangenome.S_pseudosimplitigsAC.k_10.d_5.M_ones
spneumoniae-pangenome	pseudosimplitigsAC	10	5	runs	496846	532967	523118	9849	7461	147844	11248	159092	155584	spneumoniae-pangenome.S_pseudosimplitigsAC.k_10.d_5.M_runs
spneumoniae-pangenome	pseudosimplitigsAC	10	5	zeros	496846	532967	496846	36121	19962	147844	20296	168140	165176	spneumoniae-pangenome.S_pseudosimplitigsAC.k_10.d_5.M_zeros
spneumoniae-pangenome	pseudosimplitigsAC	10	6	default	496846	532728	496846	35882	19541	147504	18772	166276	162372	spneumoniae-pangenome.S_pseudosimplitigsAC.k_10.d_6.M_default
spneumoniae-pangenome	pseudosimplitigsAC	10	6	ones	496846	532728	523330	9398	7783	147504	11236	158740	155892	spneumoniae-pangenome.S_pseudosimplitigsAC.k_10.d_6.M_ones
spneumoniae-pangenome	pseudosimplitigsAC	10	6	runs	496846	532728	522864	9864	7477	147504	11240	158744	155152	spneumoniae-pangenome.S_pseudosimplitigsAC.k_10.d_6.M_runs
spneumoniae-pangenome	pseudosimplitigsAC	10	6	zeros	496846	532728	496846	35882	20052	147504	20364	167868	164904	spneumoniae-pangenome.S_pseudosimplitigsAC.k_10.d_6.M_zeros
spneumoniae-pangenome	pseudosimplitigsAC	10	7	default	496846	532780	496846	35934	19566	147508	18816	166324	162340	spneumoniae-pangenome.S_pseudosimplitigsAC.k_10.d_7.M_default
spneumoniae-pangenome	pseudosimplitigsAC	10	7	ones	496846	532780	523332	9448	7810	147508	11256	158764	155916	spneumoniae-pangenome.S_pseudosimplitigsAC.k_10.d_7.M_ones
spneumoniae-pangenome	pseudosimplitigsAC	10	7	runs	496846	532780	522849	9931	7493	147508	11260	158768	156412	spneumoniae-pangenome.S_pseudosimplitigsAC.k_10.d_7.M_runs
spneumoniae-pangenome	pseudosimplitigsAC	10	7	zeros	496846	532780	496846	35934	20076	147508	20412	167920	164848	spneumoniae-pangenome.S_pseudosimplitigsAC.k_10.d_7.M_zeros
spneumoniae-pangenome	pseudosimplitigsAC	10	8	default	496846	532535	496846	35689	19564	147404	18844	166248	162248	spneumoniae-pangenome.S_pseudosimplitigsAC.k_10.d_8.M_default
spneumoniae-pangenome	pseudosimplitigsAC	10	8	ones	496846	532535	523075	9460	7843	147404	11252	158656	155824	spneumoniae-pangenome.S_pseudosimplitigsAC.k_10.d_8.M_ones
spneumoniae-pangenome	pseudosimplitigsAC	10	8	runs	496846	532535	522521	10014	7514	147404	11272	158676	156352	spneumoniae-pangenome.S_pseudosimplitigsAC.k_10.d_8.M_runs
spneumoniae-pangenome	pseudosimplitigsAC	10	8	zeros	496846	532535	496846	35689	20078	147404	20440	167844	164720	spneumoniae-pangenome.S_pseudosimplitigsAC.k_10.d_8.M_zeros
spneumoniae-pangenome	pseudosimplitigsAC	10	9	default	496846	532471	496846	35625	19564	147372	18852	166224	162200	spneumoniae-pangenome.S_pseudosimplitigsAC.k_10.d_9.M_default
spneumoniae-pangenome	pseudosimplitigsAC	10	9	ones	496846	532471	522926	9545	7863	147372	11280	158652	155820	spneumoniae-pangenome.S_pseudosimplitigsAC.k_10.d_9.M_ones
spneumoniae-pangenome	pseudosimplitigsAC	10	9	runs	496846	532471	522407	10064	7536	147372	11284	158656	155808	spneumoniae-pangenome.S_pseudosimplitigsAC.k_10.d_9.M_runs
spneumoniae-pangenome	pseudosimplitigsAC	10	9	zeros	496846	532471	496846	35625	20078	147372	20448	167820	164660	spneumoniae-pangenome.S_pseudosimplitigsAC.k_10.d_9.M_zeros
spneumoniae-pangenome	pseudosimplitigs	11	1	default	1545282	2530002	1545282	984720	98472	626000	80620	706620	744624	spneumoniae-pangenome.S_pseudosimplitigs.k_11.d_1.M_default
spneumoniae-pangenome	pseudosimplitigs	11	1	ones	1545282	2530002	2204790	325212	169401	626000	164512	790512	783568	spneumoniae-pangenome.S_pseudosimplitigs.k_11.d_1.M_ones
spneumoniae-pangenome	pseudosimplitigs	11	1	runs	1545282	2530002	1979180	550822	82978	626000	120432	746432	747364	spneumoniae-pangenome.S_pseudosimplitigs.k_11.d_1.M_runs
spneumoniae-pangenome	pseudosimplitigs	11	1	zeros	1545282	2530002	1545282	984720	157325	626000	155684	781684	799660	spneumoniae-pangenome.S_pseudosimplitigs.k_11.d_1.M_zeros
spneumoniae-pangenome	pseudosimplitigs	11	10	default	1545282	1851219	1545282	305937	175601	438848	127384	566232	551920	spneumoniae-pangenome.S_pseudosimplitigs.k_11.d_10.M_default
spneumoniae-pangenome	pseudosimplitigs	11	10	ones	1545282	1851219	1731242	119977	92766	438848	92352	531200	518248	spneumoniae-pangenome.S_pseudosimplitigs.k_11.d_10.M_ones
spneumoniae-pangenome	pseudosimplitigs	11	10	runs	1545282	1851219	1723024	128195	87641	438848	92060	530908	518580	spneumoniae-pangenome.S_pseudosimplitigs.k_11.d_10.M_runs
spneumoniae-pangenome	pseudosimplitigs	11	10	zeros	1545282	1851219	1545282	305937	176141	438848	129100	567948	555744	spneumoniae-pangenome.S_pseudosimplitigs.k_11.d_10.M_zeros
spneumoniae-pangenome	pseudosimplitigs	11	2	default	1545282	2059340	1545282	514058	153302	495592	111680	607272	619680	spneumoniae-pangenome.S_pseudosimplitigs.k_11.d_2.M_default
spneumoniae-pangenome	pseudosimplitigs	11	2	ones	1545282	2059340	1866427	192913	119523	495592	116112	611704	599964	spneumoniae-pangenome.S_pseudosimplitigs.k_11.d_2.M_ones
spneumoniae-pangenome	pseudosimplitigs	11	2	runs	1545282	2059340	1789977	269363	86168	495592	102668	598260	590656	spneumoniae-pangenome.S_pseudosimplitigs.k_11.d_2.M_runs
spneumoniae-pangenome	pseudosimplitigs	11	2	zeros	1545282	2059340	1545282	514058	158131	495592	121992	617584	624280	spneumoniae-pangenome.S_pseudosimplitigs.k_11.d_2.M_zeros
spneumoniae-pangenome	pseudosimplitigs	11	3	default	1545282	1919635	1545282	374353	165165	459344	119444	578788	579452	spneumoniae-pangenome.S_pseudosimplitigs.k_11.d_3.M_default
spneumoniae-pangenome	pseudosimplitigs	11	3	ones	1545282	1919635	1769784	149851	104318	459344	101944	561288	550496	spneumoniae-pangenome.S_pseudosimplitigs.k_11.d_3.M_ones
spneumoniae-pangenome	pseudosimplitigs	11	3	runs	1545282	1919635	1737904	181731	89374	459344	97420	556764	547852	spneumoniae-pangenome.S_pseudosimplitigs.k_11.d_3.M_runs
spneumoniae-pangenome	pseudosimplitigs	11	3	zeros	1545282	1919635	1545282	374353	165407	459344	121476	580820	580436	spneumoniae-pangenome.S_pseudosimplitigs.k_11.d_3.M_zeros
spneumoniae-pangenome	pseudosimplitigs	11	4	default	1545282	1871300	1545282	326018	168190	445056	122168	567224	561780	spneumoniae-pangenome.S_pseudosimplitigs.k_11.d_4.M_default
spneumoniae-pangenome	pseudosimplitigs	11	4	ones	1545282	1871300	1738949	132351	97745	445056	96028	541084	529732	spneumoniae-pangenome.S_pseudosimplitigs.k_11.d_4.M_ones
spneumoniae-pangenome	pseudosimplitigs	11	4	runs	1545282	1871300	1721542	149758	88983	445056	94112	539168	529408	spneumoniae-pangenome.S_pseudosimplitigs.k_11.d_4.M_runs
spneumoniae-pangenome	pseudosimplitigs	11	4	zeros	1545282	1871300	1545282	326018	168202	445056	123288	568344	564484	spneumoniae-pangenome.S_pseudosimplitigs.k_11.d_4.M_zeros
spneumoniae-pangenome	pseudosimplitigs	11	5	default	1545282	1857585	1545282	312303	173375	439208	125388	564596	556252	spneumoniae-pangenome.S_pseudosimplitigs.k_11.d_5.M_default
spneumoniae-pangenome	pseudosimplitigs	11	5	ones	1545282	1857585	1733256	124329	93803	439208	93292	532500	523404	spneumoniae-pangenome.S_pseudosimplitigs.k_11.d_5.M_ones
spneumoniae-pangenome	pseudosimplitigs	11	5	runs	1545282	1857585	1721833	135752	87332	439208	92276	531484	521552	spneumoniae-pangenome.S_pseudosimplitigs.k_11.d_5.M_runs
spneumoniae-pangenome	pseudosimplitigs	11	5	zeros	1545282	1857585	1545282	312303	173408	439208	126516	565724	560784	spneumoniae-pangenome.S_pseudosimplitigs.k_11.d_5.M_zeros
spneumoniae-pangenome	pseudosimplitigs	11	6	default	1545282	1852715	1545282	307433	175548	437268	126676	563944	553876	spneumoniae-pangenome.S_pseudosimplitigs.k_11.d_6.M_default
spneumoniae-pangenome	pseudosimplitigs	11	6	ones	1545282	1852715	1731476	121239	93157	437268	92416	529684	520396	spneumoniae-pangenome.S_pseudosimplitigs.k_11.d_6.M_ones
spneumoniae-pangenome	pseudosimplitigs	11	6	runs	1545282	1852715	1722369	130346	87661	437268	92032	529300	519500	spneumoniae-pangenome.S_pseudosimplitigs.k_11.d_6.M_runs
spneumoniae-pangenome	pseudosimplitigs	11	6	zeros	1545282	1852715	1545282	307433	175754	437268	127720	564988	558244	spneumoniae-pangenome.S_pseudosimplitigs.k_11.d_6.M_zeros
spneumoniae-pangenome	pseudosimplitigs	11	7	default	1545282	1851379	1545282	306097	175704	439488	126932	566420	553372	spneumoniae-pangenome.S_pseudosimplitigs.k_11.d_7.M_default
spneumoniae-pangenome	pseudosimplitigs	11	7	ones	1545282	1851379	1730812	120567	92834	439488	92412	531900	518876	spneumoniae-pangenome.S_pseudosimplitigs.k_11.d_7.M_ones
spneumoniae-pangenome	pseudosimplitigs	11	7	runs	1545282	1851379	1722444	128935	87673	439488	92244	531732	518356	spneumoniae-pangenome.S_pseudosimplitigs.k_11.d_7.M_runs
spneumoniae-pangenome	pseudosimplitigs	11	7	zeros	1545282	1851379	1545282	306097	176237	439488	128620	568108	557160	spneumoniae-pangenome.S_pseudosimplitigs.k_11.d_7.M_zeros
spneumoniae-pangenome	pseudosimplitigs	11	8	default	1545282	1850656	1545282	305374	175695	439120	127160	566280	552704	spneumoniae-pangenome.S_pseudosimplitigs.k_11.d_8.M_default
spneumoniae-pangenome	pseudosimplitigs	11	8	ones	1545282	1850656	1730319	120337	92689	439120	92344	531464	518372	spneumoniae-pangenome.S_pseudosimplitigs.k_11.d_8.M_ones
spneumoniae-pangenome	pseudosimplitigs	11	8	runs	1545282	1850656	1722283	128373	87622	439120	92020	531140	517676	spneumoniae-pangenome.S_pseudosimplitigs.k_11.d_8.M_runs
spneumoniae-pangenome	pseudosimplitigs	11	8	zeros	1545282	1850656	1545282	305374	176232	439120	128860	567980	556516	spneumoniae-pangenome.S_pseudosimplitigs.k_11.d_8.M_zeros
spneumoniae-pangenome	pseudosimplitigs	11	9	default	1545282	1850639	1545282	305357	175647	438940	127376	566316	552208	spneumoniae-pangenome.S_pseudosimplitigs.k_11.d_9.M_default
spneumoniae-pangenome	pseudosimplitigs	11	9	ones	1545282	1850639	1730519	120120	92768	438940	92360	531300	518184	spneumoniae-pangenome.S_pseudosimplitigs.k_11.d_9.M_ones
spneumoniae-pangenome	pseudosimplitigs	11	9	runs	1545282	1850639	1722432	128207	87665	438940	92048	530988	518848	spneumoniae-pangenome.S_pseudosimplitigs.k_11.d_9.M_runs
spneumoniae-pangenome	pseudosimplitigs	11	9	zeros	1545282	1850639	1545282	305357	176186	438940	129072	568012	556028	spneumoniae-pangenome.S_pseudosimplitigs.k_11.d_9.M_zeros
spneumoniae-pangenome	pseudosimplitigsAC	11	1	default	1545282	2529652	1545282	984370	98437	689416	76572	765988	804172	spneumoniae-pangenome.S_pseudosimplitigsAC.k_11.d_1.M_default
spneumoniae-pangenome	pseudosimplitigsAC	11	1	ones	1545282	2529652	2200977	328675	170564	689416	161200	850616	839072	spneumoniae-pangenome.S_pseudosimplitigsAC.k_11.d_1.M_ones
spneumoniae-pangenome	pseudosimplitigsAC	11	1	runs	1545282	2529652	1968976	560676	82854	689416	118636	808052	802204	spneumoniae-pangenome.S_pseudosimplitigsAC.k_11.d_1.M_runs
spneumoniae-pangenome	pseudosimplitigsAC	11	1	zeros	1545282	2529652	1545282	984370	164125	689416	152288	841704	852836	spneumoniae-pangenome.S_pseudosimplitigsAC.k_11.d_1.M_zeros
spneumoniae-pangenome	pseudosimplitigsAC	11	10	default	1545282	1835190	1545282	289908	167267	496792	112996	609788	600828	spneumoniae-pangenome.S_pseudosimplitigsAC.k_11.d_10.M_default
spneumoniae-pangenome	pseudosimplitigsAC	11	10	ones	1545282	1835190	1724444	110746	85170	496792	81860	578652	569024	spneumoniae-pangenome.S_pseudosimplitigsAC.k_11.d_10.M_ones
spneumoniae-pangenome	pseudosimplitigsAC	11	10	runs	1545282	1835190	1717418	117772	80696	496792	81560	578352	567768	spneumoniae-pangenome.S_pseudosimplitigsAC.k_11.d_10.M_runs
spneumoniae-pangenome	pseudosimplitigsAC	11	10	zeros	1545282	1835190	1545282	289908	167951	496792	117888	614680	603976	spneumoniae-pangenome.S_pseudosimplitigsAC.k_11.d_10.M_zeros
spneumoniae-pangenome	pseudosimplitigsAC	11	2	default	1545282	2066104	1545282	520822	149230	563084	101964	665048	679948	spneumoniae-pangenome.S_pseudosimplitigsAC.k_11.d_2.M_default
spneumoniae-pangenome	pseudosimplitigsAC	11	2	ones	1545282	2066104	1876244	189860	115414	563084	109184	672268	661156	spneumoniae-pangenome.S_pseudosimplitigsAC.k_11.d_2.M_ones
spneumoniae-pangenome	pseudosimplitigsAC	11	2	runs	1545282	2066104	1800232	265872	82109	563084	95932	659016	652928	spneumoniae-pangenome.S_pseudosimplitigsAC.k_11.d_2.M_runs
spneumoniae-pangenome	pseudosimplitigsAC	11	2	zeros	1545282	2066104	1545282	520822	154051	563084	112028	675112	684052	spneumoniae-pangenome.S_pseudosimplitigsAC.k_11.d_2.M_zeros
spneumoniae-pangenome	pseudosimplitigsAC	11	3	default	1545282	1914406	1545282	369124	163559	521520	109444	630964	629560	spneumoniae-pangenome.S_pseudosimplitigsAC.k_11.d_3.M_default
spneumoniae-pangenome	pseudosimplitigsAC	11	3	ones	1545282	1914406	1775255	139151	95521	521520	91296	612816	602664	spneumoniae-pangenome.S_pseudosimplitigsAC.k_11.d_3.M_ones
spneumoniae-pangenome	pseudosimplitigsAC	11	3	runs	1545282	1914406	1746262	168144	81553	521520	87080	608600	597812	spneumoniae-pangenome.S_pseudosimplitigsAC.k_11.d_3.M_runs
spneumoniae-pangenome	pseudosimplitigsAC	11	3	zeros	1545282	1914406	1545282	369124	163613	521520	113956	635476	632880	spneumoniae-pangenome.S_pseudosimplitigsAC.k_11.d_3.M_zeros
spneumoniae-pangenome	pseudosimplitigsAC	11	4	default	1545282	1860869	1545282	315587	166521	506168	110912	617080	610048	spneumoniae-pangenome.S_pseudosimplitigsAC.k_11.d_4.M_default
spneumoniae-pangenome	pseudosimplitigsAC	11	4	ones	1545282	1860869	1739848	121021	88543	506168	85020	591188	579484	spneumoniae-pangenome.S_pseudosimplitigsAC.k_11.d_4.M_ones
spneumoniae-pangenome	pseudosimplitigsAC	11	4	runs	1545282	1860869	1725642	135227	80953	506168	83296	589464	578556	spneumoniae-pangenome.S_pseudosimplitigsAC.k_11.d_4.M_runs
spneumoniae-pangenome	pseudosimplitigsAC	11	4	zeros	1545282	1860869	1545282	315587	166350	506168	114516	620684	612688	spneumoniae-pangenome.S_pseudosimplitigsAC.k_11.d_4.M_zeros
spneumoniae-pangenome	pseudosimplitigsAC	11	5	default	1545282	1842934	1545282	297652	167047	499040	111948	610988	604624	spneumoniae-pangenome.S_pseudosimplitigsAC.k_11.d_5.M_default
spneumoniae-pangenome	pseudosimplitigsAC	11	5	ones	1545282	1842934	1727873	115061	86296	499040	82988	582028	572224	spneumoniae-pangenome.S_pseudosimplitigsAC.k_11.d_5.M_ones
spneumoniae-pangenome	pseudosimplitigsAC	11	5	runs	1545282	1842934	1718480	124454	80764	499040	82284	581324	570956	spneumoniae-pangenome.S_pseudosimplitigsAC.k_11.d_5.M_runs
spneumoniae-pangenome	pseudosimplitigsAC	11	5	zeros	1545282	1842934	1545282	297652	167447	499040	116480	615520	607240	spneumoniae-pangenome.S_pseudosimplitigsAC.k_11.d_5.M_zeros
spneumoniae-pangenome	pseudosimplitigsAC	11	6	default	1545282	1837442	1545282	292160	167172	498028	112328	610356	602640	spneumoniae-pangenome.S_pseudosimplitigsAC.k_11.d_6.M_default
spneumoniae-pangenome	pseudosimplitigsAC	11	6	ones	1545282	1837442	1725320	112122	85387	498028	82328	580356	568660	spneumoniae-pangenome.S_pseudosimplitigsAC.k_11.d_6.M_ones
spneumoniae-pangenome	pseudosimplitigsAC	11	6	runs	1545282	1837442	1717824	119618	80635	498028	81712	579740	568232	spneumoniae-pangenome.S_pseudosimplitigsAC.k_11.d_6.M_runs
spneumoniae-pangenome	pseudosimplitigsAC	11	6	zeros	1545282	1837442	1545282	292160	167760	498028	117172	615200	606332	spneumoniae-pangenome.S_pseudosimplitigsAC.k_11.d_6.M_zeros
spneumoniae-pangenome	pseudosimplitigsAC	11	7	default	1545282	1836485	1545282	291203	167263	497552	112624	610176	602096	spneumoniae-pangenome.S_pseudosimplitigsAC.k_11.d_7.M_default
spneumoniae-pangenome	pseudosimplitigsAC	11	7	ones	1545282	1836485	1725317	111168	85149	497552	81988	579540	569836	spneumoniae-pangenome.S_pseudosimplitigsAC.k_11.d_7.M_ones
spneumoniae-pangenome	pseudosimplitigsAC	11	7	runs	1545282	1836485	1718298	118187	80647	497552	81748	579300	569180	spneumoniae-pangenome.S_pseudosimplitigsAC.k_11.d_7.M_runs
spneumoniae-pangenome	pseudosimplitigsAC	11	7	zeros	1545282	1836485	1545282	291203	167946	497552	117540	615092	605320	spneumoniae-pangenome.S_pseudosimplitigsAC.k_11.d_7.M_zeros
spneumoniae-pangenome	pseudosimplitigsAC	11	8	default	1545282	1835577	1545282	290295	167247	497084	112764	609848	601472	spneumoniae-pangenome.S_pseudosimplitigsAC.k_11.d_8.M_default
spneumoniae-pangenome	pseudosimplitigsAC	11	8	ones	1545282	1835577	1724718	110859	85027	497084	81880	578964	569380	spneumoniae-pangenome.S_pseudosimplitigsAC.k_11.d_8.M_ones
spneumoniae-pangenome	pseudosimplitigsAC	11	8	runs	1545282	1835577	1718021	117556	80658	497084	81616	578700	568204	spneumoniae-pangenome.S_pseudosimplitigsAC.k_11.d_8.M_runs
spneumoniae-pangenome	pseudosimplitigsAC	11	8	zeros	1545282	1835577	1545282	290295	167931	497084	117652	614736	604736	spneumoniae-pangenome.S_pseudosimplitigsAC.k_11.d_8.M_zeros
spneumoniae-pangenome	pseudosimplitigsAC	11	9	default	1545282	1835243	1545282	289961	167235	496892	112944	609836	601136	spneumoniae-pangenome.S_pseudosimplitigsAC.k_11.d_9.M_default
spneumoniae-pangenome	pseudosimplitigsAC	11	9	ones	1545282	1835243	1724909	110334	85048	496892	81804	578696	569068	spneumoniae-pangenome.S_pseudosimplitigsAC.k_11.d_9.M_ones
spneumoniae-pangenome	pseudosimplitigsAC	11	9	runs	1545282	1835243	1718201	117042	80663	496892	81704	578596	567852	spneumoniae-pangenome.S_pseudosimplitigsAC.k_11.d_9.M_runs
spneumoniae-pangenome	pseudosimplitigsAC	11	9	zeros	1545282	1835243	1545282	289961	167919	496892	117852	614744	604336	spneumoniae-pangenome.S_pseudosimplitigsAC.k_11.d_9.M_zeros
spneumoniae-pangenome	pseudosimplitigs	12	1	default	3336895	6813236	3336895	3476341	316031	1758652	226872	1985524	2124048	spneumoniae-pangenome.S_pseudosimplitigs.k_12.d_1.M_default
spneumoniae-pangenome	pseudosimplitigs	12	1	ones	3336895	6813236	5184535	1628701	656931	1758652	589628	2348280	2345484	spneumoniae-pangenome.S_pseudosimplitigs.k_12.d_1.M_ones
spneumoniae-pangenome	pseudosimplitigs	12	1	runs	3336895	6813236	4329835	2483401	288938	1758652	377732	2136384	2156096	spneumoniae-pangenome.S_pseudosimplitigs.k_12.d_1.M_runs
spneumoniae-pangenome	pseudosimplitigs	12	1	zeros	3336895	6813236	3336895	3476341	490950	1758652	457072	2215724	2283556	spneumoniae-pangenome.S_pseudosimplitigs.k_12.d_1.M_zeros
spneumoniae-pangenome	pseudosimplitigs	12	10	default	3336895	4314823	3336895	977928	548629	1084560	359864	1444424	1438116	spneumoniae-pangenome.S_pseudosimplitigs.k_12.d_10.M_default
spneumoniae-pangenome	pseudosimplitigs	12	10	ones	3336895	4314823	3818834	495989	333392	1084560	282892	1367452	1361164	spneumoniae-pangenome.S_pseudosimplitigs.k_12.d_10.M_ones
spneumoniae-pangenome	pseudosimplitigs	12	10	runs	3336895	4314823	3788802	526021	312675	1084560	280244	1364804	1359256	spneumoniae-pangenome.S_pseudosimplitigs.k_12.d_10.M_runs
spneumoniae-pangenome	pseudosimplitigs	12	10	zeros	3336895	4314823	3336895	977928	552956	1084560	364272	1448832	1440256	spneumoniae-pangenome.S_pseudosimplitigs.k_12.d_10.M_zeros
spneumoniae-pangenome	pseudosimplitigs	12	11	default	3336895	4316553	3336895	979658	548710	1084684	359944	1444628	1437636	spneumoniae-pangenome.S_pseudosimplitigs.k_12.d_11.M_default
spneumoniae-pangenome	pseudosimplitigs	12	11	ones	3336895	4316553	3820024	496529	333820	1084684	283124	1367808	1361500	spneumoniae-pangenome.S_pseudosimplitigs.k_12.d_11.M_ones
spneumoniae-pangenome	pseudosimplitigs	12	11	runs	3336895	4316553	3789122	527431	312689	1084684	280312	1364996	1358852	spneumoniae-pangenome.S_pseudosimplitigs.k_12.d_11.M_runs
spneumoniae-pangenome	pseudosimplitigs	12	11	zeros	3336895	4316553	3336895	979658	553037	1084684	364360	1449044	1439760	spneumoniae-pangenome.S_pseudosimplitigs.k_12.d_11.M_zeros
spneumoniae-pangenome	pseudosimplitigs	12	2	default	3336895	5234934	3336895	1898039	470529	1337392	310540	1647932	1719884	spneumoniae-pangenome.S_pseudosimplitigs.k_12.d_2.M_default
spneumoniae-pangenome	pseudosimplitigs	12	2	ones	3336895	5234934	4273779	961155	452529	1337392	399544	1736936	1730648	spneumoniae-pangenome.S_pseudosimplitigs.k_12.d_2.M_ones
spneumoniae-pangenome	pseudosimplitigs	12	2	runs	3336895	5234934	3931360	1303574	290325	1337392	314280	1651672	1665720	spneumoniae-pangenome.S_pseudosimplitigs.k_12.d_2.M_runs
spneumoniae-pangenome	pseudosimplitigs	12	2	zeros	3336895	5234934	3336895	1898039	490102	1337392	349964	1687356	1738792	spneumoniae-pangenome.S_pseudosimplitigs.k_12.d_2.M_zeros
spneumoniae-pangenome	pseudosimplitigs	12	3	default	3336895	4670986	3336895	1334091	524290	1185824	339752	1525576	1553440	spneumoniae-pangenome.S_pseudosimplitigs.k_12.d_3.M_default
spneumoniae-pangenome	pseudosimplitigs	12	3	ones	3336895	4670986	3972936	698050	386595	1185824	332020	1517844	1510856	spneumoniae-pangenome.S_pseudosimplitigs.k_12.d_3.M_ones
spneumoniae-pangenome	pseudosimplitigs	12	3	runs	3336895	4670986	3823215	847771	310827	1185824	299132	1484956	1487796	spneumoniae-pangenome.S_pseudosimplitigs.k_12.d_3.M_runs
spneumoniae-pangenome	pseudosimplitigs	12	3	zeros	3336895	4670986	3336895	1334091	525718	1185824	345728	1531552	1555440	spneumoniae-pangenome.S_pseudosimplitigs.k_12.d_3.M_zeros
spneumoniae-pangenome	pseudosimplitigs	12	4	default	3336895	4439581	3336895	1102686	540018	1124100	349084	1473184	1477996	spneumoniae-pangenome.S_pseudosimplitigs.k_12.d_4.M_default
spneumoniae-pangenome	pseudosimplitigs	12	4	ones	3336895	4439581	3872425	567156	349257	1124100	298348	1422448	1414396	spneumoniae-pangenome.S_pseudosimplitigs.k_12.d_4.M_ones
spneumoniae-pangenome	pseudosimplitigs	12	4	runs	3336895	4439581	3799186	640395	309101	1124100	285168	1409268	1405096	spneumoniae-pangenome.S_pseudosimplitigs.k_12.d_4.M_runs
spneumoniae-pangenome	pseudosimplitigs	12	4	zeros	3336895	4439581	3336895	1102686	540144	1124100	349848	1473948	1479172	spneumoniae-pangenome.S_pseudosimplitigs.k_12.d_4.M_zeros
spneumoniae-pangenome	pseudosimplitigs	12	5	default	3336895	4356243	3336895	1019348	546912	1099588	355364	1454952	1450680	spneumoniae-pangenome.S_pseudosimplitigs.k_12.d_5.M_default
spneumoniae-pangenome	pseudosimplitigs	12	5	ones	3336895	4356243	3837931	518312	337647	1099588	287352	1386940	1380248	spneumoniae-pangenome.S_pseudosimplitigs.k_12.d_5.M_ones
spneumoniae-pangenome	pseudosimplitigs	12	5	runs	3336895	4356243	3793408	562835	310453	1099588	281004	1380592	1376092	spneumoniae-pangenome.S_pseudosimplitigs.k_12.d_5.M_runs
spneumoniae-pangenome	pseudosimplitigs	12	5	zeros	3336895	4356243	3336895	1019348	547111	1099588	355296	1454884	1451636	spneumoniae-pangenome.S_pseudosimplitigs.k_12.d_5.M_zeros
spneumoniae-pangenome	pseudosimplitigs	12	6	default	3336895	4326662	3336895	989767	547983	1089768	357552	1447320	1440392	spneumoniae-pangenome.S_pseudosimplitigs.k_12.d_6.M_default
spneumoniae-pangenome	pseudosimplitigs	12	6	ones	3336895	4326662	3823496	503166	334446	1089768	284256	1374024	1366912	spneumoniae-pangenome.S_pseudosimplitigs.k_12.d_6.M_ones
spneumoniae-pangenome	pseudosimplitigs	12	6	runs	3336895	4326662	3788481	538181	311560	1089768	280452	1370220	1364180	spneumoniae-pangenome.S_pseudosimplitigs.k_12.d_6.M_runs
spneumoniae-pangenome	pseudosimplitigs	12	6	zeros	3336895	4326662	3336895	989767	549280	1089768	358948	1448716	1443400	spneumoniae-pangenome.S_pseudosimplitigs.k_12.d_6.M_zeros
spneumoniae-pangenome	pseudosimplitigs	12	7	default	3336895	4317786	3336895	980891	548481	1086668	358572	1445240	1441236	spneumoniae-pangenome.S_pseudosimplitigs.k_12.d_7.M_default
spneumoniae-pangenome	pseudosimplitigs	12	7	ones	3336895	4317786	3819350	498436	333769	1086668	283284	1369952	1363308	spneumoniae-pangenome.S_pseudosimplitigs.k_12.d_7.M_ones
spneumoniae-pangenome	pseudosimplitigs	12	7	runs	3336895	4317786	3788034	529752	312553	1086668	280188	1366856	1359484	spneumoniae-pangenome.S_pseudosimplitigs.k_12.d_7.M_runs
spneumoniae-pangenome	pseudosimplitigs	12	7	zeros	3336895	4317786	3336895	980891	552790	1086668	363016	1449684	1443432	spneumoniae-pangenome.S_pseudosimplitigs.k_12.d_7.M_zeros
spneumoniae-pangenome	pseudosimplitigs	12	8	default	3336895	4315656	3336895	978761	548660	1085408	359164	1444572	1439732	spneumoniae-pangenome.S_pseudosimplitigs.k_12.d_8.M_default
spneumoniae-pangenome	pseudosimplitigs	12	8	ones	3336895	4315656	3818872	496784	333728	1085408	283060	1368468	1362048	spneumoniae-pangenome.S_pseudosimplitigs.k_12.d_8.M_ones
spneumoniae-pangenome	pseudosimplitigs	12	8	runs	3336895	4315656	3788388	527268	312688	1085408	280308	1365716	1360272	spneumoniae-pangenome.S_pseudosimplitigs.k_12.d_8.M_runs
spneumoniae-pangenome	pseudosimplitigs	12	8	zeros	3336895	4315656	3336895	978761	552977	1085408	363592	1449000	1441956	spneumoniae-pangenome.S_pseudosimplitigs.k_12.d_8.M_zeros
spneumoniae-pangenome	pseudosimplitigs	12	9	default	3336895	4314851	3336895	977956	548645	1084872	359532	1444404	1438796	spneumoniae-pangenome.S_pseudosimplitigs.k_12.d_9.M_default
spneumoniae-pangenome	pseudosimplitigs	12	9	ones	3336895	4314851	3818715	496136	333423	1084872	282936	1367808	1361436	spneumoniae-pangenome.S_pseudosimplitigs.k_12.d_9.M_ones
spneumoniae-pangenome	pseudosimplitigs	12	9	runs	3336895	4314851	3788654	526197	312619	1084872	280172	1365044	1358552	spneumoniae-pangenome.S_pseudosimplitigs.k_12.d_9.M_runs
spneumoniae-pangenome	pseudosimplitigs	12	9	zeros	3336895	4314851	3336895	977956	552971	1084872	363956	1448828	1440936	spneumoniae-pangenome.S_pseudosimplitigs.k_12.d_9.M_zeros
spneumoniae-pangenome	pseudosimplitigsAC	12	1	default	3336895	6813225	3336895	3476330	316030	1808876	215152	2024028	2180764	spneumoniae-pangenome.S_pseudosimplitigsAC.k_12.d_1.M_default
spneumoniae-pangenome	pseudosimplitigsAC	12	1	ones	3336895	6813225	5172311	1640914	661249	1808876	582280	2391156	2391136	spneumoniae-pangenome.S_pseudosimplitigsAC.k_12.d_1.M_ones
spneumoniae-pangenome	pseudosimplitigsAC	12	1	runs	3336895	6813225	4291818	2521407	287550	1808876	371544	2180420	2203716	spneumoniae-pangenome.S_pseudosimplitigsAC.k_12.d_1.M_runs
spneumoniae-pangenome	pseudosimplitigsAC	12	1	zeros	3336895	6813225	3336895	3476330	510796	1808876	450548	2259424	2329040	spneumoniae-pangenome.S_pseudosimplitigsAC.k_12.d_1.M_zeros
spneumoniae-pangenome	pseudosimplitigsAC	12	10	default	3336895	4282762	3336895	945867	522062	1137304	319144	1456448	1447980	spneumoniae-pangenome.S_pseudosimplitigsAC.k_12.d_10.M_default
spneumoniae-pangenome	pseudosimplitigsAC	12	10	ones	3336895	4282762	3810252	472510	320825	1137304	265812	1403116	1394040	spneumoniae-pangenome.S_pseudosimplitigsAC.k_12.d_10.M_ones
spneumoniae-pangenome	pseudosimplitigsAC	12	10	runs	3336895	4282762	3781899	500863	301577	1137304	263704	1401008	1391496	spneumoniae-pangenome.S_pseudosimplitigsAC.k_12.d_10.M_runs
spneumoniae-pangenome	pseudosimplitigsAC	12	10	zeros	3336895	4282762	3336895	945867	525640	1137304	333632	1470936	1462256	spneumoniae-pangenome.S_pseudosimplitigsAC.k_12.d_10.M_zeros
spneumoniae-pangenome	pseudosimplitigsAC	12	11	default	3336895	4282952	3336895	946057	522098	1137168	319196	1456364	1447552	spneumoniae-pangenome.S_pseudosimplitigsAC.k_12.d_11.M_default
spneumoniae-pangenome	pseudosimplitigsAC	12	11	ones	3336895	4282952	3809644	473308	321078	1137168	265880	1403048	1394012	spneumoniae-pangenome.S_pseudosimplitigsAC.k_12.d_11.M_ones
spneumoniae-pangenome	pseudosimplitigsAC	12	11	runs	3336895	4282952	3780951	502001	301660	1137168	263632	1400800	1391080	spneumoniae-pangenome.S_pseudosimplitigsAC.k_12.d_11.M_runs
spneumoniae-pangenome	pseudosimplitigsAC	12	11	zeros	3336895	4282952	3336895	946057	525676	1137168	333664	1470832	1461796	spneumoniae-pangenome.S_pseudosimplitigsAC.k_12.d_11.M_zeros
spneumoniae-pangenome	pseudosimplitigsAC	12	2	default	3336895	5236083	3336895	1899188	461208	1395252	286972	1682224	1754820	spneumoniae-pangenome.S_pseudosimplitigsAC.k_12.d_2.M_default
spneumoniae-pangenome	pseudosimplitigsAC	12	2	ones	3336895	5236083	4285232	950851	442833	1395252	383172	1778424	1769380	spneumoniae-pangenome.S_pseudosimplitigsAC.k_12.d_2.M_ones
spneumoniae-pangenome	pseudosimplitigsAC	12	2	runs	3336895	5236083	3943665	1292418	281436	1395252	297752	1693004	1703996	spneumoniae-pangenome.S_pseudosimplitigsAC.k_12.d_2.M_runs
spneumoniae-pangenome	pseudosimplitigsAC	12	2	zeros	3336895	5236083	3336895	1899188	480923	1395252	326980	1722232	1772136	spneumoniae-pangenome.S_pseudosimplitigsAC.k_12.d_2.M_zeros
spneumoniae-pangenome	pseudosimplitigsAC	12	3	default	3336895	4642342	3336895	1305447	508409	1237196	307752	1544948	1572576	spneumoniae-pangenome.S_pseudosimplitigsAC.k_12.d_3.M_default
spneumoniae-pangenome	pseudosimplitigsAC	12	3	ones	3336895	4642342	3968192	674150	367325	1237196	309112	1546308	1537168	spneumoniae-pangenome.S_pseudosimplitigsAC.k_12.d_3.M_ones
spneumoniae-pangenome	pseudosimplitigsAC	12	3	runs	3336895	4642342	3825005	817337	294596	1237196	277356	1514552	1515432	spneumoniae-pangenome.S_pseudosimplitigsAC.k_12.d_3.M_runs
spneumoniae-pangenome	pseudosimplitigsAC	12	3	zeros	3336895	4642342	3336895	1305447	509578	1237196	313468	1550664	1574552	spneumoniae-pangenome.S_pseudosimplitigsAC.k_12.d_3.M_zeros
spneumoniae-pangenome	pseudosimplitigsAC	12	4	default	3336895	4408728	3336895	1071833	520244	1193236	312756	1505992	1495744	spneumoniae-pangenome.S_pseudosimplitigsAC.k_12.d_4.M_default
spneumoniae-pangenome	pseudosimplitigsAC	12	4	ones	3336895	4408728	3856517	552211	338105	1193236	281516	1474752	1447576	spneumoniae-pangenome.S_pseudosimplitigsAC.k_12.d_4.M_ones
spneumoniae-pangenome	pseudosimplitigsAC	12	4	runs	3336895	4408728	3789175	619553	300645	1193236	269156	1462392	1436828	spneumoniae-pangenome.S_pseudosimplitigsAC.k_12.d_4.M_runs
spneumoniae-pangenome	pseudosimplitigsAC	12	4	zeros	3336895	4408728	3336895	1071833	520061	1193236	323332	1516568	1502652	spneumoniae-pangenome.S_pseudosimplitigsAC.k_12.d_4.M_zeros
spneumoniae-pangenome	pseudosimplitigsAC	12	5	default	3336895	4325516	3336895	988621	521653	1149672	316368	1466040	1464916	spneumoniae-pangenome.S_pseudosimplitigsAC.k_12.d_5.M_default
spneumoniae-pangenome	pseudosimplitigsAC	12	5	ones	3336895	4325516	3820631	504885	327403	1149672	271488	1421160	1412424	spneumoniae-pangenome.S_pseudosimplitigsAC.k_12.d_5.M_ones
spneumoniae-pangenome	pseudosimplitigsAC	12	5	runs	3336895	4325516	3779063	546453	301960	1149672	265644	1415316	1407708	spneumoniae-pangenome.S_pseudosimplitigsAC.k_12.d_5.M_runs
spneumoniae-pangenome	pseudosimplitigsAC	12	5	zeros	3336895	4325516	3336895	988621	523584	1149672	328876	1478548	1477692	spneumoniae-pangenome.S_pseudosimplitigsAC.k_12.d_5.M_zeros
spneumoniae-pangenome	pseudosimplitigsAC	12	6	default	3336895	4296426	3336895	959531	521711	1143892	317244	1461136	1456216	spneumoniae-pangenome.S_pseudosimplitigsAC.k_12.d_6.M_default
spneumoniae-pangenome	pseudosimplitigsAC	12	6	ones	3336895	4296426	3809827	486599	322911	1143892	268084	1411976	1400520	spneumoniae-pangenome.S_pseudosimplitigsAC.k_12.d_6.M_ones
spneumoniae-pangenome	pseudosimplitigsAC	12	6	runs	3336895	4296426	3777235	519191	301728	1143892	264052	1407944	1397412	spneumoniae-pangenome.S_pseudosimplitigsAC.k_12.d_6.M_runs
spneumoniae-pangenome	pseudosimplitigsAC	12	6	zeros	3336895	4296426	3336895	959531	523759	1143892	330012	1473904	1467280	spneumoniae-pangenome.S_pseudosimplitigsAC.k_12.d_6.M_zeros
spneumoniae-pangenome	pseudosimplitigsAC	12	7	default	3336895	4287732	3336895	950837	521846	1141280	317920	1459200	1452656	spneumoniae-pangenome.S_pseudosimplitigsAC.k_12.d_7.M_default
spneumoniae-pangenome	pseudosimplitigsAC	12	7	ones	3336895	4287732	3809252	478480	321729	1141280	266940	1408220	1396624	spneumoniae-pangenome.S_pseudosimplitigsAC.k_12.d_7.M_ones
spneumoniae-pangenome	pseudosimplitigsAC	12	7	runs	3336895	4287732	3779457	508275	301844	1141280	263704	1404984	1394224	spneumoniae-pangenome.S_pseudosimplitigsAC.k_12.d_7.M_runs
spneumoniae-pangenome	pseudosimplitigsAC	12	7	zeros	3336895	4287732	3336895	950837	523890	1141280	330692	1471972	1463824	spneumoniae-pangenome.S_pseudosimplitigsAC.k_12.d_7.M_zeros
spneumoniae-pangenome	pseudosimplitigsAC	12	8	default	3336895	4284806	3336895	947911	521919	1138428	318460	1456888	1449876	spneumoniae-pangenome.S_pseudosimplitigsAC.k_12.d_8.M_default
spneumoniae-pangenome	pseudosimplitigsAC	12	8	ones	3336895	4284806	3810001	474805	321073	1138428	266092	1404520	1395532	spneumoniae-pangenome.S_pseudosimplitigsAC.k_12.d_8.M_ones
spneumoniae-pangenome	pseudosimplitigsAC	12	8	runs	3336895	4284806	3780990	503816	301471	1138428	263596	1402024	1392788	spneumoniae-pangenome.S_pseudosimplitigsAC.k_12.d_8.M_runs
spneumoniae-pangenome	pseudosimplitigsAC	12	8	zeros	3336895	4284806	3336895	947911	525494	1138428	332936	1471364	1464148	spneumoniae-pangenome.S_pseudosimplitigsAC.k_12.d_8.M_zeros
spneumoniae-pangenome	pseudosimplitigsAC	12	9	default	3336895	4283719	3336895	946824	522042	1137804	318752	1456556	1448860	spneumoniae-pangenome.S_pseudosimplitigsAC.k_12.d_9.M_default
spneumoniae-pangenome	pseudosimplitigsAC	12	9	ones	3336895	4283719	3810177	473542	320789	1137804	265920	1403724	1394732	spneumoniae-pangenome.S_pseudosimplitigsAC.k_12.d_9.M_ones
spneumoniae-pangenome	pseudosimplitigsAC	12	9	runs	3336895	4283719	3781725	501994	301537	1137804	263704	1401508	1391156	spneumoniae-pangenome.S_pseudosimplitigsAC.k_12.d_9.M_runs
spneumoniae-pangenome	pseudosimplitigsAC	12	9	zeros	3336895	4283719	3336895	946824	525619	1137804	333240	1471044	1463152	spneumoniae-pangenome.S_pseudosimplitigsAC.k_12.d_9.M_zeros
spneumoniae-pangenome	pseudosimplitigs	13	1	default	5038555	10244455	5038555	5205900	433825	2648364	336936	2985300	3189136	spneumoniae-pangenome.S_pseudosimplitigs.k_13.d_1.M_default
spneumoniae-pangenome	pseudosimplitigs	13	1	ones	5038555	10244455	6891807	3352648	926957	2648364	875100	3523464	3549136	spneumoniae-pangenome.S_pseudosimplitigs.k_13.d_1.M_ones
spneumoniae-pangenome	pseudosimplitigs	13	1	runs	5038555	10244455	5890327	4354128	416641	2648364	533920	3182284	3220260	spneumoniae-pangenome.S_pseudosimplitigs.k_13.d_1.M_runs
spneumoniae-pangenome	pseudosimplitigs	13	1	zeros	5038555	10244455	5038555	5205900	645300	2648364	635916	3284280	3394724	spneumoniae-pangenome.S_pseudosimplitigs.k_13.d_1.M_zeros
spneumoniae-pangenome	pseudosimplitigs	13	10	default	5038555	6666716	5038555	1628161	789684	1705176	559348	2264524	2258028	spneumoniae-pangenome.S_pseudosimplitigs.k_13.d_10.M_default
spneumoniae-pangenome	pseudosimplitigs	13	10	ones	5038555	6666716	5660765	1005951	546637	1705176	470640	2175816	2171344	spneumoniae-pangenome.S_pseudosimplitigs.k_13.d_10.M_ones
spneumoniae-pangenome	pseudosimplitigs	13	10	runs	5038555	6666716	5610164	1056552	509502	1705176	461464	2166640	2162012	spneumoniae-pangenome.S_pseudosimplitigs.k_13.d_10.M_runs
spneumoniae-pangenome	pseudosimplitigs	13	10	zeros	5038555	6666716	5038555	1628161	805051	1705176	574248	2279424	2277092	spneumoniae-pangenome.S_pseudosimplitigs.k_13.d_10.M_zeros
spneumoniae-pangenome	pseudosimplitigs	13	11	default	5038555	6666720	5038555	1628165	789744	1704988	559840	2264828	2257120	spneumoniae-pangenome.S_pseudosimplitigs.k_13.d_11.M_default
spneumoniae-pangenome	pseudosimplitigs	13	11	ones	5038555	6666720	5661094	1005626	546904	1704988	470716	2175704	2171092	spneumoniae-pangenome.S_pseudosimplitigs.k_13.d_11.M_ones
spneumoniae-pangenome	pseudosimplitigs	13	11	runs	5038555	6666720	5610310	1056410	509597	1704988	461692	2166680	2161312	spneumoniae-pangenome.S_pseudosimplitigs.k_13.d_11.M_runs
spneumoniae-pangenome	pseudosimplitigs	13	11	zeros	5038555	6666720	5038555	1628165	805110	1704988	574720	2279708	2276168	spneumoniae-pangenome.S_pseudosimplitigs.k_13.d_11.M_zeros
spneumoniae-pangenome	pseudosimplitigs	13	12	default	5038555	6668767	5038555	1630212	789750	1705240	559796	2265036	2256520	spneumoniae-pangenome.S_pseudosimplitigs.k_13.d_12.M_default
spneumoniae-pangenome	pseudosimplitigs	13	12	ones	5038555	6668767	5661656	1007111	547066	1705240	470916	2176156	2171420	spneumoniae-pangenome.S_pseudosimplitigs.k_13.d_12.M_ones
spneumoniae-pangenome	pseudosimplitigs	13	12	runs	5038555	6668767	5610287	1058480	509605	1705240	461776	2167016	2161160	spneumoniae-pangenome.S_pseudosimplitigs.k_13.d_12.M_runs
spneumoniae-pangenome	pseudosimplitigs	13	12	zeros	5038555	6668767	5038555	1630212	805117	1705240	574680	2279920	2275568	spneumoniae-pangenome.S_pseudosimplitigs.k_13.d_12.M_zeros
spneumoniae-pangenome	pseudosimplitigs	13	2	default	5038555	8162179	5038555	3123624	614810	2113480	461444	2574924	2686220	spneumoniae-pangenome.S_pseudosimplitigs.k_13.d_2.M_default
spneumoniae-pangenome	pseudosimplitigs	13	2	ones	5038555	8162179	6102597	2059582	651917	2113480	620856	2734336	2736140	spneumoniae-pangenome.S_pseudosimplitigs.k_13.d_2.M_ones
spneumoniae-pangenome	pseudosimplitigs	13	2	runs	5038555	8162179	5642060	2520119	400613	2113480	455204	2568684	2597276	spneumoniae-pangenome.S_pseudosimplitigs.k_13.d_2.M_runs
spneumoniae-pangenome	pseudosimplitigs	13	2	zeros	5038555	8162179	5038555	3123624	651008	2113480	518468	2631948	2719872	spneumoniae-pangenome.S_pseudosimplitigs.k_13.d_2.M_zeros
spneumoniae-pangenome	pseudosimplitigs	13	3	default	5038555	7351085	5038555	2312530	720798	1901740	518300	2420040	2479312	spneumoniae-pangenome.S_pseudosimplitigs.k_13.d_3.M_default
spneumoniae-pangenome	pseudosimplitigs	13	3	ones	5038555	7351085	5820771	1530314	585057	1901740	534520	2436260	2432112	spneumoniae-pangenome.S_pseudosimplitigs.k_13.d_3.M_ones
spneumoniae-pangenome	pseudosimplitigs	13	3	runs	5038555	7351085	5599505	1751580	456833	1901740	456040	2357780	2377332	spneumoniae-pangenome.S_pseudosimplitigs.k_13.d_3.M_runs
spneumoniae-pangenome	pseudosimplitigs	13	3	zeros	5038555	7351085	5038555	2312530	724872	1901740	529188	2430928	2481952	spneumoniae-pangenome.S_pseudosimplitigs.k_13.d_3.M_zeros
spneumoniae-pangenome	pseudosimplitigs	13	4	default	5038555	6947414	5038555	1908859	766301	1791160	541340	2332500	2355420	spneumoniae-pangenome.S_pseudosimplitigs.k_13.d_4.M_default
spneumoniae-pangenome	pseudosimplitigs	13	4	ones	5038555	6947414	5713894	1233520	560995	1791160	495224	2286384	2279540	spneumoniae-pangenome.S_pseudosimplitigs.k_13.d_4.M_ones
spneumoniae-pangenome	pseudosimplitigs	13	4	runs	5038555	6947414	5599253	1348161	489974	1791160	460260	2251420	2256352	spneumoniae-pangenome.S_pseudosimplitigs.k_13.d_4.M_runs
spneumoniae-pangenome	pseudosimplitigs	13	4	zeros	5038555	6947414	5038555	1908859	766687	1791160	542776	2333936	2355532	spneumoniae-pangenome.S_pseudosimplitigs.k_13.d_4.M_zeros
spneumoniae-pangenome	pseudosimplitigs	13	5	default	5038555	6766317	5038555	1727762	782402	1740812	551500	2292312	2295528	spneumoniae-pangenome.S_pseudosimplitigs.k_13.d_5.M_default
spneumoniae-pangenome	pseudosimplitigs	13	5	ones	5038555	6766317	5675661	1090656	551489	1740812	479000	2219812	2210184	spneumoniae-pangenome.S_pseudosimplitigs.k_13.d_5.M_ones
spneumoniae-pangenome	pseudosimplitigs	13	5	runs	5038555	6766317	5603607	1162710	503325	1740812	461028	2201840	2197100	spneumoniae-pangenome.S_pseudosimplitigs.k_13.d_5.M_runs
spneumoniae-pangenome	pseudosimplitigs	13	5	zeros	5038555	6766317	5038555	1727762	785645	1740812	553156	2293968	2301028	spneumoniae-pangenome.S_pseudosimplitigs.k_13.d_5.M_zeros
spneumoniae-pangenome	pseudosimplitigs	13	6	default	5038555	6696931	5038555	1658376	787572	1717516	555632	2273148	2271300	spneumoniae-pangenome.S_pseudosimplitigs.k_13.d_6.M_default
spneumoniae-pangenome	pseudosimplitigs	13	6	ones	5038555	6696931	5663621	1033310	548264	1717516	473128	2190644	2183844	spneumoniae-pangenome.S_pseudosimplitigs.k_13.d_6.M_ones
spneumoniae-pangenome	pseudosimplitigs	13	6	runs	5038555	6696931	5605983	1090948	507664	1717516	461092	2178608	2173632	spneumoniae-pangenome.S_pseudosimplitigs.k_13.d_6.M_runs
spneumoniae-pangenome	pseudosimplitigs	13	6	zeros	5038555	6696931	5038555	1658376	791620	1717516	559004	2276520	2278508	spneumoniae-pangenome.S_pseudosimplitigs.k_13.d_6.M_zeros
spneumoniae-pangenome	pseudosimplitigs	13	7	default	5038555	6673045	5038555	1634490	789109	1709460	555304	2264764	2264040	spneumoniae-pangenome.S_pseudosimplitigs.k_13.d_7.M_default
spneumoniae-pangenome	pseudosimplitigs	13	7	ones	5038555	6673045	5659920	1013125	546817	1709460	470976	2180436	2176080	spneumoniae-pangenome.S_pseudosimplitigs.k_13.d_7.M_ones
spneumoniae-pangenome	pseudosimplitigs	13	7	runs	5038555	6673045	5607927	1065118	509098	1709460	461104	2170564	2165320	spneumoniae-pangenome.S_pseudosimplitigs.k_13.d_7.M_runs
spneumoniae-pangenome	pseudosimplitigs	13	7	zeros	5038555	6673045	5038555	1634490	801682	1709460	569492	2278952	2279456	spneumoniae-pangenome.S_pseudosimplitigs.k_13.d_7.M_zeros
spneumoniae-pangenome	pseudosimplitigs	13	8	default	5038555	6666382	5038555	1627827	789506	1707092	556196	2263288	2261736	spneumoniae-pangenome.S_pseudosimplitigs.k_13.d_8.M_default
spneumoniae-pangenome	pseudosimplitigs	13	8	ones	5038555	6666382	5659499	1006883	546416	1707092	470508	2177600	2173540	spneumoniae-pangenome.S_pseudosimplitigs.k_13.d_8.M_ones
spneumoniae-pangenome	pseudosimplitigs	13	8	runs	5038555	6666382	5609041	1057341	509390	1707092	461132	2168224	2162496	spneumoniae-pangenome.S_pseudosimplitigs.k_13.d_8.M_runs
spneumoniae-pangenome	pseudosimplitigs	13	8	zeros	5038555	6666382	5038555	1627827	804747	1707092	573204	2280296	2280552	spneumoniae-pangenome.S_pseudosimplitigs.k_13.d_8.M_zeros
spneumoniae-pangenome	pseudosimplitigs	13	9	default	5038555	6665300	5038555	1626745	789630	1705408	558968	2264376	2258684	spneumoniae-pangenome.S_pseudosimplitigs.k_13.d_9.M_default
spneumoniae-pangenome	pseudosimplitigs	13	9	ones	5038555	6665300	5659858	1005442	546378	1705408	470388	2175796	2171380	spneumoniae-pangenome.S_pseudosimplitigs.k_13.d_9.M_ones
spneumoniae-pangenome	pseudosimplitigs	13	9	runs	5038555	6665300	5609680	1055620	509432	1705408	461364	2166772	2161772	spneumoniae-pangenome.S_pseudosimplitigs.k_13.d_9.M_runs
spneumoniae-pangenome	pseudosimplitigs	13	9	zeros	5038555	6665300	5038555	1626745	804994	1705408	573844	2279252	2277704	spneumoniae-pangenome.S_pseudosimplitigs.k_13.d_9.M_zeros
spneumoniae-pangenome	pseudosimplitigsAC	13	1	default	5038555	10244503	5038555	5205948	433829	2655216	323932	2979148	3219948	spneumoniae-pangenome.S_pseudosimplitigsAC.k_13.d_1.M_default
spneumoniae-pangenome	pseudosimplitigsAC	13	1	ones	5038555	10244503	6879428	3365075	930121	2655216	864796	3520012	3561148	spneumoniae-pangenome.S_pseudosimplitigsAC.k_13.d_1.M_ones
spneumoniae-pangenome	pseudosimplitigsAC	13	1	runs	5038555	10244503	5858312	4386191	414594	2655216	526588	3181804	3242760	spneumoniae-pangenome.S_pseudosimplitigsAC.k_13.d_1.M_runs
spneumoniae-pangenome	pseudosimplitigsAC	13	1	zeros	5038555	10244503	5038555	5205948	659995	2655216	629972	3285188	3412796	spneumoniae-pangenome.S_pseudosimplitigsAC.k_13.d_1.M_zeros
spneumoniae-pangenome	pseudosimplitigsAC	13	10	default	5038555	6614600	5038555	1576045	761521	1722204	515420	2237624	2246476	spneumoniae-pangenome.S_pseudosimplitigsAC.k_13.d_10.M_default
spneumoniae-pangenome	pseudosimplitigsAC	13	10	ones	5038555	6614600	5640820	973780	533883	1722204	450132	2172336	2173700	spneumoniae-pangenome.S_pseudosimplitigsAC.k_13.d_10.M_ones
spneumoniae-pangenome	pseudosimplitigsAC	13	10	runs	5038555	6614600	5591706	1022894	498644	1722204	441828	2164032	2164576	spneumoniae-pangenome.S_pseudosimplitigsAC.k_13.d_10.M_runs
spneumoniae-pangenome	pseudosimplitigsAC	13	10	zeros	5038555	6614600	5038555	1576045	777908	1722204	540696	2262900	2269772	spneumoniae-pangenome.S_pseudosimplitigsAC.k_13.d_10.M_zeros
spneumoniae-pangenome	pseudosimplitigsAC	13	11	default	5038555	6612912	5038555	1574357	761573	1721692	515904	2237596	2245260	spneumoniae-pangenome.S_pseudosimplitigsAC.k_13.d_11.M_default
spneumoniae-pangenome	pseudosimplitigsAC	13	11	ones	5038555	6612912	5640920	971992	533661	1721692	449924	2171616	2172712	spneumoniae-pangenome.S_pseudosimplitigsAC.k_13.d_11.M_ones
spneumoniae-pangenome	pseudosimplitigsAC	13	11	runs	5038555	6612912	5592407	1020505	498649	1721692	441860	2163552	2164460	spneumoniae-pangenome.S_pseudosimplitigsAC.k_13.d_11.M_runs
spneumoniae-pangenome	pseudosimplitigsAC	13	11	zeros	5038555	6612912	5038555	1574357	777961	1721692	541180	2262872	2268620	spneumoniae-pangenome.S_pseudosimplitigsAC.k_13.d_11.M_zeros
spneumoniae-pangenome	pseudosimplitigsAC	13	12	default	5038555	6613366	5038555	1574811	761603	1721692	515904	2237596	2244900	spneumoniae-pangenome.S_pseudosimplitigsAC.k_13.d_12.M_default
spneumoniae-pangenome	pseudosimplitigsAC	13	12	ones	5038555	6613366	5640668	972698	533751	1721692	449960	2171652	2172732	spneumoniae-pangenome.S_pseudosimplitigsAC.k_13.d_12.M_ones
spneumoniae-pangenome	pseudosimplitigsAC	13	12	runs	5038555	6613366	5592061	1021305	498703	1721692	441844	2163536	2164880	spneumoniae-pangenome.S_pseudosimplitigsAC.k_13.d_12.M_runs
spneumoniae-pangenome	pseudosimplitigsAC	13	12	zeros	5038555	6613366	5038555	1574811	777991	1721692	541168	2262860	2268268	spneumoniae-pangenome.S_pseudosimplitigsAC.k_13.d_12.M_zeros
spneumoniae-pangenome	pseudosimplitigsAC	13	2	default	5038555	8150553	5038555	3111998	606693	2143116	437176	2580292	2694868	spneumoniae-pangenome.S_pseudosimplitigsAC.k_13.d_2.M_default
spneumoniae-pangenome	pseudosimplitigsAC	13	2	ones	5038555	8150553	6107256	2043297	642601	2143116	602108	2745224	2742892	spneumoniae-pangenome.S_pseudosimplitigsAC.k_13.d_2.M_ones
spneumoniae-pangenome	pseudosimplitigsAC	13	2	runs	5038555	8150553	5646718	2503835	392166	2143116	438412	2581528	2607260	spneumoniae-pangenome.S_pseudosimplitigsAC.k_13.d_2.M_runs
spneumoniae-pangenome	pseudosimplitigsAC	13	2	zeros	5038555	8150553	5038555	3111998	642634	2143116	495548	2638664	2726748	spneumoniae-pangenome.S_pseudosimplitigsAC.k_13.d_2.M_zeros
spneumoniae-pangenome	pseudosimplitigsAC	13	3	default	5038555	7327892	5038555	2289337	706265	1917048	488540	2405588	2476864	spneumoniae-pangenome.S_pseudosimplitigsAC.k_13.d_3.M_default
spneumoniae-pangenome	pseudosimplitigsAC	13	3	ones	5038555	7327892	5820672	1507220	572896	1917048	514288	2431336	2436368	spneumoniae-pangenome.S_pseudosimplitigsAC.k_13.d_3.M_ones
spneumoniae-pangenome	pseudosimplitigsAC	13	3	runs	5038555	7327892	5600436	1727456	445737	1917048	436736	2353784	2382388	spneumoniae-pangenome.S_pseudosimplitigsAC.k_13.d_3.M_runs
spneumoniae-pangenome	pseudosimplitigsAC	13	3	zeros	5038555	7327892	5038555	2289337	709983	1917048	498244	2415292	2479880	spneumoniae-pangenome.S_pseudosimplitigsAC.k_13.d_3.M_zeros
spneumoniae-pangenome	pseudosimplitigsAC	13	4	default	5038555	6922495	5038555	1883940	748068	1811732	505956	2317688	2350984	spneumoniae-pangenome.S_pseudosimplitigsAC.k_13.d_4.M_default
spneumoniae-pangenome	pseudosimplitigsAC	13	4	ones	5038555	6922495	5705931	1216564	550087	1811732	476468	2288200	2288020	spneumoniae-pangenome.S_pseudosimplitigsAC.k_13.d_4.M_ones
spneumoniae-pangenome	pseudosimplitigsAC	13	4	runs	5038555	6922495	5593836	1328659	480796	1811732	442772	2254504	2263692	spneumoniae-pangenome.S_pseudosimplitigsAC.k_13.d_4.M_runs
spneumoniae-pangenome	pseudosimplitigsAC	13	4	zeros	5038555	6922495	5038555	1883940	748299	1811732	507384	2319116	2352348	spneumoniae-pangenome.S_pseudosimplitigsAC.k_13.d_4.M_zeros
spneumoniae-pangenome	pseudosimplitigsAC	13	5	default	5038555	6733243	5038555	1694688	759051	1755288	511104	2266392	2289144	spneumoniae-pangenome.S_pseudosimplitigsAC.k_13.d_5.M_default
spneumoniae-pangenome	pseudosimplitigsAC	13	5	ones	5038555	6733243	5659861	1073382	542119	1755288	461200	2216488	2217228	spneumoniae-pangenome.S_pseudosimplitigsAC.k_13.d_5.M_ones
spneumoniae-pangenome	pseudosimplitigsAC	13	5	runs	5038555	6733243	5589547	1143696	495301	1755288	444152	2199440	2205048	spneumoniae-pangenome.S_pseudosimplitigsAC.k_13.d_5.M_runs
spneumoniae-pangenome	pseudosimplitigsAC	13	5	zeros	5038555	6733243	5038555	1694688	759814	1755288	516144	2271432	2291844	spneumoniae-pangenome.S_pseudosimplitigsAC.k_13.d_5.M_zeros
spneumoniae-pangenome	pseudosimplitigsAC	13	6	default	5038555	6651203	5038555	1612648	760261	1728528	512244	2240772	2259544	spneumoniae-pangenome.S_pseudosimplitigsAC.k_13.d_6.M_default
spneumoniae-pangenome	pseudosimplitigsAC	13	6	ones	5038555	6651203	5641455	1009748	536118	1728528	453048	2181576	2185888	spneumoniae-pangenome.S_pseudosimplitigsAC.k_13.d_6.M_ones
spneumoniae-pangenome	pseudosimplitigsAC	13	6	runs	5038555	6651203	5586865	1064338	497665	1728528	441736	2170264	2176680	spneumoniae-pangenome.S_pseudosimplitigsAC.k_13.d_6.M_runs
spneumoniae-pangenome	pseudosimplitigsAC	13	6	zeros	5038555	6651203	5038555	1612648	761542	1728528	518012	2246540	2263348	spneumoniae-pangenome.S_pseudosimplitigsAC.k_13.d_6.M_zeros
spneumoniae-pangenome	pseudosimplitigsAC	13	7	default	5038555	6625786	5038555	1587231	761026	1722804	513620	2236424	2251548	spneumoniae-pangenome.S_pseudosimplitigsAC.k_13.d_7.M_default
spneumoniae-pangenome	pseudosimplitigsAC	13	7	ones	5038555	6625786	5639381	986405	534248	1722804	450856	2173660	2178000	spneumoniae-pangenome.S_pseudosimplitigsAC.k_13.d_7.M_ones
spneumoniae-pangenome	pseudosimplitigsAC	13	7	runs	5038555	6625786	5588942	1036844	498314	1722804	442016	2164820	2169944	spneumoniae-pangenome.S_pseudosimplitigsAC.k_13.d_7.M_runs
spneumoniae-pangenome	pseudosimplitigsAC	13	7	zeros	5038555	6625786	5038555	1587231	775739	1722804	537116	2259920	2273752	spneumoniae-pangenome.S_pseudosimplitigsAC.k_13.d_7.M_zeros
spneumoniae-pangenome	pseudosimplitigsAC	13	8	default	5038555	6618329	5038555	1579774	761325	1720008	514320	2234328	2248868	spneumoniae-pangenome.S_pseudosimplitigsAC.k_13.d_8.M_default
spneumoniae-pangenome	pseudosimplitigsAC	13	8	ones	5038555	6618329	5639270	979059	533836	1720008	450540	2170548	2175976	spneumoniae-pangenome.S_pseudosimplitigsAC.k_13.d_8.M_ones
spneumoniae-pangenome	pseudosimplitigsAC	13	8	runs	5038555	6618329	5589990	1028339	498537	1720008	441928	2161936	2165940	spneumoniae-pangenome.S_pseudosimplitigsAC.k_13.d_8.M_runs
spneumoniae-pangenome	pseudosimplitigsAC	13	8	zeros	5038555	6618329	5038555	1579774	777576	1720008	539708	2259716	2271924	spneumoniae-pangenome.S_pseudosimplitigsAC.k_13.d_8.M_zeros
spneumoniae-pangenome	pseudosimplitigsAC	13	9	default	5038555	6614838	5038555	1576283	761400	1722520	515020	2237540	2247036	spneumoniae-pangenome.S_pseudosimplitigsAC.k_13.d_9.M_default
spneumoniae-pangenome	pseudosimplitigsAC	13	9	ones	5038555	6614838	5640087	974751	533590	1722520	450040	2172560	2173940	spneumoniae-pangenome.S_pseudosimplitigsAC.k_13.d_9.M_ones
spneumoniae-pangenome	pseudosimplitigsAC	13	9	runs	5038555	6614838	5591443	1023395	498586	1722520	441784	2164304	2167076	spneumoniae-pangenome.S_pseudosimplitigsAC.k_13.d_9.M_runs
spneumoniae-pangenome	pseudosimplitigsAC	13	9	zeros	5038555	6614838	5038555	1576283	777785	1722520	540300	2262820	2270464	spneumoniae-pangenome.S_pseudosimplitigsAC.k_13.d_9.M_zeros
spneumoniae-pangenome	pseudosimplitigs	14	1	default	6089164	10737444	6089164	4648280	357560	2737580	327788	3065368	3261420	spneumoniae-pangenome.S_pseudosimplitigs.k_14.d_1.M_default
spneumoniae-pangenome	pseudosimplitigs	14	1	ones	6089164	10737444	7035102	3702342	639716	2737580	706720	3444300	3512476	spneumoniae-pangenome.S_pseudosimplitigs.k_14.d_1.M_ones
spneumoniae-pangenome	pseudosimplitigs	14	1	runs	6089164	10737444	6547848	4189596	351387	2737580	460304	3197884	3272740	spneumoniae-pangenome.S_pseudosimplitigs.k_14.d_1.M_runs
spneumoniae-pangenome	pseudosimplitigs	14	1	zeros	6089164	10737444	6089164	4648280	485135	2737580	534676	3272256	3406152	spneumoniae-pangenome.S_pseudosimplitigs.k_14.d_1.M_zeros
spneumoniae-pangenome	pseudosimplitigs	14	10	default	6089164	7999567	6089164	1910403	727530	2026776	602588	2629364	2656688	spneumoniae-pangenome.S_pseudosimplitigs.k_14.d_10.M_default
spneumoniae-pangenome	pseudosimplitigs	14	10	ones	6089164	7999567	6616105	1383462	551945	2026776	522540	2549316	2570128	spneumoniae-pangenome.S_pseudosimplitigs.k_14.d_10.M_ones
spneumoniae-pangenome	pseudosimplitigs	14	10	runs	6089164	7999567	6568480	1431087	515952	2026776	507784	2534560	2556108	spneumoniae-pangenome.S_pseudosimplitigs.k_14.d_10.M_runs
spneumoniae-pangenome	pseudosimplitigs	14	10	zeros	6089164	7999567	6089164	1910403	731401	2026776	607700	2634476	2660472	spneumoniae-pangenome.S_pseudosimplitigs.k_14.d_10.M_zeros
spneumoniae-pangenome	pseudosimplitigs	14	11	default	6089164	8001376	6089164	1912212	727737	2026876	603036	2629912	2656352	spneumoniae-pangenome.S_pseudosimplitigs.k_14.d_11.M_default
spneumoniae-pangenome	pseudosimplitigs	14	11	ones	6089164	8001376	6616362	1385014	552319	2026876	522904	2549780	2570372	spneumoniae-pangenome.S_pseudosimplitigs.k_14.d_11.M_ones
spneumoniae-pangenome	pseudosimplitigs	14	11	runs	6089164	8001376	6568375	1433001	516141	2026876	507828	2534704	2554844	spneumoniae-pangenome.S_pseudosimplitigs.k_14.d_11.M_runs
spneumoniae-pangenome	pseudosimplitigs	14	11	zeros	6089164	8001376	6089164	1912212	731609	2026876	608104	2634980	2660152	spneumoniae-pangenome.S_pseudosimplitigs.k_14.d_11.M_zeros
spneumoniae-pangenome	pseudosimplitigs	14	12	default	6089164	8003584	6089164	1914420	727812	2026780	603700	2630480	2655476	spneumoniae-pangenome.S_pseudosimplitigs.k_14.d_12.M_default
spneumoniae-pangenome	pseudosimplitigs	14	12	ones	6089164	8003584	6617062	1386522	552457	2026780	523172	2549952	2570248	spneumoniae-pangenome.S_pseudosimplitigs.k_14.d_12.M_ones
spneumoniae-pangenome	pseudosimplitigs	14	12	runs	6089164	8003584	6568766	1434818	516102	2026780	508068	2534848	2555452	spneumoniae-pangenome.S_pseudosimplitigs.k_14.d_12.M_runs
spneumoniae-pangenome	pseudosimplitigs	14	12	zeros	6089164	8003584	6089164	1914420	731684	2026780	608768	2635548	2659256	spneumoniae-pangenome.S_pseudosimplitigs.k_14.d_12.M_zeros
spneumoniae-pangenome	pseudosimplitigs	14	2	default	6089164	9138938	6089164	3049774	461326	2337900	438888	2776788	2895924	spneumoniae-pangenome.S_pseudosimplitigs.k_14.d_2.M_default
spneumoniae-pangenome	pseudosimplitigs	14	2	ones	6089164	9138938	6738882	2400056	460523	2337900	534316	2872216	2903664	spneumoniae-pangenome.S_pseudosimplitigs.k_14.d_2.M_ones
spneumoniae-pangenome	pseudosimplitigs	14	2	runs	6089164	9138938	6488489	2650449	306108	2337900	405032	2742932	2787656	spneumoniae-pangenome.S_pseudosimplitigs.k_14.d_2.M_runs
spneumoniae-pangenome	pseudosimplitigs	14	2	zeros	6089164	9138938	6089164	3049774	492858	2337900	485412	2823312	2926388	spneumoniae-pangenome.S_pseudosimplitigs.k_14.d_2.M_zeros
spneumoniae-pangenome	pseudosimplitigs	14	3	default	6089164	8643684	6089164	2554520	566188	2215248	508592	2723840	2817204	spneumoniae-pangenome.S_pseudosimplitigs.k_14.d_3.M_default
spneumoniae-pangenome	pseudosimplitigs	14	3	ones	6089164	8643684	6659621	1984063	465792	2215248	514680	2729928	2754264	spneumoniae-pangenome.S_pseudosimplitigs.k_14.d_3.M_ones
spneumoniae-pangenome	pseudosimplitigs	14	3	runs	6089164	8643684	6512107	2131577	371319	2215248	440460	2655708	2694572	spneumoniae-pangenome.S_pseudosimplitigs.k_14.d_3.M_runs
spneumoniae-pangenome	pseudosimplitigs	14	3	zeros	6089164	8643684	6089164	2554520	572397	2215248	518572	2733820	2822204	spneumoniae-pangenome.S_pseudosimplitigs.k_14.d_3.M_zeros
spneumoniae-pangenome	pseudosimplitigs	14	4	default	6089164	8372970	6089164	2283806	652891	2145608	557020	2702628	2769396	spneumoniae-pangenome.S_pseudosimplitigs.k_14.d_4.M_default
spneumoniae-pangenome	pseudosimplitigs	14	4	ones	6089164	8372970	6630155	1742815	509735	2145608	523580	2669188	2688004	spneumoniae-pangenome.S_pseudosimplitigs.k_14.d_4.M_ones
spneumoniae-pangenome	pseudosimplitigs	14	4	runs	6089164	8372970	6539378	1833592	448740	2145608	479604	2625212	2655568	spneumoniae-pangenome.S_pseudosimplitigs.k_14.d_4.M_runs
spneumoniae-pangenome	pseudosimplitigs	14	4	zeros	6089164	8372970	6089164	2283806	653710	2145608	559084	2704692	2769692	spneumoniae-pangenome.S_pseudosimplitigs.k_14.d_4.M_zeros
spneumoniae-pangenome	pseudosimplitigs	14	5	default	6089164	8156552	6089164	2067388	697348	2085772	582856	2668628	2708348	spneumoniae-pangenome.S_pseudosimplitigs.k_14.d_5.M_default
spneumoniae-pangenome	pseudosimplitigs	14	5	ones	6089164	8156552	6619530	1537022	531829	2085772	521408	2607180	2621040	spneumoniae-pangenome.S_pseudosimplitigs.k_14.d_5.M_ones
spneumoniae-pangenome	pseudosimplitigs	14	5	runs	6089164	8156552	6558465	1598087	488344	2085772	496240	2582012	2603024	spneumoniae-pangenome.S_pseudosimplitigs.k_14.d_5.M_runs
spneumoniae-pangenome	pseudosimplitigs	14	5	zeros	6089164	8156552	6089164	2067388	697632	2085772	583300	2669072	2708832	spneumoniae-pangenome.S_pseudosimplitigs.k_14.d_5.M_zeros
spneumoniae-pangenome	pseudosimplitigs	14	6	default	6089164	8043187	6089164	1954023	717472	2052372	592072	2644444	2674160	spneumoniae-pangenome.S_pseudosimplitigs.k_14.d_6.M_default
spneumoniae-pangenome	pseudosimplitigs	14	6	ones	6089164	8043187	6615089	1428098	543623	2052372	521188	2573560	2587372	spneumoniae-pangenome.S_pseudosimplitigs.k_14.d_6.M_ones
spneumoniae-pangenome	pseudosimplitigs	14	6	runs	6089164	8043187	6565511	1477676	506929	2052372	503212	2555584	2572596	spneumoniae-pangenome.S_pseudosimplitigs.k_14.d_6.M_runs
spneumoniae-pangenome	pseudosimplitigs	14	6	zeros	6089164	8043187	6089164	1954023	718129	2052372	595256	2647628	2675420	spneumoniae-pangenome.S_pseudosimplitigs.k_14.d_6.M_zeros
spneumoniae-pangenome	pseudosimplitigs	14	7	default	6089164	8008113	6089164	1918949	724799	2034900	599156	2634056	2662484	spneumoniae-pangenome.S_pseudosimplitigs.k_14.d_7.M_default
spneumoniae-pangenome	pseudosimplitigs	14	7	ones	6089164	8008113	6613403	1394710	549599	2034900	521648	2556548	2574656	spneumoniae-pangenome.S_pseudosimplitigs.k_14.d_7.M_ones
spneumoniae-pangenome	pseudosimplitigs	14	7	runs	6089164	8008113	6566142	1441971	514023	2034900	505868	2540768	2560996	spneumoniae-pangenome.S_pseudosimplitigs.k_14.d_7.M_runs
spneumoniae-pangenome	pseudosimplitigs	14	7	zeros	6089164	8008113	6089164	1918949	727696	2034900	603052	2637952	2665044	spneumoniae-pangenome.S_pseudosimplitigs.k_14.d_7.M_zeros
spneumoniae-pangenome	pseudosimplitigs	14	8	default	6089164	7996473	6089164	1907309	726305	2029896	600428	2630324	2659120	spneumoniae-pangenome.S_pseudosimplitigs.k_14.d_8.M_default
spneumoniae-pangenome	pseudosimplitigs	14	8	ones	6089164	7996473	6613595	1382878	550513	2029896	521416	2551312	2570504	spneumoniae-pangenome.S_pseudosimplitigs.k_14.d_8.M_ones
spneumoniae-pangenome	pseudosimplitigs	14	8	runs	6089164	7996473	6566637	1429836	515117	2029896	506472	2536368	2558076	spneumoniae-pangenome.S_pseudosimplitigs.k_14.d_8.M_runs
spneumoniae-pangenome	pseudosimplitigs	14	8	zeros	6089164	7996473	6089164	1907309	730095	2029896	605396	2635292	2662612	spneumoniae-pangenome.S_pseudosimplitigs.k_14.d_8.M_zeros
spneumoniae-pangenome	pseudosimplitigs	14	9	default	6089164	7997784	6089164	1908620	727203	2027412	601644	2629056	2657724	spneumoniae-pangenome.S_pseudosimplitigs.k_14.d_9.M_default
spneumoniae-pangenome	pseudosimplitigs	14	9	ones	6089164	7997784	6615162	1382622	551408	2027412	521880	2549292	2569828	spneumoniae-pangenome.S_pseudosimplitigs.k_14.d_9.M_ones
spneumoniae-pangenome	pseudosimplitigs	14	9	runs	6089164	7997784	6567969	1429815	515735	2027412	507104	2534516	2557196	spneumoniae-pangenome.S_pseudosimplitigs.k_14.d_9.M_runs
spneumoniae-pangenome	pseudosimplitigs	14	9	zeros	6089164	7997784	6089164	1908620	731017	2027412	606536	2633948	2661200	spneumoniae-pangenome.S_pseudosimplitigs.k_14.d_9.M_zeros
spneumoniae-pangenome	pseudosimplitigsAC	14	1	default	6089164	10737457	6089164	4648293	357561	2736736	323264	3060000	3269860	spneumoniae-pangenome.S_pseudosimplitigsAC.k_14.d_1.M_default
spneumoniae-pangenome	pseudosimplitigsAC	14	1	ones	6089164	10737457	7034432	3703025	638326	2736736	699572	3436308	3512208	spneumoniae-pangenome.S_pseudosimplitigsAC.k_14.d_1.M_ones
spneumoniae-pangenome	pseudosimplitigsAC	14	1	runs	6089164	10737457	6543758	4193699	350324	2736736	455496	3192232	3280496	spneumoniae-pangenome.S_pseudosimplitigsAC.k_14.d_1.M_runs
spneumoniae-pangenome	pseudosimplitigsAC	14	1	zeros	6089164	10737457	6089164	4648293	485721	2736736	530376	3267112	3409848	spneumoniae-pangenome.S_pseudosimplitigsAC.k_14.d_1.M_zeros
spneumoniae-pangenome	pseudosimplitigsAC	14	10	default	6089164	7921103	6089164	1831939	710667	2019228	578204	2597432	2634908	spneumoniae-pangenome.S_pseudosimplitigsAC.k_14.d_10.M_default
spneumoniae-pangenome	pseudosimplitigsAC	14	10	ones	6089164	7921103	6606644	1314459	535318	2019228	502452	2521680	2549112	spneumoniae-pangenome.S_pseudosimplitigsAC.k_14.d_10.M_ones
spneumoniae-pangenome	pseudosimplitigsAC	14	10	runs	6089164	7921103	6563164	1357939	502626	2019228	489112	2508340	2535136	spneumoniae-pangenome.S_pseudosimplitigsAC.k_14.d_10.M_runs
spneumoniae-pangenome	pseudosimplitigsAC	14	10	zeros	6089164	7921103	6089164	1831939	719955	2019228	594988	2614216	2648800	spneumoniae-pangenome.S_pseudosimplitigsAC.k_14.d_10.M_zeros
spneumoniae-pangenome	pseudosimplitigsAC	14	11	default	6089164	7920604	6089164	1831440	710771	2019332	578904	2598236	2635644	spneumoniae-pangenome.S_pseudosimplitigsAC.k_14.d_11.M_default
spneumoniae-pangenome	pseudosimplitigsAC	14	11	ones	6089164	7920604	6606681	1313923	535448	2019332	502432	2521764	2547308	spneumoniae-pangenome.S_pseudosimplitigsAC.k_14.d_11.M_ones
spneumoniae-pangenome	pseudosimplitigsAC	14	11	runs	6089164	7920604	6563189	1357415	502767	2019332	488904	2508236	2535556	spneumoniae-pangenome.S_pseudosimplitigsAC.k_14.d_11.M_runs
spneumoniae-pangenome	pseudosimplitigsAC	14	11	zeros	6089164	7920604	6089164	1831440	720245	2019332	595496	2614828	2647440	spneumoniae-pangenome.S_pseudosimplitigsAC.k_14.d_11.M_zeros
spneumoniae-pangenome	pseudosimplitigsAC	14	12	default	6089164	7919683	6089164	1830519	710826	2019032	579160	2598192	2634892	spneumoniae-pangenome.S_pseudosimplitigsAC.k_14.d_12.M_default
spneumoniae-pangenome	pseudosimplitigsAC	14	12	ones	6089164	7919683	6606994	1312689	535597	2019032	502516	2521548	2546872	spneumoniae-pangenome.S_pseudosimplitigsAC.k_14.d_12.M_ones
spneumoniae-pangenome	pseudosimplitigsAC	14	12	runs	6089164	7919683	6563371	1356312	502845	2019032	489192	2508224	2535376	spneumoniae-pangenome.S_pseudosimplitigsAC.k_14.d_12.M_runs
spneumoniae-pangenome	pseudosimplitigsAC	14	12	zeros	6089164	7919683	6089164	1830519	720300	2019032	595760	2614792	2646652	spneumoniae-pangenome.S_pseudosimplitigsAC.k_14.d_12.M_zeros
spneumoniae-pangenome	pseudosimplitigsAC	14	2	default	6089164	9121024	6089164	3031860	458136	2334608	429056	2763664	2895444	spneumoniae-pangenome.S_pseudosimplitigsAC.k_14.d_2.M_default
spneumoniae-pangenome	pseudosimplitigsAC	14	2	ones	6089164	9121024	6739619	2381405	454108	2334608	522080	2856688	2896348	spneumoniae-pangenome.S_pseudosimplitigsAC.k_14.d_2.M_ones
spneumoniae-pangenome	pseudosimplitigsAC	14	2	runs	6089164	9121024	6490339	2630685	300990	2334608	394640	2729248	2784556	spneumoniae-pangenome.S_pseudosimplitigsAC.k_14.d_2.M_runs
spneumoniae-pangenome	pseudosimplitigsAC	14	2	zeros	6089164	9121024	6089164	3031860	488903	2334608	475396	2810004	2924284	spneumoniae-pangenome.S_pseudosimplitigsAC.k_14.d_2.M_zeros
spneumoniae-pangenome	pseudosimplitigsAC	14	3	default	6089164	8623196	6089164	2534032	560478	2216076	496404	2712480	2815380	spneumoniae-pangenome.S_pseudosimplitigsAC.k_14.d_3.M_default
spneumoniae-pangenome	pseudosimplitigsAC	14	3	ones	6089164	8623196	6663329	1959867	457849	2216076	501920	2717996	2747816	spneumoniae-pangenome.S_pseudosimplitigsAC.k_14.d_3.M_ones
spneumoniae-pangenome	pseudosimplitigsAC	14	3	runs	6089164	8623196	6515902	2107294	363530	2216076	429016	2645092	2687976	spneumoniae-pangenome.S_pseudosimplitigsAC.k_14.d_3.M_runs
spneumoniae-pangenome	pseudosimplitigsAC	14	3	zeros	6089164	8623196	6089164	2534032	566398	2216076	506388	2722464	2820048	spneumoniae-pangenome.S_pseudosimplitigsAC.k_14.d_3.M_zeros
spneumoniae-pangenome	pseudosimplitigsAC	14	4	default	6089164	8347243	6089164	2258079	645901	2143752	544716	2688468	2764552	spneumoniae-pangenome.S_pseudosimplitigsAC.k_14.d_4.M_default
spneumoniae-pangenome	pseudosimplitigsAC	14	4	ones	6089164	8347243	6630752	1716491	499008	2143752	508844	2652596	2680108	spneumoniae-pangenome.S_pseudosimplitigsAC.k_14.d_4.M_ones
spneumoniae-pangenome	pseudosimplitigsAC	14	4	runs	6089164	8347243	6541941	1805302	439473	2143752	465964	2609716	2650744	spneumoniae-pangenome.S_pseudosimplitigsAC.k_14.d_4.M_runs
spneumoniae-pangenome	pseudosimplitigsAC	14	4	zeros	6089164	8347243	6089164	2258079	646625	2143752	548520	2692272	2764528	spneumoniae-pangenome.S_pseudosimplitigsAC.k_14.d_4.M_zeros
spneumoniae-pangenome	pseudosimplitigsAC	14	5	default	6089164	8141089	6089164	2051925	691631	2086644	568552	2655196	2707900	spneumoniae-pangenome.S_pseudosimplitigsAC.k_14.d_5.M_default
spneumoniae-pangenome	pseudosimplitigsAC	14	5	ones	6089164	8141089	6617844	1523245	526402	2086644	510056	2596700	2621824	spneumoniae-pangenome.S_pseudosimplitigsAC.k_14.d_5.M_ones
spneumoniae-pangenome	pseudosimplitigsAC	14	5	runs	6089164	8141089	6557618	1583471	483627	2086644	485808	2572452	2603280	spneumoniae-pangenome.S_pseudosimplitigsAC.k_14.d_5.M_runs
spneumoniae-pangenome	pseudosimplitigsAC	14	5	zeros	6089164	8141089	6089164	2051925	692484	2086644	572432	2659076	2709228	spneumoniae-pangenome.S_pseudosimplitigsAC.k_14.d_5.M_zeros
spneumoniae-pangenome	pseudosimplitigsAC	14	6	default	6089164	8012363	6089164	1923199	706041	2051700	571700	2623400	2667204	spneumoniae-pangenome.S_pseudosimplitigsAC.k_14.d_6.M_default
spneumoniae-pangenome	pseudosimplitigsAC	14	6	ones	6089164	8012363	6609664	1402699	533817	2051700	506248	2557948	2580256	spneumoniae-pangenome.S_pseudosimplitigsAC.k_14.d_6.M_ones
spneumoniae-pangenome	pseudosimplitigsAC	14	6	runs	6089164	8012363	6561403	1450960	498270	2051700	488972	2540672	2565932	spneumoniae-pangenome.S_pseudosimplitigsAC.k_14.d_6.M_runs
spneumoniae-pangenome	pseudosimplitigsAC	14	6	zeros	6089164	8012363	6089164	1923199	709639	2051700	583040	2634740	2673584	spneumoniae-pangenome.S_pseudosimplitigsAC.k_14.d_6.M_zeros
spneumoniae-pangenome	pseudosimplitigsAC	14	7	default	6089164	7952928	6089164	1863764	709155	2031124	576192	2607316	2648920	spneumoniae-pangenome.S_pseudosimplitigsAC.k_14.d_7.M_default
spneumoniae-pangenome	pseudosimplitigsAC	14	7	ones	6089164	7952928	6606494	1346434	534706	2031124	503708	2534832	2559864	spneumoniae-pangenome.S_pseudosimplitigsAC.k_14.d_7.M_ones
spneumoniae-pangenome	pseudosimplitigsAC	14	7	runs	6089164	7952928	6561971	1390957	501385	2031124	488688	2519812	2548004	spneumoniae-pangenome.S_pseudosimplitigsAC.k_14.d_7.M_runs
spneumoniae-pangenome	pseudosimplitigsAC	14	7	zeros	6089164	7952928	6089164	1863764	717686	2031124	591872	2622996	2661188	spneumoniae-pangenome.S_pseudosimplitigsAC.k_14.d_7.M_zeros
spneumoniae-pangenome	pseudosimplitigsAC	14	8	default	6089164	7931322	6089164	1842158	710342	2022924	577068	2599992	2640832	spneumoniae-pangenome.S_pseudosimplitigsAC.k_14.d_8.M_default
spneumoniae-pangenome	pseudosimplitigsAC	14	8	ones	6089164	7931322	6605970	1325352	535140	2022924	502780	2525704	2551840	spneumoniae-pangenome.S_pseudosimplitigsAC.k_14.d_8.M_ones
spneumoniae-pangenome	pseudosimplitigsAC	14	8	runs	6089164	7931322	6562360	1368962	502444	2022924	488908	2511832	2539416	spneumoniae-pangenome.S_pseudosimplitigsAC.k_14.d_8.M_runs
spneumoniae-pangenome	pseudosimplitigsAC	14	8	zeros	6089164	7931322	6089164	1842158	718885	2022924	592732	2615656	2652892	spneumoniae-pangenome.S_pseudosimplitigsAC.k_14.d_8.M_zeros
spneumoniae-pangenome	pseudosimplitigsAC	14	9	default	6089164	7923630	6089164	1834466	710548	2019896	578192	2598088	2636336	spneumoniae-pangenome.S_pseudosimplitigsAC.k_14.d_9.M_default
spneumoniae-pangenome	pseudosimplitigsAC	14	9	ones	6089164	7923630	6606467	1317163	535353	2019896	502612	2522508	2548456	spneumoniae-pangenome.S_pseudosimplitigsAC.k_14.d_9.M_ones
spneumoniae-pangenome	pseudosimplitigsAC	14	9	runs	6089164	7923630	6562733	1360897	502561	2019896	488976	2508872	2536456	spneumoniae-pangenome.S_pseudosimplitigsAC.k_14.d_9.M_runs
spneumoniae-pangenome	pseudosimplitigsAC	14	9	zeros	6089164	7923630	6089164	1834466	719617	2019896	594336	2614232	2651604	spneumoniae-pangenome.S_pseudosimplitigsAC.k_14.d_9.M_zeros
spneumoniae-pangenome	pseudosimplitigs	15	1	default	6634628	10113096	6634628	3478468	248462	2505872	272136	2778008	2963672	spneumoniae-pangenome.S_pseudosimplitigs.k_15.d_1.M_default
spneumoniae-pangenome	pseudosimplitigs	15	1	ones	6634628	10113096	7020465	3092631	340422	2505872	457756	2963628	3066336	spneumoniae-pangenome.S_pseudosimplitigs.k_15.d_1.M_ones
spneumoniae-pangenome	pseudosimplitigs	15	1	runs	6634628	10113096	6877150	3235946	246690	2505872	347224	2853096	2969424	spneumoniae-pangenome.S_pseudosimplitigs.k_15.d_1.M_runs
spneumoniae-pangenome	pseudosimplitigs	15	1	zeros	6634628	10113096	6634628	3478468	294845	2505872	362380	2868252	3025304	spneumoniae-pangenome.S_pseudosimplitigs.k_15.d_1.M_zeros
spneumoniae-pangenome	pseudosimplitigs	15	10	default	6634628	8737793	6634628	2103165	585586	2174600	552272	2726872	2797308	spneumoniae-pangenome.S_pseudosimplitigs.k_15.d_10.M_default
spneumoniae-pangenome	pseudosimplitigs	15	10	ones	6634628	8737793	7033444	1704349	489107	2174600	503020	2677620	2734632	spneumoniae-pangenome.S_pseudosimplitigs.k_15.d_10.M_ones
spneumoniae-pangenome	pseudosimplitigs	15	10	runs	6634628	8737793	6997394	1740399	462302	2174600	488816	2663416	2721276	spneumoniae-pangenome.S_pseudosimplitigs.k_15.d_10.M_runs
spneumoniae-pangenome	pseudosimplitigs	15	10	zeros	6634628	8737793	6634628	2103165	590088	2174600	561472	2736072	2805888	spneumoniae-pangenome.S_pseudosimplitigs.k_15.d_10.M_zeros
spneumoniae-pangenome	pseudosimplitigs	15	11	default	6634628	8739144	6634628	2104516	585997	2173780	553476	2727256	2796852	spneumoniae-pangenome.S_pseudosimplitigs.k_15.d_11.M_default
spneumoniae-pangenome	pseudosimplitigs	15	11	ones	6634628	8739144	7034091	1705053	489606	2173780	503552	2677332	2734288	spneumoniae-pangenome.S_pseudosimplitigs.k_15.d_11.M_ones
spneumoniae-pangenome	pseudosimplitigs	15	11	runs	6634628	8739144	6997738	1741406	462653	2173780	489568	2663348	2721560	spneumoniae-pangenome.S_pseudosimplitigs.k_15.d_11.M_runs
spneumoniae-pangenome	pseudosimplitigs	15	11	zeros	6634628	8739144	6634628	2104516	590838	2173780	563300	2737080	2805056	spneumoniae-pangenome.S_pseudosimplitigs.k_15.d_11.M_zeros
spneumoniae-pangenome	pseudosimplitigs	15	12	default	6634628	8744908	6634628	2110280	586339	2174116	554172	2728288	2796896	spneumoniae-pangenome.S_pseudosimplitigs.k_15.d_12.M_default
spneumoniae-pangenome	pseudosimplitigs	15	12	ones	6634628	8744908	7034856	1710052	490144	2174116	504176	2678292	2735256	spneumoniae-pangenome.S_pseudosimplitigs.k_15.d_12.M_ones
spneumoniae-pangenome	pseudosimplitigs	15	12	runs	6634628	8744908	6998004	1746904	462728	2174116	490440	2664556	2722424	spneumoniae-pangenome.S_pseudosimplitigs.k_15.d_12.M_runs
spneumoniae-pangenome	pseudosimplitigs	15	12	zeros	6634628	8744908	6634628	2110280	591182	2174116	563988	2738104	2805216	spneumoniae-pangenome.S_pseudosimplitigs.k_15.d_12.M_zeros
spneumoniae-pangenome	pseudosimplitigs	15	2	default	6634628	9265771	6634628	2631143	285735	2299128	334344	2633472	2772780	spneumoniae-pangenome.S_pseudosimplitigs.k_15.d_2.M_default
spneumoniae-pangenome	pseudosimplitigs	15	2	ones	6634628	9265771	6953601	2312170	267211	2299128	377736	2676864	2753316	spneumoniae-pangenome.S_pseudosimplitigs.k_15.d_2.M_ones
spneumoniae-pangenome	pseudosimplitigs	15	2	runs	6634628	9265771	6869032	2396739	210041	2299128	309968	2609096	2695112	spneumoniae-pangenome.S_pseudosimplitigs.k_15.d_2.M_runs
spneumoniae-pangenome	pseudosimplitigs	15	2	zeros	6634628	9265771	6634628	2631143	301871	2299128	361580	2660708	2792008	spneumoniae-pangenome.S_pseudosimplitigs.k_15.d_2.M_zeros
spneumoniae-pangenome	pseudosimplitigs	15	3	default	6634628	9021684	6634628	2387056	343584	2246100	396664	2642764	2760028	spneumoniae-pangenome.S_pseudosimplitigs.k_15.d_3.M_default
spneumoniae-pangenome	pseudosimplitigs	15	3	ones	6634628	9021684	6961351	2060333	283909	2246100	390700	2636800	2698932	spneumoniae-pangenome.S_pseudosimplitigs.k_15.d_3.M_ones
spneumoniae-pangenome	pseudosimplitigs	15	3	runs	6634628	9021684	6901140	2120544	242588	2246100	345840	2591940	2662604	spneumoniae-pangenome.S_pseudosimplitigs.k_15.d_3.M_runs
spneumoniae-pangenome	pseudosimplitigs	15	3	zeros	6634628	9021684	6634628	2387056	348759	2246100	404800	2650900	2766792	spneumoniae-pangenome.S_pseudosimplitigs.k_15.d_3.M_zeros
spneumoniae-pangenome	pseudosimplitigs	15	4	default	6634628	8934828	6634628	2300200	427820	2237016	461968	2698984	2803364	spneumoniae-pangenome.S_pseudosimplitigs.k_15.d_4.M_default
spneumoniae-pangenome	pseudosimplitigs	15	4	ones	6634628	8934828	6990551	1944277	346247	2237016	435016	2672032	2727944	spneumoniae-pangenome.S_pseudosimplitigs.k_15.d_4.M_ones
spneumoniae-pangenome	pseudosimplitigs	15	4	runs	6634628	8934828	6944535	1990293	313909	2237016	406716	2643732	2703424	spneumoniae-pangenome.S_pseudosimplitigs.k_15.d_4.M_runs
spneumoniae-pangenome	pseudosimplitigs	15	4	zeros	6634628	8934828	6634628	2300200	428997	2237016	463904	2700920	2803772	spneumoniae-pangenome.S_pseudosimplitigs.k_15.d_4.M_zeros
spneumoniae-pangenome	pseudosimplitigs	15	5	default	6634628	8895630	6634628	2261002	511137	2231840	510932	2742772	2834196	spneumoniae-pangenome.S_pseudosimplitigs.k_15.d_5.M_default
spneumoniae-pangenome	pseudosimplitigs	15	5	ones	6634628	8895630	7012793	1882837	419286	2231840	474168	2706008	2761460	spneumoniae-pangenome.S_pseudosimplitigs.k_15.d_5.M_ones
spneumoniae-pangenome	pseudosimplitigs	15	5	runs	6634628	8895630	6975139	1920491	392284	2231840	453828	2685668	2744564	spneumoniae-pangenome.S_pseudosimplitigs.k_15.d_5.M_runs
spneumoniae-pangenome	pseudosimplitigs	15	5	zeros	6634628	8895630	6634628	2261002	511385	2231840	511528	2743368	2833660	spneumoniae-pangenome.S_pseudosimplitigs.k_15.d_5.M_zeros
spneumoniae-pangenome	pseudosimplitigs	15	6	default	6634628	8818087	6634628	2183459	560114	2208424	536788	2745212	2822044	spneumoniae-pangenome.S_pseudosimplitigs.k_15.d_6.M_default
spneumoniae-pangenome	pseudosimplitigs	15	6	ones	6634628	8818087	7021872	1796215	464932	2208424	495172	2703596	2753420	spneumoniae-pangenome.S_pseudosimplitigs.k_15.d_6.M_ones
spneumoniae-pangenome	pseudosimplitigs	15	6	runs	6634628	8818087	6988503	1829584	440178	2208424	479948	2688372	2740612	spneumoniae-pangenome.S_pseudosimplitigs.k_15.d_6.M_runs
spneumoniae-pangenome	pseudosimplitigs	15	6	zeros	6634628	8818087	6634628	2183459	561123	2208424	539088	2747512	2822368	spneumoniae-pangenome.S_pseudosimplitigs.k_15.d_6.M_zeros
spneumoniae-pangenome	pseudosimplitigs	15	7	default	6634628	8740257	6634628	2105629	575122	2188156	543732	2731888	2802520	spneumoniae-pangenome.S_pseudosimplitigs.k_15.d_7.M_default
spneumoniae-pangenome	pseudosimplitigs	15	7	ones	6634628	8740257	7027317	1712940	477688	2188156	496220	2684376	2737072	spneumoniae-pangenome.S_pseudosimplitigs.k_15.d_7.M_ones
spneumoniae-pangenome	pseudosimplitigs	15	7	runs	6634628	8740257	6994624	1745633	453286	2188156	482496	2670652	2724296	spneumoniae-pangenome.S_pseudosimplitigs.k_15.d_7.M_runs
spneumoniae-pangenome	pseudosimplitigs	15	7	zeros	6634628	8740257	6634628	2105629	575733	2188156	545532	2733688	2803324	spneumoniae-pangenome.S_pseudosimplitigs.k_15.d_7.M_zeros
spneumoniae-pangenome	pseudosimplitigs	15	8	default	6634628	8734149	6634628	2099521	582702	2176648	548796	2725444	2798760	spneumoniae-pangenome.S_pseudosimplitigs.k_15.d_8.M_default
spneumoniae-pangenome	pseudosimplitigs	15	8	ones	6634628	8734149	7031363	1702786	485781	2176648	500256	2676904	2734056	spneumoniae-pangenome.S_pseudosimplitigs.k_15.d_8.M_ones
spneumoniae-pangenome	pseudosimplitigs	15	8	runs	6634628	8734149	6997039	1737110	460063	2176648	486280	2662928	2721044	spneumoniae-pangenome.S_pseudosimplitigs.k_15.d_8.M_runs
spneumoniae-pangenome	pseudosimplitigs	15	8	zeros	6634628	8734149	6634628	2099521	583454	2176648	551004	2727652	2798896	spneumoniae-pangenome.S_pseudosimplitigs.k_15.d_8.M_zeros
spneumoniae-pangenome	pseudosimplitigs	15	9	default	6634628	8734648	6634628	2100020	584632	2174904	551180	2726084	2798116	spneumoniae-pangenome.S_pseudosimplitigs.k_15.d_9.M_default
spneumoniae-pangenome	pseudosimplitigs	15	9	ones	6634628	8734648	7032811	1701837	488026	2174904	501992	2676896	2734616	spneumoniae-pangenome.S_pseudosimplitigs.k_15.d_9.M_ones
spneumoniae-pangenome	pseudosimplitigs	15	9	runs	6634628	8734648	6997308	1737340	461623	2174904	488108	2663012	2721532	spneumoniae-pangenome.S_pseudosimplitigs.k_15.d_9.M_runs
spneumoniae-pangenome	pseudosimplitigs	15	9	zeros	6634628	8734648	6634628	2100020	588676	2174904	559160	2734064	2803792	spneumoniae-pangenome.S_pseudosimplitigs.k_15.d_9.M_zeros
spneumoniae-pangenome	pseudosimplitigsAC	15	1	default	6634628	10113166	6634628	3478538	248467	2508292	268504	2776796	2965084	spneumoniae-pangenome.S_pseudosimplitigsAC.k_15.d_1.M_default
spneumoniae-pangenome	pseudosimplitigsAC	15	1	ones	6634628	10113166	7020294	3092872	340591	2508292	453664	2961956	3067192	spneumoniae-pangenome.S_pseudosimplitigsAC.k_15.d_1.M_ones
spneumoniae-pangenome	pseudosimplitigsAC	15	1	runs	6634628	10113166	6875976	3237190	246549	2508292	343728	2852020	2970764	spneumoniae-pangenome.S_pseudosimplitigsAC.k_15.d_1.M_runs
spneumoniae-pangenome	pseudosimplitigsAC	15	1	zeros	6634628	10113166	6634628	3478538	294264	2508292	358504	2866796	3025324	spneumoniae-pangenome.S_pseudosimplitigsAC.k_15.d_1.M_zeros
spneumoniae-pangenome	pseudosimplitigsAC	15	10	default	6634628	8638723	6634628	2004095	574936	2156624	540512	2697136	2770220	spneumoniae-pangenome.S_pseudosimplitigsAC.k_15.d_10.M_default
spneumoniae-pangenome	pseudosimplitigsAC	15	10	ones	6634628	8638723	7021356	1617367	477053	2156624	489768	2646392	2706936	spneumoniae-pangenome.S_pseudosimplitigsAC.k_15.d_10.M_ones
spneumoniae-pangenome	pseudosimplitigsAC	15	10	runs	6634628	8638723	6991428	1647295	454402	2156624	477588	2634212	2695308	spneumoniae-pangenome.S_pseudosimplitigsAC.k_15.d_10.M_runs
spneumoniae-pangenome	pseudosimplitigsAC	15	10	zeros	6634628	8638723	6634628	2004095	593283	2156624	571840	2728464	2800512	spneumoniae-pangenome.S_pseudosimplitigsAC.k_15.d_10.M_zeros
spneumoniae-pangenome	pseudosimplitigsAC	15	11	default	6634628	8637175	6634628	2002547	575097	2156256	540652	2696908	2770368	spneumoniae-pangenome.S_pseudosimplitigsAC.k_15.d_11.M_default
spneumoniae-pangenome	pseudosimplitigsAC	15	11	ones	6634628	8637175	7021632	1615543	477298	2156256	489716	2645972	2705720	spneumoniae-pangenome.S_pseudosimplitigsAC.k_15.d_11.M_ones
spneumoniae-pangenome	pseudosimplitigsAC	15	11	runs	6634628	8637175	6991473	1645702	454515	2156256	477972	2634228	2694392	spneumoniae-pangenome.S_pseudosimplitigsAC.k_15.d_11.M_runs
spneumoniae-pangenome	pseudosimplitigsAC	15	11	zeros	6634628	8637175	6634628	2002547	593508	2156256	572488	2728744	2799748	spneumoniae-pangenome.S_pseudosimplitigsAC.k_15.d_11.M_zeros
spneumoniae-pangenome	pseudosimplitigsAC	15	12	default	6634628	8636447	6634628	2001819	575169	2155952	540880	2696832	2769768	spneumoniae-pangenome.S_pseudosimplitigsAC.k_15.d_12.M_default
spneumoniae-pangenome	pseudosimplitigsAC	15	12	ones	6634628	8636447	7021721	1614726	477391	2155952	489780	2645732	2705340	spneumoniae-pangenome.S_pseudosimplitigsAC.k_15.d_12.M_ones
spneumoniae-pangenome	pseudosimplitigsAC	15	12	runs	6634628	8636447	6991492	1644955	454586	2155952	477916	2633868	2693732	spneumoniae-pangenome.S_pseudosimplitigsAC.k_15.d_12.M_runs
spneumoniae-pangenome	pseudosimplitigsAC	15	12	zeros	6634628	8636447	6634628	2001819	593583	2155952	572684	2728636	2799128	spneumoniae-pangenome.S_pseudosimplitigsAC.k_15.d_12.M_zeros
spneumoniae-pangenome	pseudosimplitigsAC	15	2	default	6634628	9262017	6634628	2627389	284373	2300852	330240	2631092	2772400	spneumoniae-pangenome.S_pseudosimplitigsAC.k_15.d_2.M_default
spneumoniae-pangenome	pseudosimplitigsAC	15	2	ones	6634628	9262017	6953969	2308048	265770	2300852	372396	2673248	2750656	spneumoniae-pangenome.S_pseudosimplitigsAC.k_15.d_2.M_ones
spneumoniae-pangenome	pseudosimplitigsAC	15	2	runs	6634628	9262017	6869370	2392647	208625	2300852	305148	2606000	2694300	spneumoniae-pangenome.S_pseudosimplitigsAC.k_15.d_2.M_runs
spneumoniae-pangenome	pseudosimplitigsAC	15	2	zeros	6634628	9262017	6634628	2627389	299985	2300852	356536	2657388	2790840	spneumoniae-pangenome.S_pseudosimplitigsAC.k_15.d_2.M_zeros
spneumoniae-pangenome	pseudosimplitigsAC	15	3	default	6634628	9010382	6634628	2375754	340903	2247236	391900	2639136	2758036	spneumoniae-pangenome.S_pseudosimplitigsAC.k_15.d_3.M_default
spneumoniae-pangenome	pseudosimplitigsAC	15	3	ones	6634628	9010382	6961317	2049065	281089	2247236	384944	2632180	2693104	spneumoniae-pangenome.S_pseudosimplitigsAC.k_15.d_3.M_ones
spneumoniae-pangenome	pseudosimplitigsAC	15	3	runs	6634628	9010382	6901223	2109159	239736	2247236	340452	2587688	2657720	spneumoniae-pangenome.S_pseudosimplitigsAC.k_15.d_3.M_runs
spneumoniae-pangenome	pseudosimplitigsAC	15	3	zeros	6634628	9010382	6634628	2375754	346239	2247236	400452	2647688	2763808	spneumoniae-pangenome.S_pseudosimplitigsAC.k_15.d_3.M_zeros
spneumoniae-pangenome	pseudosimplitigsAC	15	4	default	6634628	8921415	6634628	2286787	424262	2235348	457204	2692552	2798772	spneumoniae-pangenome.S_pseudosimplitigsAC.k_15.d_4.M_default
spneumoniae-pangenome	pseudosimplitigsAC	15	4	ones	6634628	8921415	6989253	1932162	341867	2235348	428008	2663356	2721916	spneumoniae-pangenome.S_pseudosimplitigsAC.k_15.d_4.M_ones
spneumoniae-pangenome	pseudosimplitigsAC	15	4	runs	6634628	8921415	6943887	1977528	310221	2235348	400276	2635624	2697384	spneumoniae-pangenome.S_pseudosimplitigsAC.k_15.d_4.M_runs
spneumoniae-pangenome	pseudosimplitigsAC	15	4	zeros	6634628	8921415	6634628	2286787	425515	2235348	459476	2694824	2799532	spneumoniae-pangenome.S_pseudosimplitigsAC.k_15.d_4.M_zeros
spneumoniae-pangenome	pseudosimplitigsAC	15	5	default	6634628	8880808	6634628	2246180	506192	2228556	504936	2733492	2829604	spneumoniae-pangenome.S_pseudosimplitigsAC.k_15.d_5.M_default
spneumoniae-pangenome	pseudosimplitigsAC	15	5	ones	6634628	8880808	7010244	1870564	413673	2228556	466984	2695540	2756452	spneumoniae-pangenome.S_pseudosimplitigsAC.k_15.d_5.M_ones
spneumoniae-pangenome	pseudosimplitigsAC	15	5	runs	6634628	8880808	6973603	1907205	387205	2228556	447184	2675740	2739284	spneumoniae-pangenome.S_pseudosimplitigsAC.k_15.d_5.M_runs
spneumoniae-pangenome	pseudosimplitigsAC	15	5	zeros	6634628	8880808	6634628	2246180	506426	2228556	505484	2734040	2829564	spneumoniae-pangenome.S_pseudosimplitigsAC.k_15.d_5.M_zeros
spneumoniae-pangenome	pseudosimplitigsAC	15	6	default	6634628	8789688	6634628	2155060	552697	2203432	529156	2732588	2814864	spneumoniae-pangenome.S_pseudosimplitigsAC.k_15.d_6.M_default
spneumoniae-pangenome	pseudosimplitigsAC	15	6	ones	6634628	8789688	7018645	1771043	456747	2203432	484904	2688336	2744588	spneumoniae-pangenome.S_pseudosimplitigsAC.k_15.d_6.M_ones
spneumoniae-pangenome	pseudosimplitigsAC	15	6	runs	6634628	8789688	6986201	1803487	432747	2203432	470136	2673568	2732168	spneumoniae-pangenome.S_pseudosimplitigsAC.k_15.d_6.M_runs
spneumoniae-pangenome	pseudosimplitigsAC	15	6	zeros	6634628	8789688	6634628	2155060	553293	2203432	530960	2734392	2815916	spneumoniae-pangenome.S_pseudosimplitigsAC.k_15.d_6.M_zeros
spneumoniae-pangenome	pseudosimplitigsAC	15	7	default	6634628	8705302	6634628	2070674	569171	2181164	537192	2718356	2796552	spneumoniae-pangenome.S_pseudosimplitigsAC.k_15.d_7.M_default
spneumoniae-pangenome	pseudosimplitigsAC	15	7	ones	6634628	8705302	7021648	1683654	472169	2181164	490448	2671612	2729540	spneumoniae-pangenome.S_pseudosimplitigsAC.k_15.d_7.M_ones
spneumoniae-pangenome	pseudosimplitigsAC	15	7	runs	6634628	8705302	6990483	1714819	448770	2181164	476956	2658120	2717776	spneumoniae-pangenome.S_pseudosimplitigsAC.k_15.d_7.M_runs
spneumoniae-pangenome	pseudosimplitigsAC	15	7	zeros	6634628	8705302	6634628	2070674	587123	2181164	568088	2749252	2824988	spneumoniae-pangenome.S_pseudosimplitigsAC.k_15.d_7.M_zeros
spneumoniae-pangenome	pseudosimplitigsAC	15	8	default	6634628	8658707	6634628	2024079	573159	2166012	539284	2705296	2779540	spneumoniae-pangenome.S_pseudosimplitigsAC.k_15.d_8.M_default
spneumoniae-pangenome	pseudosimplitigsAC	15	8	ones	6634628	8658707	7021119	1637588	475398	2166012	489936	2655948	2714540	spneumoniae-pangenome.S_pseudosimplitigsAC.k_15.d_8.M_ones
spneumoniae-pangenome	pseudosimplitigsAC	15	8	runs	6634628	8658707	6990897	1667810	452551	2166012	477228	2643240	2703020	spneumoniae-pangenome.S_pseudosimplitigsAC.k_15.d_8.M_runs
spneumoniae-pangenome	pseudosimplitigsAC	15	8	zeros	6634628	8658707	6634628	2024079	591302	2166012	570596	2736608	2809276	spneumoniae-pangenome.S_pseudosimplitigsAC.k_15.d_8.M_zeros
spneumoniae-pangenome	pseudosimplitigsAC	15	9	default	6634628	8644353	6634628	2009725	574648	2158016	539932	2697948	2773468	spneumoniae-pangenome.S_pseudosimplitigsAC.k_15.d_9.M_default
spneumoniae-pangenome	pseudosimplitigsAC	15	9	ones	6634628	8644353	7021274	1623079	476874	2158016	489868	2647884	2709088	spneumoniae-pangenome.S_pseudosimplitigsAC.k_15.d_9.M_ones
spneumoniae-pangenome	pseudosimplitigsAC	15	9	runs	6634628	8644353	6990990	1653363	453979	2158016	477360	2635376	2697348	spneumoniae-pangenome.S_pseudosimplitigsAC.k_15.d_9.M_runs
spneumoniae-pangenome	pseudosimplitigsAC	15	9	zeros	6634628	8644353	6634628	2009725	592812	2158016	571208	2729224	2803272	spneumoniae-pangenome.S_pseudosimplitigsAC.k_15.d_9.M_zeros
spneumoniae-pangenome	pseudosimplitigs	16	1	default	6945327	9973167	6945327	3027840	201856	2375792	232144	2607936	2833296	spneumoniae-pangenome.S_pseudosimplitigs.k_16.d_1.M_default
spneumoniae-pangenome	pseudosimplitigs	16	1	ones	6945327	9973167	7147738	2825429	227091	2375792	328640	2704432	2869968	spneumoniae-pangenome.S_pseudosimplitigs.k_16.d_1.M_ones
spneumoniae-pangenome	pseudosimplitigs	16	1	runs	6945327	9973167	7110645	2862522	201199	2375792	288496	2664288	2838788	spneumoniae-pangenome.S_pseudosimplitigs.k_16.d_1.M_runs
spneumoniae-pangenome	pseudosimplitigs	16	1	zeros	6945327	9973167	6945327	3027840	215705	2375792	266276	2642068	2853344	spneumoniae-pangenome.S_pseudosimplitigs.k_16.d_1.M_zeros
spneumoniae-pangenome	pseudosimplitigs	16	10	default	6945327	9326317	6945327	2380990	512743	2265804	514452	2780256	2905040	spneumoniae-pangenome.S_pseudosimplitigs.k_16.d_10.M_default
spneumoniae-pangenome	pseudosimplitigs	16	10	ones	6945327	9326317	7287555	2038762	448365	2265804	479912	2745716	2854980	spneumoniae-pangenome.S_pseudosimplitigs.k_16.d_10.M_ones
spneumoniae-pangenome	pseudosimplitigs	16	10	runs	6945327	9326317	7262343	2063974	429894	2265804	471196	2737000	2845652	spneumoniae-pangenome.S_pseudosimplitigs.k_16.d_10.M_runs
spneumoniae-pangenome	pseudosimplitigs	16	10	zeros	6945327	9326317	6945327	2380990	520695	2265804	532588	2798392	2920268	spneumoniae-pangenome.S_pseudosimplitigs.k_16.d_10.M_zeros
spneumoniae-pangenome	pseudosimplitigs	16	11	default	6945327	9329820	6945327	2384493	513447	2265352	515628	2780980	2904184	spneumoniae-pangenome.S_pseudosimplitigs.k_16.d_11.M_default
spneumoniae-pangenome	pseudosimplitigs	16	11	ones	6945327	9329820	7288052	2041768	449068	2265352	480648	2746000	2854944	spneumoniae-pangenome.S_pseudosimplitigs.k_16.d_11.M_ones
spneumoniae-pangenome	pseudosimplitigs	16	11	runs	6945327	9329820	7262660	2067160	430482	2265352	471912	2737264	2845200	spneumoniae-pangenome.S_pseudosimplitigs.k_16.d_11.M_runs
spneumoniae-pangenome	pseudosimplitigs	16	11	zeros	6945327	9329820	6945327	2384493	521519	2265352	534100	2799452	2920232	spneumoniae-pangenome.S_pseudosimplitigs.k_16.d_11.M_zeros
spneumoniae-pangenome	pseudosimplitigs	16	12	default	6945327	9333552	6945327	2388225	514032	2265376	516640	2782016	2903916	spneumoniae-pangenome.S_pseudosimplitigs.k_16.d_12.M_default
spneumoniae-pangenome	pseudosimplitigs	16	12	ones	6945327	9333552	7288430	2045122	449614	2265376	481288	2746664	2854868	spneumoniae-pangenome.S_pseudosimplitigs.k_16.d_12.M_ones
spneumoniae-pangenome	pseudosimplitigs	16	12	runs	6945327	9333552	7262895	2070657	430898	2265376	472572	2737948	2846452	spneumoniae-pangenome.S_pseudosimplitigs.k_16.d_12.M_runs
spneumoniae-pangenome	pseudosimplitigs	16	12	zeros	6945327	9333552	6945327	2388225	522125	2265376	535004	2800380	2919992	spneumoniae-pangenome.S_pseudosimplitigs.k_16.d_12.M_zeros
spneumoniae-pangenome	pseudosimplitigs	16	2	default	6945327	9531966	6945327	2586639	213163	2267964	262032	2529996	2726116	spneumoniae-pangenome.S_pseudosimplitigs.k_16.d_2.M_default
spneumoniae-pangenome	pseudosimplitigs	16	2	ones	6945327	9531966	7138217	2393749	196180	2267964	291744	2559708	2706656	spneumoniae-pangenome.S_pseudosimplitigs.k_16.d_2.M_ones
spneumoniae-pangenome	pseudosimplitigs	16	2	runs	6945327	9531966	7112355	2419611	177799	2267964	262588	2530552	2685456	spneumoniae-pangenome.S_pseudosimplitigs.k_16.d_2.M_runs
spneumoniae-pangenome	pseudosimplitigs	16	2	zeros	6945327	9531966	6945327	2586639	219185	2267964	274548	2542512	2734868	spneumoniae-pangenome.S_pseudosimplitigs.k_16.d_2.M_zeros
spneumoniae-pangenome	pseudosimplitigs	16	3	default	6945327	9280067	6945327	2334740	235531	2212448	299488	2511936	2682488	spneumoniae-pangenome.S_pseudosimplitigs.k_16.d_3.M_default
spneumoniae-pangenome	pseudosimplitigs	16	3	ones	6945327	9280067	7163273	2116794	192432	2212448	292396	2504844	2624992	spneumoniae-pangenome.S_pseudosimplitigs.k_16.d_3.M_ones
spneumoniae-pangenome	pseudosimplitigs	16	3	runs	6945327	9280067	7142877	2137190	177930	2212448	270688	2483136	2610228	spneumoniae-pangenome.S_pseudosimplitigs.k_16.d_3.M_runs
spneumoniae-pangenome	pseudosimplitigs	16	3	zeros	6945327	9280067	6945327	2334740	238411	2212448	304772	2517220	2686292	spneumoniae-pangenome.S_pseudosimplitigs.k_16.d_3.M_zeros
spneumoniae-pangenome	pseudosimplitigs	16	4	default	6945327	9247509	6945327	2302182	281315	2224908	353440	2578348	2730108	spneumoniae-pangenome.S_pseudosimplitigs.k_16.d_4.M_default
spneumoniae-pangenome	pseudosimplitigs	16	4	ones	6945327	9247509	7192954	2054555	227720	2224908	334296	2559204	2660304	spneumoniae-pangenome.S_pseudosimplitigs.k_16.d_4.M_ones
spneumoniae-pangenome	pseudosimplitigs	16	4	runs	6945327	9247509	7174484	2073025	214608	2224908	317472	2542380	2648524	spneumoniae-pangenome.S_pseudosimplitigs.k_16.d_4.M_runs
spneumoniae-pangenome	pseudosimplitigs	16	4	zeros	6945327	9247509	6945327	2302182	282474	2224908	355688	2580596	2731608	spneumoniae-pangenome.S_pseudosimplitigs.k_16.d_4.M_zeros
spneumoniae-pangenome	pseudosimplitigs	16	5	default	6945327	9311837	6945327	2366510	357969	2264996	423836	2688832	2826220	spneumoniae-pangenome.S_pseudosimplitigs.k_16.d_5.M_default
spneumoniae-pangenome	pseudosimplitigs	16	5	ones	6945327	9311837	7227166	2084671	297345	2264996	397004	2662000	2756160	spneumoniae-pangenome.S_pseudosimplitigs.k_16.d_5.M_ones
spneumoniae-pangenome	pseudosimplitigs	16	5	runs	6945327	9311837	7209223	2102614	284469	2264996	385696	2650692	2745352	spneumoniae-pangenome.S_pseudosimplitigs.k_16.d_5.M_runs
spneumoniae-pangenome	pseudosimplitigs	16	5	zeros	6945327	9311837	6945327	2366510	358234	2264996	424376	2689372	2826340	spneumoniae-pangenome.S_pseudosimplitigs.k_16.d_5.M_zeros
spneumoniae-pangenome	pseudosimplitigs	16	6	default	6945327	9373590	6945327	2428263	438207	2292324	472916	2765240	2896760	spneumoniae-pangenome.S_pseudosimplitigs.k_16.d_6.M_default
spneumoniae-pangenome	pseudosimplitigs	16	6	ones	6945327	9373590	7263397	2110193	373854	2292324	443932	2736256	2833764	spneumoniae-pangenome.S_pseudosimplitigs.k_16.d_6.M_ones
spneumoniae-pangenome	pseudosimplitigs	16	6	runs	6945327	9373590	7243260	2130330	359563	2292324	434336	2726660	2824616	spneumoniae-pangenome.S_pseudosimplitigs.k_16.d_6.M_runs
spneumoniae-pangenome	pseudosimplitigs	16	6	zeros	6945327	9373590	6945327	2428263	438353	2292324	473264	2765588	2896548	spneumoniae-pangenome.S_pseudosimplitigs.k_16.d_6.M_zeros
spneumoniae-pangenome	pseudosimplitigs	16	7	default	6945327	9366963	6945327	2421636	486481	2286748	497896	2784644	2911636	spneumoniae-pangenome.S_pseudosimplitigs.k_16.d_7.M_default
spneumoniae-pangenome	pseudosimplitigs	16	7	ones	6945327	9366963	7276949	2090014	421575	2286748	467028	2753776	2853392	spneumoniae-pangenome.S_pseudosimplitigs.k_16.d_7.M_ones
spneumoniae-pangenome	pseudosimplitigs	16	7	runs	6945327	9366963	7255219	2111744	405865	2286748	458280	2745028	2843964	spneumoniae-pangenome.S_pseudosimplitigs.k_16.d_7.M_runs
spneumoniae-pangenome	pseudosimplitigs	16	7	zeros	6945327	9366963	6945327	2421636	487563	2286748	500344	2787092	2911072	spneumoniae-pangenome.S_pseudosimplitigs.k_16.d_7.M_zeros
spneumoniae-pangenome	pseudosimplitigs	16	8	default	6945327	9328225	6945327	2382898	505256	2280264	509020	2789284	2910244	spneumoniae-pangenome.S_pseudosimplitigs.k_16.d_8.M_default
spneumoniae-pangenome	pseudosimplitigs	16	8	ones	6945327	9328225	7283356	2044869	440309	2280264	476188	2756452	2857008	spneumoniae-pangenome.S_pseudosimplitigs.k_16.d_8.M_ones
spneumoniae-pangenome	pseudosimplitigs	16	8	runs	6945327	9328225	7260405	2067820	423610	2280264	467532	2747796	2847868	spneumoniae-pangenome.S_pseudosimplitigs.k_16.d_8.M_runs
spneumoniae-pangenome	pseudosimplitigs	16	8	zeros	6945327	9328225	6945327	2382898	512512	2280264	525472	2805736	2924868	spneumoniae-pangenome.S_pseudosimplitigs.k_16.d_8.M_zeros
spneumoniae-pangenome	pseudosimplitigs	16	9	default	6945327	9319824	6945327	2374497	510724	2272708	512264	2784972	2904676	spneumoniae-pangenome.S_pseudosimplitigs.k_16.d_9.M_default
spneumoniae-pangenome	pseudosimplitigs	16	9	ones	6945327	9319824	7286762	2033062	445975	2272708	478356	2751064	2854552	spneumoniae-pangenome.S_pseudosimplitigs.k_16.d_9.M_ones
spneumoniae-pangenome	pseudosimplitigs	16	9	runs	6945327	9319824	7262631	2057193	428357	2272708	469556	2742264	2844780	spneumoniae-pangenome.S_pseudosimplitigs.k_16.d_9.M_runs
spneumoniae-pangenome	pseudosimplitigs	16	9	zeros	6945327	9319824	6945327	2374497	518199	2272708	529472	2802180	2919560	spneumoniae-pangenome.S_pseudosimplitigs.k_16.d_9.M_zeros
spneumoniae-pangenome	pseudosimplitigsAC	16	1	default	6945327	9973347	6945327	3028020	201868	2390460	230004	2620464	2836412	spneumoniae-pangenome.S_pseudosimplitigsAC.k_16.d_1.M_default
spneumoniae-pangenome	pseudosimplitigsAC	16	1	ones	6945327	9973347	7147899	2825448	227154	2390460	326240	2716700	2873148	spneumoniae-pangenome.S_pseudosimplitigsAC.k_16.d_1.M_ones
spneumoniae-pangenome	pseudosimplitigsAC	16	1	runs	6945327	9973347	7110470	2862877	201219	2390460	285628	2676088	2842188	spneumoniae-pangenome.S_pseudosimplitigsAC.k_16.d_1.M_runs
spneumoniae-pangenome	pseudosimplitigsAC	16	1	zeros	6945327	9973347	6945327	3028020	215578	2390460	263924	2654384	2856516	spneumoniae-pangenome.S_pseudosimplitigsAC.k_16.d_1.M_zeros
spneumoniae-pangenome	pseudosimplitigsAC	16	10	default	6945327	9235509	6945327	2290182	506475	2250704	506764	2757468	2880552	spneumoniae-pangenome.S_pseudosimplitigsAC.k_16.d_10.M_default
spneumoniae-pangenome	pseudosimplitigsAC	16	10	ones	6945327	9235509	7279001	1956508	441375	2250704	469648	2720352	2829028	spneumoniae-pangenome.S_pseudosimplitigsAC.k_16.d_10.M_ones
spneumoniae-pangenome	pseudosimplitigsAC	16	10	runs	6945327	9235509	7257759	1977750	425812	2250704	461984	2712688	2820772	spneumoniae-pangenome.S_pseudosimplitigsAC.k_16.d_10.M_runs
spneumoniae-pangenome	pseudosimplitigsAC	16	10	zeros	6945327	9235509	6945327	2290182	518939	2250704	534184	2784888	2904404	spneumoniae-pangenome.S_pseudosimplitigsAC.k_16.d_10.M_zeros
spneumoniae-pangenome	pseudosimplitigsAC	16	11	default	6945327	9230391	6945327	2285064	506708	2248040	507032	2755072	2878380	spneumoniae-pangenome.S_pseudosimplitigsAC.k_16.d_11.M_default
spneumoniae-pangenome	pseudosimplitigsAC	16	11	ones	6945327	9230391	7279522	1950869	441621	2248040	469508	2717548	2827408	spneumoniae-pangenome.S_pseudosimplitigsAC.k_16.d_11.M_ones
spneumoniae-pangenome	pseudosimplitigsAC	16	11	runs	6945327	9230391	7258019	1972372	425891	2248040	462228	2710268	2818672	spneumoniae-pangenome.S_pseudosimplitigsAC.k_16.d_11.M_runs
spneumoniae-pangenome	pseudosimplitigsAC	16	11	zeros	6945327	9230391	6945327	2285064	519257	2248040	534912	2782952	2902520	spneumoniae-pangenome.S_pseudosimplitigsAC.k_16.d_11.M_zeros
spneumoniae-pangenome	pseudosimplitigsAC	16	12	default	6945327	9228678	6945327	2283351	506829	2248272	507428	2755700	2877744	spneumoniae-pangenome.S_pseudosimplitigsAC.k_16.d_12.M_default
spneumoniae-pangenome	pseudosimplitigsAC	16	12	ones	6945327	9228678	7279655	1949023	441774	2248272	469764	2718036	2825872	spneumoniae-pangenome.S_pseudosimplitigsAC.k_16.d_12.M_ones
spneumoniae-pangenome	pseudosimplitigsAC	16	12	runs	6945327	9228678	7258143	1970535	426015	2248272	462468	2710740	2817616	spneumoniae-pangenome.S_pseudosimplitigsAC.k_16.d_12.M_runs
spneumoniae-pangenome	pseudosimplitigsAC	16	12	zeros	6945327	9228678	6945327	2283351	519378	2248272	535076	2783348	2902220	spneumoniae-pangenome.S_pseudosimplitigsAC.k_16.d_12.M_zeros
spneumoniae-pangenome	pseudosimplitigsAC	16	2	default	6945327	9529383	6945327	2584056	212792	2281048	259568	2540616	2728592	spneumoniae-pangenome.S_pseudosimplitigsAC.k_16.d_2.M_default
spneumoniae-pangenome	pseudosimplitigsAC	16	2	ones	6945327	9529383	7137879	2391504	195576	2281048	288284	2569332	2708356	spneumoniae-pangenome.S_pseudosimplitigsAC.k_16.d_2.M_ones
spneumoniae-pangenome	pseudosimplitigsAC	16	2	runs	6945327	9529383	7112001	2417382	177302	2281048	258772	2539820	2686512	spneumoniae-pangenome.S_pseudosimplitigsAC.k_16.d_2.M_runs
spneumoniae-pangenome	pseudosimplitigsAC	16	2	zeros	6945327	9529383	6945327	2584056	218377	2281048	271224	2552272	2735896	spneumoniae-pangenome.S_pseudosimplitigsAC.k_16.d_2.M_zeros
spneumoniae-pangenome	pseudosimplitigsAC	16	3	default	6945327	9275213	6945327	2329886	234372	2224544	295936	2520480	2683996	spneumoniae-pangenome.S_pseudosimplitigsAC.k_16.d_3.M_default
spneumoniae-pangenome	pseudosimplitigsAC	16	3	ones	6945327	9275213	7162650	2112563	191066	2224544	288628	2513172	2625304	spneumoniae-pangenome.S_pseudosimplitigsAC.k_16.d_3.M_ones
spneumoniae-pangenome	pseudosimplitigsAC	16	3	runs	6945327	9275213	7142271	2132942	176583	2224544	266772	2491316	2609884	spneumoniae-pangenome.S_pseudosimplitigsAC.k_16.d_3.M_runs
spneumoniae-pangenome	pseudosimplitigsAC	16	3	zeros	6945327	9275213	6945327	2329886	237115	2224544	301232	2525776	2687480	spneumoniae-pangenome.S_pseudosimplitigsAC.k_16.d_3.M_zeros
spneumoniae-pangenome	pseudosimplitigsAC	16	4	default	6945327	9241233	6945327	2295906	279662	2231780	350028	2581808	2728940	spneumoniae-pangenome.S_pseudosimplitigsAC.k_16.d_4.M_default
spneumoniae-pangenome	pseudosimplitigsAC	16	4	ones	6945327	9241233	7191611	2049622	225546	2231780	329972	2561752	2658812	spneumoniae-pangenome.S_pseudosimplitigsAC.k_16.d_4.M_ones
spneumoniae-pangenome	pseudosimplitigsAC	16	4	runs	6945327	9241233	7173780	2067453	212783	2231780	313672	2545452	2646824	spneumoniae-pangenome.S_pseudosimplitigsAC.k_16.d_4.M_runs
spneumoniae-pangenome	pseudosimplitigsAC	16	4	zeros	6945327	9241233	6945327	2295906	280726	2231780	352088	2583868	2730548	spneumoniae-pangenome.S_pseudosimplitigsAC.k_16.d_4.M_zeros
spneumoniae-pangenome	pseudosimplitigsAC	16	5	default	6945327	9311572	6945327	2366245	356677	2269664	420604	2690268	2826188	spneumoniae-pangenome.S_pseudosimplitigsAC.k_16.d_5.M_default
spneumoniae-pangenome	pseudosimplitigsAC	16	5	ones	6945327	9311572	7228209	2083363	296087	2269664	394164	2663828	2756304	spneumoniae-pangenome.S_pseudosimplitigsAC.k_16.d_5.M_ones
spneumoniae-pangenome	pseudosimplitigsAC	16	5	runs	6945327	9311572	7210011	2101561	283225	2269664	382360	2652024	2745680	spneumoniae-pangenome.S_pseudosimplitigsAC.k_16.d_5.M_runs
spneumoniae-pangenome	pseudosimplitigsAC	16	5	zeros	6945327	9311572	6945327	2366245	356953	2269664	421068	2690732	2825680	spneumoniae-pangenome.S_pseudosimplitigsAC.k_16.d_5.M_zeros
spneumoniae-pangenome	pseudosimplitigsAC	16	6	default	6945327	9372503	6945327	2427176	436989	2290984	469748	2760732	2895580	spneumoniae-pangenome.S_pseudosimplitigsAC.k_16.d_6.M_default
spneumoniae-pangenome	pseudosimplitigsAC	16	6	ones	6945327	9372503	7262508	2109995	372721	2290984	440596	2731580	2832116	spneumoniae-pangenome.S_pseudosimplitigsAC.k_16.d_6.M_ones
spneumoniae-pangenome	pseudosimplitigsAC	16	6	runs	6945327	9372503	7242657	2129846	358662	2290984	431036	2722020	2823196	spneumoniae-pangenome.S_pseudosimplitigsAC.k_16.d_6.M_runs
spneumoniae-pangenome	pseudosimplitigsAC	16	6	zeros	6945327	9372503	6945327	2427176	437197	2290984	470408	2761392	2895372	spneumoniae-pangenome.S_pseudosimplitigsAC.k_16.d_6.M_zeros
spneumoniae-pangenome	pseudosimplitigsAC	16	7	default	6945327	9352576	6945327	2407249	483873	2283432	494204	2777636	2907156	spneumoniae-pangenome.S_pseudosimplitigsAC.k_16.d_7.M_default
spneumoniae-pangenome	pseudosimplitigsAC	16	7	ones	6945327	9352576	7276249	2076327	418990	2283432	462368	2745800	2848200	spneumoniae-pangenome.S_pseudosimplitigsAC.k_16.d_7.M_ones
spneumoniae-pangenome	pseudosimplitigsAC	16	7	runs	6945327	9352576	7255116	2097460	403689	2283432	454016	2737448	2839172	spneumoniae-pangenome.S_pseudosimplitigsAC.k_16.d_7.M_runs
spneumoniae-pangenome	pseudosimplitigsAC	16	7	zeros	6945327	9352576	6945327	2407249	484831	2283432	497172	2780604	2907600	spneumoniae-pangenome.S_pseudosimplitigsAC.k_16.d_7.M_zeros
spneumoniae-pangenome	pseudosimplitigsAC	16	8	default	6945327	9290199	6945327	2344872	500666	2268116	503208	2771324	2898820	spneumoniae-pangenome.S_pseudosimplitigsAC.k_16.d_8.M_default
spneumoniae-pangenome	pseudosimplitigsAC	16	8	ones	6945327	9290199	7278733	2011466	435764	2268116	468784	2736900	2842904	spneumoniae-pangenome.S_pseudosimplitigsAC.k_16.d_8.M_ones
spneumoniae-pangenome	pseudosimplitigsAC	16	8	runs	6945327	9290199	7257719	2032480	420451	2268116	461096	2729212	2834756	spneumoniae-pangenome.S_pseudosimplitigsAC.k_16.d_8.M_runs
spneumoniae-pangenome	pseudosimplitigsAC	16	8	zeros	6945327	9290199	6945327	2344872	505539	2268116	515832	2783948	2907700	spneumoniae-pangenome.S_pseudosimplitigsAC.k_16.d_8.M_zeros
spneumoniae-pangenome	pseudosimplitigsAC	16	9	default	6945327	9250017	6945327	2304690	504951	2259536	505608	2765144	2886392	spneumoniae-pangenome.S_pseudosimplitigsAC.k_16.d_9.M_default
spneumoniae-pangenome	pseudosimplitigsAC	16	9	ones	6945327	9250017	7279447	1970570	439708	2259536	469236	2728772	2836236	spneumoniae-pangenome.S_pseudosimplitigsAC.k_16.d_9.M_ones
spneumoniae-pangenome	pseudosimplitigsAC	16	9	runs	6945327	9250017	7258292	1991725	424252	2259536	461984	2721520	2825552	spneumoniae-pangenome.S_pseudosimplitigsAC.k_16.d_9.M_runs
spneumoniae-pangenome	pseudosimplitigsAC	16	9	zeros	6945327	9250017	6945327	2304690	516983	2259536	531860	2791396	2909336	spneumoniae-pangenome.S_pseudosimplitigsAC.k_16.d_9.M_zeros
spneumoniae-pangenome	pseudosimplitigs	17	1	default	7170727	10067895	7170727	2897168	181073	2305184	206788	2511972	2784248	spneumoniae-pangenome.S_pseudosimplitigs.k_17.d_1.M_default
spneumoniae-pangenome	pseudosimplitigs	17	1	ones	7170727	10067895	7322505	2745390	188049	2305184	271636	2576820	2799172	spneumoniae-pangenome.S_pseudosimplitigs.k_17.d_1.M_ones
spneumoniae-pangenome	pseudosimplitigs	17	1	runs	7170727	10067895	7312045	2755850	180734	2305184	257844	2563028	2790276	spneumoniae-pangenome.S_pseudosimplitigs.k_17.d_1.M_runs
spneumoniae-pangenome	pseudosimplitigs	17	1	zeros	7170727	10067895	7170727	2897168	186135	2305184	222404	2527588	2792028	spneumoniae-pangenome.S_pseudosimplitigs.k_17.d_1.M_zeros
spneumoniae-pangenome	pseudosimplitigs	17	10	default	7170727	9849122	7170727	2678395	473387	2336552	487260	2823812	3006672	spneumoniae-pangenome.S_pseudosimplitigs.k_17.d_10.M_default
spneumoniae-pangenome	pseudosimplitigs	17	10	ones	7170727	9849122	7498673	2350449	417927	2336552	457744	2794296	2954128	spneumoniae-pangenome.S_pseudosimplitigs.k_17.d_10.M_ones
spneumoniae-pangenome	pseudosimplitigs	17	10	runs	7170727	9849122	7479826	2369296	404713	2336552	453536	2790088	2948100	spneumoniae-pangenome.S_pseudosimplitigs.k_17.d_10.M_runs
spneumoniae-pangenome	pseudosimplitigs	17	10	zeros	7170727	9849122	7170727	2678395	482443	2336552	511836	2848388	3025104	spneumoniae-pangenome.S_pseudosimplitigs.k_17.d_10.M_zeros
spneumoniae-pangenome	pseudosimplitigs	17	11	default	7170727	9851193	7170727	2680466	475165	2335792	489364	2825156	3007316	spneumoniae-pangenome.S_pseudosimplitigs.k_17.d_11.M_default
spneumoniae-pangenome	pseudosimplitigs	17	11	ones	7170727	9851193	7498685	2352508	419759	2335792	458752	2794544	2954584	spneumoniae-pangenome.S_pseudosimplitigs.k_17.d_11.M_ones
spneumoniae-pangenome	pseudosimplitigs	17	11	runs	7170727	9851193	7479509	2371684	406258	2335792	454672	2790464	2949280	spneumoniae-pangenome.S_pseudosimplitigs.k_17.d_11.M_runs
spneumoniae-pangenome	pseudosimplitigs	17	11	zeros	7170727	9851193	7170727	2680466	486085	2335792	519864	2855656	3035656	spneumoniae-pangenome.S_pseudosimplitigs.k_17.d_11.M_zeros
spneumoniae-pangenome	pseudosimplitigs	17	12	default	7170727	9853768	7170727	2683041	475880	2335848	490484	2826332	3007032	spneumoniae-pangenome.S_pseudosimplitigs.k_17.d_12.M_default
spneumoniae-pangenome	pseudosimplitigs	17	12	ones	7170727	9853768	7499234	2354534	420575	2335848	459428	2795276	2954560	spneumoniae-pangenome.S_pseudosimplitigs.k_17.d_12.M_ones
spneumoniae-pangenome	pseudosimplitigs	17	12	runs	7170727	9853768	7479651	2374117	406854	2335848	455276	2791124	2949776	spneumoniae-pangenome.S_pseudosimplitigs.k_17.d_12.M_runs
spneumoniae-pangenome	pseudosimplitigs	17	12	zeros	7170727	9853768	7170727	2683041	486793	2335848	521076	2856924	3035396	spneumoniae-pangenome.S_pseudosimplitigs.k_17.d_12.M_zeros
spneumoniae-pangenome	pseudosimplitigs	17	2	default	7170727	9688459	7170727	2517732	184842	2212148	224796	2436944	2680552	spneumoniae-pangenome.S_pseudosimplitigs.k_17.d_2.M_default
spneumoniae-pangenome	pseudosimplitigs	17	2	ones	7170727	9688459	7322492	2365967	163355	2212148	243320	2455468	2652856	spneumoniae-pangenome.S_pseudosimplitigs.k_17.d_2.M_ones
spneumoniae-pangenome	pseudosimplitigs	17	2	runs	7170727	9688459	7314793	2373666	157835	2212148	232512	2444660	2646800	spneumoniae-pangenome.S_pseudosimplitigs.k_17.d_2.M_runs
spneumoniae-pangenome	pseudosimplitigs	17	2	zeros	7170727	9688459	7170727	2517732	186774	2212148	229680	2441828	2682340	spneumoniae-pangenome.S_pseudosimplitigs.k_17.d_2.M_zeros
spneumoniae-pangenome	pseudosimplitigs	17	3	default	7170727	9557130	7170727	2386403	192151	2183380	242000	2425380	2652776	spneumoniae-pangenome.S_pseudosimplitigs.k_17.d_3.M_default
spneumoniae-pangenome	pseudosimplitigs	17	3	ones	7170727	9557130	7336175	2220955	159164	2183380	242040	2425420	2608264	spneumoniae-pangenome.S_pseudosimplitigs.k_17.d_3.M_ones
spneumoniae-pangenome	pseudosimplitigs	17	3	runs	7170727	9557130	7329506	2227624	154398	2183380	233024	2416404	2602268	spneumoniae-pangenome.S_pseudosimplitigs.k_17.d_3.M_runs
spneumoniae-pangenome	pseudosimplitigs	17	3	zeros	7170727	9557130	7170727	2386403	193179	2183380	244176	2427556	2654220	spneumoniae-pangenome.S_pseudosimplitigs.k_17.d_3.M_zeros
spneumoniae-pangenome	pseudosimplitigs	17	4	default	7170727	9498869	7170727	2328142	210294	2183208	272040	2455248	2664536	spneumoniae-pangenome.S_pseudosimplitigs.k_17.d_4.M_default
spneumoniae-pangenome	pseudosimplitigs	17	4	ones	7170727	9498869	7358718	2140151	169489	2183208	260692	2443900	2605620	spneumoniae-pangenome.S_pseudosimplitigs.k_17.d_4.M_ones
spneumoniae-pangenome	pseudosimplitigs	17	4	runs	7170727	9498869	7352226	2146643	164797	2183208	252808	2436016	2600716	spneumoniae-pangenome.S_pseudosimplitigs.k_17.d_4.M_runs
spneumoniae-pangenome	pseudosimplitigs	17	4	zeros	7170727	9498869	7170727	2328142	210865	2183208	273360	2456568	2665444	spneumoniae-pangenome.S_pseudosimplitigs.k_17.d_4.M_zeros
spneumoniae-pangenome	pseudosimplitigs	17	5	default	7170727	9487697	7170727	2316970	251071	2206728	325444	2532172	2719412	spneumoniae-pangenome.S_pseudosimplitigs.k_17.d_5.M_default
spneumoniae-pangenome	pseudosimplitigs	17	5	ones	7170727	9487697	7401507	2086190	200634	2206728	302240	2508968	2646860	spneumoniae-pangenome.S_pseudosimplitigs.k_17.d_5.M_ones
spneumoniae-pangenome	pseudosimplitigs	17	5	runs	7170727	9487697	7394592	2093105	195785	2206728	296240	2502968	2642004	spneumoniae-pangenome.S_pseudosimplitigs.k_17.d_5.M_runs
spneumoniae-pangenome	pseudosimplitigs	17	5	zeros	7170727	9487697	7170727	2316970	251319	2206728	325896	2532624	2719680	spneumoniae-pangenome.S_pseudosimplitigs.k_17.d_5.M_zeros
spneumoniae-pangenome	pseudosimplitigs	17	6	default	7170727	9640104	7170727	2469377	323042	2278300	396192	2674492	2845752	spneumoniae-pangenome.S_pseudosimplitigs.k_17.d_6.M_default
spneumoniae-pangenome	pseudosimplitigs	17	6	ones	7170727	9640104	7441315	2198789	268772	2278300	370956	2649256	2776080	spneumoniae-pangenome.S_pseudosimplitigs.k_17.d_6.M_ones
spneumoniae-pangenome	pseudosimplitigs	17	6	runs	7170727	9640104	7431782	2208322	262258	2278300	366020	2644320	2771180	spneumoniae-pangenome.S_pseudosimplitigs.k_17.d_6.M_runs
spneumoniae-pangenome	pseudosimplitigs	17	6	zeros	7170727	9640104	7170727	2469377	323095	2278300	396364	2674664	2846552	spneumoniae-pangenome.S_pseudosimplitigs.k_17.d_6.M_zeros
spneumoniae-pangenome	pseudosimplitigs	17	7	default	7170727	9812254	7170727	2641527	401254	2334576	448700	2783276	2956412	spneumoniae-pangenome.S_pseudosimplitigs.k_17.d_7.M_default
spneumoniae-pangenome	pseudosimplitigs	17	7	ones	7170727	9812254	7474295	2337959	345578	2334576	422080	2756656	2895916	spneumoniae-pangenome.S_pseudosimplitigs.k_17.d_7.M_ones
spneumoniae-pangenome	pseudosimplitigs	17	7	runs	7170727	9812254	7460604	2351650	336305	2334576	417348	2751924	2889276	spneumoniae-pangenome.S_pseudosimplitigs.k_17.d_7.M_runs
spneumoniae-pangenome	pseudosimplitigs	17	7	zeros	7170727	9812254	7170727	2641527	401352	2334576	449104	2783680	2957820	spneumoniae-pangenome.S_pseudosimplitigs.k_17.d_7.M_zeros
spneumoniae-pangenome	pseudosimplitigs	17	8	default	7170727	9856730	7170727	2686003	448856	2342180	472740	2814920	2993308	spneumoniae-pangenome.S_pseudosimplitigs.k_17.d_8.M_default
spneumoniae-pangenome	pseudosimplitigs	17	8	ones	7170727	9856730	7490559	2366171	393097	2342180	445360	2787540	2933100	spneumoniae-pangenome.S_pseudosimplitigs.k_17.d_8.M_ones
spneumoniae-pangenome	pseudosimplitigs	17	8	runs	7170727	9856730	7474458	2382272	381986	2342180	440868	2783048	2926888	spneumoniae-pangenome.S_pseudosimplitigs.k_17.d_8.M_runs
spneumoniae-pangenome	pseudosimplitigs	17	8	zeros	7170727	9856730	7170727	2686003	449918	2342180	475492	2817672	2993044	spneumoniae-pangenome.S_pseudosimplitigs.k_17.d_8.M_zeros
spneumoniae-pangenome	pseudosimplitigs	17	9	default	7170727	9840722	7170727	2669995	467001	2340276	482604	2822880	3005568	spneumoniae-pangenome.S_pseudosimplitigs.k_17.d_9.M_default
spneumoniae-pangenome	pseudosimplitigs	17	9	ones	7170727	9840722	7494408	2346314	411429	2340276	454536	2794812	2950628	spneumoniae-pangenome.S_pseudosimplitigs.k_17.d_9.M_ones
spneumoniae-pangenome	pseudosimplitigs	17	9	runs	7170727	9840722	7476963	2363759	399142	2340276	450256	2790532	2943864	spneumoniae-pangenome.S_pseudosimplitigs.k_17.d_9.M_runs
spneumoniae-pangenome	pseudosimplitigs	17	9	zeros	7170727	9840722	7170727	2669995	475049	2340276	504820	2845096	3021368	spneumoniae-pangenome.S_pseudosimplitigs.k_17.d_9.M_zeros
spneumoniae-pangenome	pseudosimplitigsAC	17	1	default	7170727	10068311	7170727	2897584	181099	2337416	205212	2542628	2795556	spneumoniae-pangenome.S_pseudosimplitigsAC.k_17.d_1.M_default
spneumoniae-pangenome	pseudosimplitigsAC	17	1	ones	7170727	10068311	7321885	2746426	188176	2337416	269760	2607176	2810904	spneumoniae-pangenome.S_pseudosimplitigsAC.k_17.d_1.M_ones
spneumoniae-pangenome	pseudosimplitigsAC	17	1	runs	7170727	10068311	7311292	2757019	180732	2337416	256004	2593420	2801864	spneumoniae-pangenome.S_pseudosimplitigsAC.k_17.d_1.M_runs
spneumoniae-pangenome	pseudosimplitigsAC	17	1	zeros	7170727	10068311	7170727	2897584	186131	2337416	220788	2558204	2802644	spneumoniae-pangenome.S_pseudosimplitigsAC.k_17.d_1.M_zeros
spneumoniae-pangenome	pseudosimplitigsAC	17	10	default	7170727	9782726	7170727	2611999	469094	2314904	480468	2795372	2991592	spneumoniae-pangenome.S_pseudosimplitigsAC.k_17.d_10.M_default
spneumoniae-pangenome	pseudosimplitigsAC	17	10	ones	7170727	9782726	7492739	2289987	413355	2314904	449092	2763996	2933616	spneumoniae-pangenome.S_pseudosimplitigsAC.k_17.d_10.M_ones
spneumoniae-pangenome	pseudosimplitigsAC	17	10	runs	7170727	9782726	7476318	2306408	401722	2314904	445232	2760136	2927804	spneumoniae-pangenome.S_pseudosimplitigsAC.k_17.d_10.M_runs
spneumoniae-pangenome	pseudosimplitigsAC	17	10	zeros	7170727	9782726	7170727	2611999	476769	2314904	502144	2817048	2999412	spneumoniae-pangenome.S_pseudosimplitigsAC.k_17.d_10.M_zeros
spneumoniae-pangenome	pseudosimplitigsAC	17	11	default	7170727	9771115	7170727	2600388	470509	2311848	482492	2794340	2989228	spneumoniae-pangenome.S_pseudosimplitigsAC.k_17.d_11.M_default
spneumoniae-pangenome	pseudosimplitigsAC	17	11	ones	7170727	9771115	7492953	2278162	414760	2311848	449464	2761312	2932936	spneumoniae-pangenome.S_pseudosimplitigsAC.k_17.d_11.M_ones
spneumoniae-pangenome	pseudosimplitigsAC	17	11	runs	7170727	9771115	7476446	2294669	403025	2311848	445988	2757836	2927220	spneumoniae-pangenome.S_pseudosimplitigsAC.k_17.d_11.M_runs
spneumoniae-pangenome	pseudosimplitigsAC	17	11	zeros	7170727	9771115	7170727	2600388	479953	2311848	509884	2821732	3004472	spneumoniae-pangenome.S_pseudosimplitigsAC.k_17.d_11.M_zeros
spneumoniae-pangenome	pseudosimplitigsAC	17	12	default	7170727	9764330	7170727	2593603	470707	2309492	482968	2792460	2986068	spneumoniae-pangenome.S_pseudosimplitigsAC.k_17.d_12.M_default
spneumoniae-pangenome	pseudosimplitigsAC	17	12	ones	7170727	9764330	7493084	2271246	414973	2309492	449696	2759188	2928888	spneumoniae-pangenome.S_pseudosimplitigsAC.k_17.d_12.M_ones
spneumoniae-pangenome	pseudosimplitigsAC	17	12	runs	7170727	9764330	7476673	2287657	403283	2309492	446052	2755544	2924412	spneumoniae-pangenome.S_pseudosimplitigsAC.k_17.d_12.M_runs
spneumoniae-pangenome	pseudosimplitigsAC	17	12	zeros	7170727	9764330	7170727	2593603	480196	2309492	510840	2820332	3001444	spneumoniae-pangenome.S_pseudosimplitigsAC.k_17.d_12.M_zeros
spneumoniae-pangenome	pseudosimplitigsAC	17	2	default	7170727	9688327	7170727	2517600	184860	2243076	223172	2466248	2690076	spneumoniae-pangenome.S_pseudosimplitigsAC.k_17.d_2.M_default
spneumoniae-pangenome	pseudosimplitigsAC	17	2	ones	7170727	9688327	7322467	2365860	163366	2243076	241332	2484408	2663704	spneumoniae-pangenome.S_pseudosimplitigsAC.k_17.d_2.M_ones
spneumoniae-pangenome	pseudosimplitigsAC	17	2	runs	7170727	9688327	7314858	2373469	157804	2243076	230384	2473460	2656828	spneumoniae-pangenome.S_pseudosimplitigsAC.k_17.d_2.M_runs
spneumoniae-pangenome	pseudosimplitigsAC	17	2	zeros	7170727	9688327	7170727	2517600	186755	2243076	227908	2470984	2693184	spneumoniae-pangenome.S_pseudosimplitigsAC.k_17.d_2.M_zeros
spneumoniae-pangenome	pseudosimplitigsAC	17	3	default	7170727	9556269	7170727	2385542	191921	2213440	240436	2453876	2662352	spneumoniae-pangenome.S_pseudosimplitigsAC.k_17.d_3.M_default
spneumoniae-pangenome	pseudosimplitigsAC	17	3	ones	7170727	9556269	7336447	2219822	158983	2213440	240096	2453536	2618104	spneumoniae-pangenome.S_pseudosimplitigsAC.k_17.d_3.M_ones
spneumoniae-pangenome	pseudosimplitigsAC	17	3	runs	7170727	9556269	7329736	2226533	154133	2213440	230792	2444232	2612304	spneumoniae-pangenome.S_pseudosimplitigsAC.k_17.d_3.M_runs
spneumoniae-pangenome	pseudosimplitigsAC	17	3	zeros	7170727	9556269	7170727	2385542	193033	2213440	242872	2456312	2664420	spneumoniae-pangenome.S_pseudosimplitigsAC.k_17.d_3.M_zeros
spneumoniae-pangenome	pseudosimplitigsAC	17	4	default	7170727	9496513	7170727	2325786	209636	2207444	269528	2476972	2672688	spneumoniae-pangenome.S_pseudosimplitigsAC.k_17.d_4.M_default
spneumoniae-pangenome	pseudosimplitigsAC	17	4	ones	7170727	9496513	7357739	2138774	168806	2207444	257864	2465308	2614760	spneumoniae-pangenome.S_pseudosimplitigsAC.k_17.d_4.M_ones
spneumoniae-pangenome	pseudosimplitigsAC	17	4	runs	7170727	9496513	7351281	2145232	164192	2207444	250064	2457508	2609628	spneumoniae-pangenome.S_pseudosimplitigsAC.k_17.d_4.M_runs
spneumoniae-pangenome	pseudosimplitigsAC	17	4	zeros	7170727	9496513	7170727	2325786	210324	2207444	270880	2478324	2674344	spneumoniae-pangenome.S_pseudosimplitigsAC.k_17.d_4.M_zeros
spneumoniae-pangenome	pseudosimplitigsAC	17	5	default	7170727	9483163	7170727	2312436	250544	2225156	323504	2548660	2726144	spneumoniae-pangenome.S_pseudosimplitigsAC.k_17.d_5.M_default
spneumoniae-pangenome	pseudosimplitigsAC	17	5	ones	7170727	9483163	7402264	2080899	199986	2225156	300528	2525684	2654520	spneumoniae-pangenome.S_pseudosimplitigsAC.k_17.d_5.M_ones
spneumoniae-pangenome	pseudosimplitigsAC	17	5	runs	7170727	9483163	7395172	2087991	195078	2225156	294536	2519692	2649488	spneumoniae-pangenome.S_pseudosimplitigsAC.k_17.d_5.M_runs
spneumoniae-pangenome	pseudosimplitigsAC	17	5	zeros	7170727	9483163	7170727	2312436	250771	2225156	323944	2549100	2728176	spneumoniae-pangenome.S_pseudosimplitigsAC.k_17.d_5.M_zeros
spneumoniae-pangenome	pseudosimplitigsAC	17	6	default	7170727	9634130	7170727	2463403	321989	2283484	393972	2677456	2848304	spneumoniae-pangenome.S_pseudosimplitigsAC.k_17.d_6.M_default
spneumoniae-pangenome	pseudosimplitigsAC	17	6	ones	7170727	9634130	7440242	2193888	267432	2283484	367788	2651272	2776964	spneumoniae-pangenome.S_pseudosimplitigsAC.k_17.d_6.M_ones
spneumoniae-pangenome	pseudosimplitigsAC	17	6	runs	7170727	9634130	7430999	2203131	261106	2283484	363044	2646528	2772332	spneumoniae-pangenome.S_pseudosimplitigsAC.k_17.d_6.M_runs
spneumoniae-pangenome	pseudosimplitigsAC	17	6	zeros	7170727	9634130	7170727	2463403	322062	2283484	394204	2677688	2847816	spneumoniae-pangenome.S_pseudosimplitigsAC.k_17.d_6.M_zeros
spneumoniae-pangenome	pseudosimplitigsAC	17	7	default	7170727	9801871	7170727	2631144	398818	2331816	444068	2775884	2953724	spneumoniae-pangenome.S_pseudosimplitigsAC.k_17.d_7.M_default
spneumoniae-pangenome	pseudosimplitigsAC	17	7	ones	7170727	9801871	7473864	2328007	343254	2331816	417940	2749756	2891880	spneumoniae-pangenome.S_pseudosimplitigsAC.k_17.d_7.M_ones
spneumoniae-pangenome	pseudosimplitigsAC	17	7	runs	7170727	9801871	7460384	2341487	334111	2331816	413296	2745112	2885792	spneumoniae-pangenome.S_pseudosimplitigsAC.k_17.d_7.M_runs
spneumoniae-pangenome	pseudosimplitigsAC	17	7	zeros	7170727	9801871	7170727	2631144	398923	2331816	444560	2776376	2952608	spneumoniae-pangenome.S_pseudosimplitigsAC.k_17.d_7.M_zeros
spneumoniae-pangenome	pseudosimplitigsAC	17	8	default	7170727	9843046	7170727	2672319	446431	2338980	468264	2807244	2990244	spneumoniae-pangenome.S_pseudosimplitigsAC.k_17.d_8.M_default
spneumoniae-pangenome	pseudosimplitigsAC	17	8	ones	7170727	9843046	7490208	2352838	390449	2338980	440768	2779748	2930884	spneumoniae-pangenome.S_pseudosimplitigsAC.k_17.d_8.M_ones
spneumoniae-pangenome	pseudosimplitigsAC	17	8	runs	7170727	9843046	7474178	2368868	379388	2338980	436080	2775060	2924500	spneumoniae-pangenome.S_pseudosimplitigsAC.k_17.d_8.M_runs
spneumoniae-pangenome	pseudosimplitigsAC	17	8	zeros	7170727	9843046	7170727	2672319	447206	2338980	471012	2809992	2990260	spneumoniae-pangenome.S_pseudosimplitigsAC.k_17.d_8.M_zeros
spneumoniae-pangenome	pseudosimplitigsAC	17	9	default	7170727	9806263	7170727	2635536	463805	2328004	478044	2806048	2997508	spneumoniae-pangenome.S_pseudosimplitigsAC.k_17.d_9.M_default
spneumoniae-pangenome	pseudosimplitigsAC	17	9	ones	7170727	9806263	7492467	2313796	407992	2328004	448496	2776500	2934788	spneumoniae-pangenome.S_pseudosimplitigsAC.k_17.d_9.M_ones
spneumoniae-pangenome	pseudosimplitigsAC	17	9	runs	7170727	9806263	7476088	2330175	396583	2328004	444260	2772264	2929876	spneumoniae-pangenome.S_pseudosimplitigsAC.k_17.d_9.M_runs
spneumoniae-pangenome	pseudosimplitigsAC	17	9	zeros	7170727	9806263	7170727	2635536	471585	2328004	499872	2827876	3005628	spneumoniae-pangenome.S_pseudosimplitigsAC.k_17.d_9.M_zeros
spneumoniae-pangenome	pseudosimplitigs	18	1	default	7367184	10169277	7367184	2802093	164829	2252472	189036	2441508	2743452	spneumoniae-pangenome.S_pseudosimplitigs.k_18.d_1.M_default
spneumoniae-pangenome	pseudosimplitigs	18	1	ones	7367184	10169277	7496041	2673236	166928	2252472	240996	2493468	2751688	spneumoniae-pangenome.S_pseudosimplitigs.k_18.d_1.M_ones
spneumoniae-pangenome	pseudosimplitigs	18	1	runs	7367184	10169277	7492840	2676437	164688	2252472	235984	2488456	2748484	spneumoniae-pangenome.S_pseudosimplitigs.k_18.d_1.M_runs
spneumoniae-pangenome	pseudosimplitigs	18	1	zeros	7367184	10169277	7367184	2802093	166906	2252472	196528	2449000	2746404	spneumoniae-pangenome.S_pseudosimplitigs.k_18.d_1.M_zeros
spneumoniae-pangenome	pseudosimplitigs	18	10	default	7367184	10344627	7367184	2977443	440268	2398652	464756	2863408	3098460	spneumoniae-pangenome.S_pseudosimplitigs.k_18.d_10.M_default
spneumoniae-pangenome	pseudosimplitigs	18	10	ones	7367184	10344627	7702014	2642613	391182	2398652	440016	2838668	3043304	spneumoniae-pangenome.S_pseudosimplitigs.k_18.d_10.M_ones
spneumoniae-pangenome	pseudosimplitigs	18	10	runs	7367184	10344627	7687087	2657540	380986	2398652	438032	2836684	3038536	spneumoniae-pangenome.S_pseudosimplitigs.k_18.d_10.M_runs
spneumoniae-pangenome	pseudosimplitigs	18	10	zeros	7367184	10344627	7367184	2977443	445600	2398652	482336	2880988	3111256	spneumoniae-pangenome.S_pseudosimplitigs.k_18.d_10.M_zeros
spneumoniae-pangenome	pseudosimplitigs	18	11	default	7367184	10358854	7367184	2991670	447053	2396108	469404	2865512	3101532	spneumoniae-pangenome.S_pseudosimplitigs.k_18.d_11.M_default
spneumoniae-pangenome	pseudosimplitigs	18	11	ones	7367184	10358854	7703966	2654888	398091	2396108	443164	2839272	3049404	spneumoniae-pangenome.S_pseudosimplitigs.k_18.d_11.M_ones
spneumoniae-pangenome	pseudosimplitigs	18	11	runs	7367184	10358854	7687904	2670950	387139	2396108	441052	2837160	3044448	spneumoniae-pangenome.S_pseudosimplitigs.k_18.d_11.M_runs
spneumoniae-pangenome	pseudosimplitigs	18	11	zeros	7367184	10358854	7367184	2991670	454277	2396108	492724	2888832	3118552	spneumoniae-pangenome.S_pseudosimplitigs.k_18.d_11.M_zeros
spneumoniae-pangenome	pseudosimplitigs	18	12	default	7367184	10360844	7367184	2993660	448447	2391376	471772	2863148	3099120	spneumoniae-pangenome.S_pseudosimplitigs.k_18.d_12.M_default
spneumoniae-pangenome	pseudosimplitigs	18	12	ones	7367184	10360844	7705117	2655727	399524	2391376	444064	2835440	3047444	spneumoniae-pangenome.S_pseudosimplitigs.k_18.d_12.M_ones
spneumoniae-pangenome	pseudosimplitigs	18	12	runs	7367184	10360844	7688249	2672595	388098	2391376	442588	2833964	3043064	spneumoniae-pangenome.S_pseudosimplitigs.k_18.d_12.M_runs
spneumoniae-pangenome	pseudosimplitigs	18	12	zeros	7367184	10360844	7367184	2993660	455920	2391376	495928	2887304	3117536	spneumoniae-pangenome.S_pseudosimplitigs.k_18.d_12.M_zeros
spneumoniae-pangenome	pseudosimplitigs	18	2	default	7367184	9981489	7367184	2614305	166657	2208840	199216	2408056	2690708	spneumoniae-pangenome.S_pseudosimplitigs.k_18.d_2.M_default
spneumoniae-pangenome	pseudosimplitigs	18	2	ones	7367184	9981489	7496564	2484925	155617	2208840	227896	2436736	2679472	spneumoniae-pangenome.S_pseudosimplitigs.k_18.d_2.M_ones
spneumoniae-pangenome	pseudosimplitigs	18	2	runs	7367184	9981489	7493930	2487559	153756	2208840	223672	2432512	2677172	spneumoniae-pangenome.S_pseudosimplitigs.k_18.d_2.M_runs
spneumoniae-pangenome	pseudosimplitigs	18	2	zeros	7367184	9981489	7367184	2614305	167444	2208840	201800	2410640	2692112	spneumoniae-pangenome.S_pseudosimplitigs.k_18.d_2.M_zeros
spneumoniae-pangenome	pseudosimplitigs	18	3	default	7367184	9861412	7367184	2494228	169322	2180396	208980	2389376	2660376	spneumoniae-pangenome.S_pseudosimplitigs.k_18.d_3.M_default
spneumoniae-pangenome	pseudosimplitigs	18	3	ones	7367184	9861412	7508203	2353209	149335	2180396	222852	2403248	2633424	spneumoniae-pangenome.S_pseudosimplitigs.k_18.d_3.M_ones
spneumoniae-pangenome	pseudosimplitigs	18	3	runs	7367184	9861412	7505798	2355614	147640	2180396	219148	2399544	2631124	spneumoniae-pangenome.S_pseudosimplitigs.k_18.d_3.M_runs
spneumoniae-pangenome	pseudosimplitigs	18	3	zeros	7367184	9861412	7367184	2494228	169821	2180396	210436	2390832	2660848	spneumoniae-pangenome.S_pseudosimplitigs.k_18.d_3.M_zeros
spneumoniae-pangenome	pseudosimplitigs	18	4	default	7367184	9717562	7367184	2350378	176094	2146160	225916	2372076	2626280	spneumoniae-pangenome.S_pseudosimplitigs.k_18.d_4.M_default
spneumoniae-pangenome	pseudosimplitigs	18	4	ones	7367184	9717562	7537981	2179581	143940	2146160	222156	2368316	2575328	spneumoniae-pangenome.S_pseudosimplitigs.k_18.d_4.M_ones
spneumoniae-pangenome	pseudosimplitigs	18	4	runs	7367184	9717562	7535742	2181820	142356	2146160	218972	2365132	2573764	spneumoniae-pangenome.S_pseudosimplitigs.k_18.d_4.M_runs
spneumoniae-pangenome	pseudosimplitigs	18	4	zeros	7367184	9717562	7367184	2350378	176389	2146160	226728	2372888	2626136	spneumoniae-pangenome.S_pseudosimplitigs.k_18.d_4.M_zeros
spneumoniae-pangenome	pseudosimplitigs	18	5	default	7367184	9687485	7367184	2320301	192124	2156444	253400	2409844	2647192	spneumoniae-pangenome.S_pseudosimplitigs.k_18.d_5.M_default
spneumoniae-pangenome	pseudosimplitigs	18	5	ones	7367184	9687485	7563550	2123935	153960	2156444	241232	2397676	2585408	spneumoniae-pangenome.S_pseudosimplitigs.k_18.d_5.M_ones
spneumoniae-pangenome	pseudosimplitigs	18	5	runs	7367184	9687485	7561082	2126403	152255	2156444	238520	2394964	2583492	spneumoniae-pangenome.S_pseudosimplitigs.k_18.d_5.M_runs
spneumoniae-pangenome	pseudosimplitigs	18	5	zeros	7367184	9687485	7367184	2320301	192260	2156444	253784	2410228	2646688	spneumoniae-pangenome.S_pseudosimplitigs.k_18.d_5.M_zeros
spneumoniae-pangenome	pseudosimplitigs	18	6	default	7367184	9764252	7367184	2397068	230468	2207404	304596	2512000	2732916	spneumoniae-pangenome.S_pseudosimplitigs.k_18.d_6.M_default
spneumoniae-pangenome	pseudosimplitigs	18	6	ones	7367184	9764252	7598013	2166239	187322	2207404	286420	2493824	2660844	spneumoniae-pangenome.S_pseudosimplitigs.k_18.d_6.M_ones
spneumoniae-pangenome	pseudosimplitigs	18	6	runs	7367184	9764252	7594199	2170053	184809	2207404	283984	2491388	2657920	spneumoniae-pangenome.S_pseudosimplitigs.k_18.d_6.M_runs
spneumoniae-pangenome	pseudosimplitigs	18	6	zeros	7367184	9764252	7367184	2397068	230548	2207404	304728	2512132	2729360	spneumoniae-pangenome.S_pseudosimplitigs.k_18.d_6.M_zeros
spneumoniae-pangenome	pseudosimplitigs	18	7	default	7367184	9968005	7367184	2600821	297917	2292584	374224	2666808	2876628	spneumoniae-pangenome.S_pseudosimplitigs.k_18.d_7.M_default
spneumoniae-pangenome	pseudosimplitigs	18	7	ones	7367184	9968005	7646381	2321624	250061	2292584	353024	2645608	2806028	spneumoniae-pangenome.S_pseudosimplitigs.k_18.d_7.M_ones
spneumoniae-pangenome	pseudosimplitigs	18	7	runs	7367184	9968005	7639549	2328456	245671	2292584	350352	2642936	2802600	spneumoniae-pangenome.S_pseudosimplitigs.k_18.d_7.M_runs
spneumoniae-pangenome	pseudosimplitigs	18	7	zeros	7367184	9968005	7367184	2600821	297959	2292584	374244	2666828	2877156	spneumoniae-pangenome.S_pseudosimplitigs.k_18.d_7.M_zeros
spneumoniae-pangenome	pseudosimplitigs	18	8	default	7367184	10224854	7367184	2857670	373634	2368440	429952	2798392	3017080	spneumoniae-pangenome.S_pseudosimplitigs.k_18.d_8.M_default
spneumoniae-pangenome	pseudosimplitigs	18	8	ones	7367184	10224854	7681077	2543777	324460	2368440	407428	2775868	2953936	spneumoniae-pangenome.S_pseudosimplitigs.k_18.d_8.M_ones
spneumoniae-pangenome	pseudosimplitigs	18	8	runs	7367184	10224854	7670287	2554567	317406	2368440	404920	2773360	2949452	spneumoniae-pangenome.S_pseudosimplitigs.k_18.d_8.M_runs
spneumoniae-pangenome	pseudosimplitigs	18	8	zeros	7367184	10224854	7367184	2857670	373838	2368440	430708	2799148	3017416	spneumoniae-pangenome.S_pseudosimplitigs.k_18.d_8.M_zeros
spneumoniae-pangenome	pseudosimplitigs	18	9	default	7367184	10341840	7367184	2974656	423039	2398484	455724	2854208	3083824	spneumoniae-pangenome.S_pseudosimplitigs.k_18.d_9.M_default
spneumoniae-pangenome	pseudosimplitigs	18	9	ones	7367184	10341840	7697838	2644002	373701	2398484	432224	2830708	3026136	spneumoniae-pangenome.S_pseudosimplitigs.k_18.d_9.M_ones
spneumoniae-pangenome	pseudosimplitigs	18	9	runs	7367184	10341840	7683961	2657879	364411	2398484	429416	2827900	3020444	spneumoniae-pangenome.S_pseudosimplitigs.k_18.d_9.M_runs
spneumoniae-pangenome	pseudosimplitigs	18	9	zeros	7367184	10341840	7367184	2974656	423414	2398484	456736	2855220	3084332	spneumoniae-pangenome.S_pseudosimplitigs.k_18.d_9.M_zeros
spneumoniae-pangenome	pseudosimplitigsAC	18	1	default	7367184	10169345	7367184	2802161	164833	2300096	188640	2488736	2762432	spneumoniae-pangenome.S_pseudosimplitigsAC.k_18.d_1.M_default
spneumoniae-pangenome	pseudosimplitigsAC	18	1	ones	7367184	10169345	7494658	2674687	167009	2300096	239788	2539884	2771412	spneumoniae-pangenome.S_pseudosimplitigsAC.k_18.d_1.M_ones
spneumoniae-pangenome	pseudosimplitigsAC	18	1	runs	7367184	10169345	7491228	2678117	164659	2300096	234752	2534848	2768208	spneumoniae-pangenome.S_pseudosimplitigsAC.k_18.d_1.M_runs
spneumoniae-pangenome	pseudosimplitigsAC	18	1	zeros	7367184	10169345	7367184	2802161	166907	2300096	196316	2496412	2765952	spneumoniae-pangenome.S_pseudosimplitigsAC.k_18.d_1.M_zeros
spneumoniae-pangenome	pseudosimplitigsAC	18	10	default	7367184	10310693	7367184	2943509	438431	2389244	460988	2850232	3090364	spneumoniae-pangenome.S_pseudosimplitigsAC.k_18.d_10.M_default
spneumoniae-pangenome	pseudosimplitigsAC	18	10	ones	7367184	10310693	7698927	2611766	389342	2389244	436780	2826024	3036576	spneumoniae-pangenome.S_pseudosimplitigsAC.k_18.d_10.M_ones
spneumoniae-pangenome	pseudosimplitigsAC	18	10	runs	7367184	10310693	7684709	2625984	379688	2389244	434432	2823676	3032204	spneumoniae-pangenome.S_pseudosimplitigsAC.k_18.d_10.M_runs
spneumoniae-pangenome	pseudosimplitigsAC	18	10	zeros	7367184	10310693	7367184	2943509	445490	2389244	484456	2873700	3106520	spneumoniae-pangenome.S_pseudosimplitigsAC.k_18.d_10.M_zeros
spneumoniae-pangenome	pseudosimplitigsAC	18	11	default	7367184	10293774	7367184	2926590	444038	2378760	464124	2842884	3083148	spneumoniae-pangenome.S_pseudosimplitigsAC.k_18.d_11.M_default
spneumoniae-pangenome	pseudosimplitigsAC	18	11	ones	7367184	10293774	7698567	2595207	395050	2378760	437704	2816464	3031528	spneumoniae-pangenome.S_pseudosimplitigsAC.k_18.d_11.M_ones
spneumoniae-pangenome	pseudosimplitigsAC	18	11	runs	7367184	10293774	7684296	2609478	385217	2378760	435980	2814740	3026824	spneumoniae-pangenome.S_pseudosimplitigsAC.k_18.d_11.M_runs
spneumoniae-pangenome	pseudosimplitigsAC	18	11	zeros	7367184	10293774	7367184	2926590	451174	2378760	487628	2866388	3099000	spneumoniae-pangenome.S_pseudosimplitigsAC.k_18.d_11.M_zeros
spneumoniae-pangenome	pseudosimplitigsAC	18	12	default	7367184	10283204	7367184	2916020	445470	2371492	466104	2837596	3079792	spneumoniae-pangenome.S_pseudosimplitigsAC.k_18.d_12.M_default
spneumoniae-pangenome	pseudosimplitigsAC	18	12	ones	7367184	10283204	7698710	2584494	396518	2371492	438712	2810204	3028904	spneumoniae-pangenome.S_pseudosimplitigsAC.k_18.d_12.M_ones
spneumoniae-pangenome	pseudosimplitigsAC	18	12	runs	7367184	10283204	7684335	2598869	386604	2371492	436976	2808468	3024796	spneumoniae-pangenome.S_pseudosimplitigsAC.k_18.d_12.M_runs
spneumoniae-pangenome	pseudosimplitigsAC	18	12	zeros	7367184	10283204	7367184	2916020	453283	2371492	492396	2863888	3097996	spneumoniae-pangenome.S_pseudosimplitigsAC.k_18.d_12.M_zeros
spneumoniae-pangenome	pseudosimplitigsAC	18	2	default	7367184	9981193	7367184	2614009	166537	2253644	199208	2452852	2711324	spneumoniae-pangenome.S_pseudosimplitigsAC.k_18.d_2.M_default
spneumoniae-pangenome	pseudosimplitigsAC	18	2	ones	7367184	9981193	7496285	2484908	155625	2253644	227060	2480704	2698640	spneumoniae-pangenome.S_pseudosimplitigsAC.k_18.d_2.M_ones
spneumoniae-pangenome	pseudosimplitigsAC	18	2	runs	7367184	9981193	7493664	2487529	153718	2253644	222648	2476292	2696644	spneumoniae-pangenome.S_pseudosimplitigsAC.k_18.d_2.M_runs
spneumoniae-pangenome	pseudosimplitigsAC	18	2	zeros	7367184	9981193	7367184	2614009	167328	2253644	201872	2455516	2711612	spneumoniae-pangenome.S_pseudosimplitigsAC.k_18.d_2.M_zeros
spneumoniae-pangenome	pseudosimplitigsAC	18	3	default	7367184	9861334	7367184	2494150	169181	2224016	209140	2433156	2679736	spneumoniae-pangenome.S_pseudosimplitigsAC.k_18.d_3.M_default
spneumoniae-pangenome	pseudosimplitigsAC	18	3	ones	7367184	9861334	7507577	2353757	149337	2224016	222512	2446528	2652716	spneumoniae-pangenome.S_pseudosimplitigsAC.k_18.d_3.M_ones
spneumoniae-pangenome	pseudosimplitigsAC	18	3	runs	7367184	9861334	7505174	2356160	147608	2224016	218476	2442492	2649320	spneumoniae-pangenome.S_pseudosimplitigsAC.k_18.d_3.M_runs
spneumoniae-pangenome	pseudosimplitigsAC	18	3	zeros	7367184	9861334	7367184	2494150	169644	2224016	210444	2434460	2679880	spneumoniae-pangenome.S_pseudosimplitigsAC.k_18.d_3.M_zeros
spneumoniae-pangenome	pseudosimplitigsAC	18	4	default	7367184	9717696	7367184	2350512	175898	2190352	224500	2414852	2647916	spneumoniae-pangenome.S_pseudosimplitigsAC.k_18.d_4.M_default
spneumoniae-pangenome	pseudosimplitigsAC	18	4	ones	7367184	9717696	7536947	2180749	143866	2190352	220908	2411260	2596964	spneumoniae-pangenome.S_pseudosimplitigsAC.k_18.d_4.M_ones
spneumoniae-pangenome	pseudosimplitigsAC	18	4	runs	7367184	9717696	7534722	2182974	142290	2190352	217608	2407960	2594536	spneumoniae-pangenome.S_pseudosimplitigsAC.k_18.d_4.M_runs
spneumoniae-pangenome	pseudosimplitigsAC	18	4	zeros	7367184	9717696	7367184	2350512	176166	2190352	225300	2415652	2647388	spneumoniae-pangenome.S_pseudosimplitigsAC.k_18.d_4.M_zeros
spneumoniae-pangenome	pseudosimplitigsAC	18	5	default	7367184	9685309	7367184	2318125	191520	2192696	251728	2444424	2664140	spneumoniae-pangenome.S_pseudosimplitigsAC.k_18.d_5.M_default
spneumoniae-pangenome	pseudosimplitigsAC	18	5	ones	7367184	9685309	7562725	2122584	153396	2192696	239216	2431912	2602060	spneumoniae-pangenome.S_pseudosimplitigsAC.k_18.d_5.M_ones
spneumoniae-pangenome	pseudosimplitigsAC	18	5	runs	7367184	9685309	7560175	2125134	151622	2192696	236316	2429012	2600844	spneumoniae-pangenome.S_pseudosimplitigsAC.k_18.d_5.M_runs
spneumoniae-pangenome	pseudosimplitigsAC	18	5	zeros	7367184	9685309	7367184	2318125	191664	2192696	252184	2444880	2664552	spneumoniae-pangenome.S_pseudosimplitigsAC.k_18.d_5.M_zeros
spneumoniae-pangenome	pseudosimplitigsAC	18	6	default	7367184	9757675	7367184	2390491	229434	2231804	302772	2534576	2743852	spneumoniae-pangenome.S_pseudosimplitigsAC.k_18.d_6.M_default
spneumoniae-pangenome	pseudosimplitigsAC	18	6	ones	7367184	9757675	7596664	2161011	186275	2231804	284088	2515892	2673380	spneumoniae-pangenome.S_pseudosimplitigsAC.k_18.d_6.M_ones
spneumoniae-pangenome	pseudosimplitigsAC	18	6	runs	7367184	9757675	7593084	2164591	183871	2231804	281676	2513480	2670900	spneumoniae-pangenome.S_pseudosimplitigsAC.k_18.d_6.M_runs
spneumoniae-pangenome	pseudosimplitigsAC	18	6	zeros	7367184	9757675	7367184	2390491	229534	2231804	303024	2534828	2745056	spneumoniae-pangenome.S_pseudosimplitigsAC.k_18.d_6.M_zeros
spneumoniae-pangenome	pseudosimplitigsAC	18	7	default	7367184	9961084	7367184	2593900	297125	2302592	372928	2675520	2880728	spneumoniae-pangenome.S_pseudosimplitigsAC.k_18.d_7.M_default
spneumoniae-pangenome	pseudosimplitigsAC	18	7	ones	7367184	9961084	7646623	2314461	249198	2302592	351460	2654052	2811664	spneumoniae-pangenome.S_pseudosimplitigsAC.k_18.d_7.M_ones
spneumoniae-pangenome	pseudosimplitigsAC	18	7	runs	7367184	9961084	7640109	2320975	244964	2302592	349008	2651600	2807612	spneumoniae-pangenome.S_pseudosimplitigsAC.k_18.d_7.M_runs
spneumoniae-pangenome	pseudosimplitigsAC	18	7	zeros	7367184	9961084	7367184	2593900	297157	2302592	373076	2675668	2880368	spneumoniae-pangenome.S_pseudosimplitigsAC.k_18.d_7.M_zeros
spneumoniae-pangenome	pseudosimplitigsAC	18	8	default	7367184	10217005	7367184	2849821	372905	2367844	428604	2796448	3018076	spneumoniae-pangenome.S_pseudosimplitigsAC.k_18.d_8.M_default
spneumoniae-pangenome	pseudosimplitigsAC	18	8	ones	7367184	10217005	7680097	2536908	323543	2367844	405412	2773256	2953716	spneumoniae-pangenome.S_pseudosimplitigsAC.k_18.d_8.M_ones
spneumoniae-pangenome	pseudosimplitigsAC	18	8	runs	7367184	10217005	7669624	2547381	316788	2367844	403120	2770964	2949496	spneumoniae-pangenome.S_pseudosimplitigsAC.k_18.d_8.M_runs
spneumoniae-pangenome	pseudosimplitigsAC	18	8	zeros	7367184	10217005	7367184	2849821	373186	2367844	429892	2797736	3017364	spneumoniae-pangenome.S_pseudosimplitigsAC.k_18.d_8.M_zeros
spneumoniae-pangenome	pseudosimplitigsAC	18	9	default	7367184	10322196	7367184	2955012	421046	2389604	451908	2841512	3074940	spneumoniae-pangenome.S_pseudosimplitigsAC.k_18.d_9.M_default
spneumoniae-pangenome	pseudosimplitigsAC	18	9	ones	7367184	10322196	7695748	2626448	371865	2389604	428528	2818132	3016012	spneumoniae-pangenome.S_pseudosimplitigsAC.k_18.d_9.M_ones
spneumoniae-pangenome	pseudosimplitigsAC	18	9	runs	7367184	10322196	7682158	2640038	362896	2389604	425852	2815456	3010492	spneumoniae-pangenome.S_pseudosimplitigsAC.k_18.d_9.M_runs
spneumoniae-pangenome	pseudosimplitigsAC	18	9	zeros	7367184	10322196	7367184	2955012	422093	2389604	455992	2845596	3075688	spneumoniae-pangenome.S_pseudosimplitigsAC.k_18.d_9.M_zeros
spneumoniae-pangenome	pseudosimplitigs	19	1	default	7551412	10580164	7551412	3028752	168264	2287620	189096	2476716	2824612	spneumoniae-pangenome.S_pseudosimplitigs.k_19.d_1.M_default
spneumoniae-pangenome	pseudosimplitigs	19	1	ones	7551412	10580164	7679149	2901015	169128	2287620	240068	2527688	2826404	spneumoniae-pangenome.S_pseudosimplitigs.k_19.d_1.M_ones
spneumoniae-pangenome	pseudosimplitigs	19	1	runs	7551412	10580164	7677599	2902565	168089	2287620	237948	2525568	2825280	spneumoniae-pangenome.S_pseudosimplitigs.k_19.d_1.M_runs
spneumoniae-pangenome	pseudosimplitigs	19	1	zeros	7551412	10580164	7551412	3028752	169778	2287620	195684	2483304	2827780	spneumoniae-pangenome.S_pseudosimplitigs.k_19.d_1.M_zeros
spneumoniae-pangenome	pseudosimplitigs	19	10	default	7551412	10840174	7551412	3288762	417037	2451312	460732	2912044	3201296	spneumoniae-pangenome.S_pseudosimplitigs.k_19.d_10.M_default
spneumoniae-pangenome	pseudosimplitigs	19	10	ones	7551412	10840174	7920052	2920122	361367	2451312	430544	2881856	3123700	spneumoniae-pangenome.S_pseudosimplitigs.k_19.d_10.M_ones
spneumoniae-pangenome	pseudosimplitigs	19	10	runs	7551412	10840174	7907432	2932742	353039	2451312	428840	2880152	3117596	spneumoniae-pangenome.S_pseudosimplitigs.k_19.d_10.M_runs
spneumoniae-pangenome	pseudosimplitigs	19	10	zeros	7551412	10840174	7551412	3288762	419767	2451312	472852	2924164	3206184	spneumoniae-pangenome.S_pseudosimplitigs.k_19.d_10.M_zeros
spneumoniae-pangenome	pseudosimplitigs	19	11	default	7551412	10880796	7551412	3329384	435975	2463124	470212	2933336	3226048	spneumoniae-pangenome.S_pseudosimplitigs.k_19.d_11.M_default
spneumoniae-pangenome	pseudosimplitigs	19	11	ones	7551412	10880796	7923321	2957475	380674	2463124	438596	2901720	3152692	spneumoniae-pangenome.S_pseudosimplitigs.k_19.d_11.M_ones
spneumoniae-pangenome	pseudosimplitigs	19	11	runs	7551412	10880796	7909232	2971564	371344	2463124	437144	2900268	3148392	spneumoniae-pangenome.S_pseudosimplitigs.k_19.d_11.M_runs
spneumoniae-pangenome	pseudosimplitigs	19	11	zeros	7551412	10880796	7551412	3329384	438961	2463124	483308	2946432	3231976	spneumoniae-pangenome.S_pseudosimplitigs.k_19.d_11.M_zeros
spneumoniae-pangenome	pseudosimplitigs	19	12	default	7551412	10892356	7551412	3340944	441777	2464380	475864	2940244	3230896	spneumoniae-pangenome.S_pseudosimplitigs.k_19.d_12.M_default
spneumoniae-pangenome	pseudosimplitigs	19	12	ones	7551412	10892356	7925303	2967053	386401	2464380	441944	2906324	3160420	spneumoniae-pangenome.S_pseudosimplitigs.k_19.d_12.M_ones
spneumoniae-pangenome	pseudosimplitigs	19	12	runs	7551412	10892356	7910347	2982009	376470	2464380	441008	2905388	3156496	spneumoniae-pangenome.S_pseudosimplitigs.k_19.d_12.M_runs
spneumoniae-pangenome	pseudosimplitigs	19	12	zeros	7551412	10892356	7551412	3340944	447702	2464380	498052	2962432	3243780	spneumoniae-pangenome.S_pseudosimplitigs.k_19.d_12.M_zeros
spneumoniae-pangenome	pseudosimplitigs	19	2	default	7551412	10412697	7551412	2861285	169386	2247824	197900	2445724	2778220	spneumoniae-pangenome.S_pseudosimplitigs.k_19.d_2.M_default
spneumoniae-pangenome	pseudosimplitigs	19	2	ones	7551412	10412697	7680538	2732159	159570	2247824	230228	2478052	2763300	spneumoniae-pangenome.S_pseudosimplitigs.k_19.d_2.M_ones
spneumoniae-pangenome	pseudosimplitigs	19	2	runs	7551412	10412697	7679358	2733339	158752	2247824	228408	2476232	2762108	spneumoniae-pangenome.S_pseudosimplitigs.k_19.d_2.M_runs
spneumoniae-pangenome	pseudosimplitigs	19	2	zeros	7551412	10412697	7551412	2861285	169966	2247824	200300	2448124	2778892	spneumoniae-pangenome.S_pseudosimplitigs.k_19.d_2.M_zeros
spneumoniae-pangenome	pseudosimplitigs	19	3	default	7551412	10179392	7551412	2627980	170701	2191352	207944	2399296	2711464	spneumoniae-pangenome.S_pseudosimplitigs.k_19.d_3.M_default
spneumoniae-pangenome	pseudosimplitigs	19	3	ones	7551412	10179392	7699213	2480179	145610	2191352	216768	2408120	2668840	spneumoniae-pangenome.S_pseudosimplitigs.k_19.d_3.M_ones
spneumoniae-pangenome	pseudosimplitigs	19	3	runs	7551412	10179392	7698279	2481113	144943	2191352	215084	2406436	2667484	spneumoniae-pangenome.S_pseudosimplitigs.k_19.d_3.M_runs
spneumoniae-pangenome	pseudosimplitigs	19	3	zeros	7551412	10179392	7551412	2627980	170927	2191352	208696	2400048	2710304	spneumoniae-pangenome.S_pseudosimplitigs.k_19.d_3.M_zeros
spneumoniae-pangenome	pseudosimplitigs	19	4	default	7551412	10087416	7551412	2536004	173349	2170196	216512	2386708	2688600	spneumoniae-pangenome.S_pseudosimplitigs.k_19.d_4.M_default
spneumoniae-pangenome	pseudosimplitigs	19	4	ones	7551412	10087416	7716752	2370664	141345	2170196	215076	2385272	2630956	spneumoniae-pangenome.S_pseudosimplitigs.k_19.d_4.M_ones
spneumoniae-pangenome	pseudosimplitigs	19	4	runs	7551412	10087416	7715821	2371595	140692	2170196	213524	2383720	2630616	spneumoniae-pangenome.S_pseudosimplitigs.k_19.d_4.M_runs
spneumoniae-pangenome	pseudosimplitigs	19	4	zeros	7551412	10087416	7551412	2536004	173468	2170196	216896	2387092	2687396	spneumoniae-pangenome.S_pseudosimplitigs.k_19.d_4.M_zeros
spneumoniae-pangenome	pseudosimplitigs	19	5	default	7551412	10025701	7551412	2474289	179073	2161644	230100	2391744	2678260	spneumoniae-pangenome.S_pseudosimplitigs.k_19.d_5.M_default
spneumoniae-pangenome	pseudosimplitigs	19	5	ones	7551412	10025701	7739082	2286619	141207	2161644	219188	2380832	2611776	spneumoniae-pangenome.S_pseudosimplitigs.k_19.d_5.M_ones
spneumoniae-pangenome	pseudosimplitigs	19	5	runs	7551412	10025701	7738067	2287634	140514	2161644	217956	2379600	2611036	spneumoniae-pangenome.S_pseudosimplitigs.k_19.d_5.M_runs
spneumoniae-pangenome	pseudosimplitigs	19	5	zeros	7551412	10025701	7551412	2474289	179165	2161644	230376	2392020	2678600	spneumoniae-pangenome.S_pseudosimplitigs.k_19.d_5.M_zeros
spneumoniae-pangenome	pseudosimplitigs	19	6	default	7551412	9969050	7551412	2417638	194069	2160936	257412	2418348	2686464	spneumoniae-pangenome.S_pseudosimplitigs.k_19.d_6.M_default
spneumoniae-pangenome	pseudosimplitigs	19	6	ones	7551412	9969050	7784987	2184063	147378	2160936	234472	2395408	2602748	spneumoniae-pangenome.S_pseudosimplitigs.k_19.d_6.M_ones
spneumoniae-pangenome	pseudosimplitigs	19	6	runs	7551412	9969050	7783535	2185515	146429	2160936	233268	2394204	2602792	spneumoniae-pangenome.S_pseudosimplitigs.k_19.d_6.M_runs
spneumoniae-pangenome	pseudosimplitigs	19	6	zeros	7551412	9969050	7551412	2417638	194126	2160936	257568	2418504	2686016	spneumoniae-pangenome.S_pseudosimplitigs.k_19.d_6.M_zeros
spneumoniae-pangenome	pseudosimplitigs	19	7	default	7551412	10077319	7551412	2525907	229953	2221556	306500	2528056	2777700	spneumoniae-pangenome.S_pseudosimplitigs.k_19.d_7.M_default
spneumoniae-pangenome	pseudosimplitigs	19	7	ones	7551412	10077319	7821658	2255661	179003	2221556	278616	2500172	2691276	spneumoniae-pangenome.S_pseudosimplitigs.k_19.d_7.M_ones
spneumoniae-pangenome	pseudosimplitigs	19	7	runs	7551412	10077319	7819071	2258248	177354	2221556	277256	2498812	2689692	spneumoniae-pangenome.S_pseudosimplitigs.k_19.d_7.M_runs
spneumoniae-pangenome	pseudosimplitigs	19	7	zeros	7551412	10077319	7551412	2525907	229991	2221556	306636	2528192	2777796	spneumoniae-pangenome.S_pseudosimplitigs.k_19.d_7.M_zeros
spneumoniae-pangenome	pseudosimplitigs	19	8	default	7551412	10361926	7551412	2810514	295593	2327068	377268	2704336	2950968	spneumoniae-pangenome.S_pseudosimplitigs.k_19.d_8.M_default
spneumoniae-pangenome	pseudosimplitigs	19	8	ones	7551412	10361926	7864166	2497760	241511	2327068	347588	2674656	2867220	spneumoniae-pangenome.S_pseudosimplitigs.k_19.d_8.M_ones
spneumoniae-pangenome	pseudosimplitigs	19	8	runs	7551412	10361926	7858497	2503429	237967	2327068	345976	2673044	2865144	spneumoniae-pangenome.S_pseudosimplitigs.k_19.d_8.M_runs
spneumoniae-pangenome	pseudosimplitigs	19	8	zeros	7551412	10361926	7551412	2810514	295646	2327068	377488	2704556	2950640	spneumoniae-pangenome.S_pseudosimplitigs.k_19.d_8.M_zeros
spneumoniae-pangenome	pseudosimplitigs	19	9	default	7551412	10682210	7551412	3130798	369506	2419436	435436	2854872	3118552	spneumoniae-pangenome.S_pseudosimplitigs.k_19.d_9.M_default
spneumoniae-pangenome	pseudosimplitigs	19	9	ones	7551412	10682210	7903258	2778952	313645	2419436	405476	2824912	3040124	spneumoniae-pangenome.S_pseudosimplitigs.k_19.d_9.M_ones
spneumoniae-pangenome	pseudosimplitigs	19	9	runs	7551412	10682210	7893532	2788678	307490	2419436	403724	2823160	3035552	spneumoniae-pangenome.S_pseudosimplitigs.k_19.d_9.M_runs
spneumoniae-pangenome	pseudosimplitigs	19	9	zeros	7551412	10682210	7551412	3130798	369565	2419436	435524	2854960	3118860	spneumoniae-pangenome.S_pseudosimplitigs.k_19.d_9.M_zeros
spneumoniae-pangenome	pseudosimplitigsAC	19	1	default	7551412	10580416	7551412	3029004	168278	2345520	189832	2535352	2849164	spneumoniae-pangenome.S_pseudosimplitigsAC.k_19.d_1.M_default
spneumoniae-pangenome	pseudosimplitigsAC	19	1	ones	7551412	10580416	7678216	2902200	169114	2345520	239608	2585128	2852768	spneumoniae-pangenome.S_pseudosimplitigsAC.k_19.d_1.M_ones
spneumoniae-pangenome	pseudosimplitigsAC	19	1	runs	7551412	10580416	7676726	2903690	168120	2345520	237592	2583112	2850956	spneumoniae-pangenome.S_pseudosimplitigsAC.k_19.d_1.M_runs
spneumoniae-pangenome	pseudosimplitigsAC	19	1	zeros	7551412	10580416	7551412	3029004	169716	2345520	196024	2541544	2851472	spneumoniae-pangenome.S_pseudosimplitigsAC.k_19.d_1.M_zeros
spneumoniae-pangenome	pseudosimplitigsAC	19	10	default	7551412	10828919	7551412	3277507	416015	2452356	459260	2911616	3200588	spneumoniae-pangenome.S_pseudosimplitigsAC.k_19.d_10.M_default
spneumoniae-pangenome	pseudosimplitigsAC	19	10	ones	7551412	10828919	7918161	2910758	360384	2452356	428504	2880860	3123904	spneumoniae-pangenome.S_pseudosimplitigsAC.k_19.d_10.M_ones
spneumoniae-pangenome	pseudosimplitigsAC	19	10	runs	7551412	10828919	7905961	2922958	352477	2452356	426824	2879180	3118316	spneumoniae-pangenome.S_pseudosimplitigsAC.k_19.d_10.M_runs
spneumoniae-pangenome	pseudosimplitigsAC	19	10	zeros	7551412	10828919	7551412	3277507	418354	2452356	469412	2921768	3203468	spneumoniae-pangenome.S_pseudosimplitigsAC.k_19.d_10.M_zeros
spneumoniae-pangenome	pseudosimplitigsAC	19	11	default	7551412	10844438	7551412	3293026	434417	2458720	467924	2926644	3220392	spneumoniae-pangenome.S_pseudosimplitigsAC.k_19.d_11.M_default
spneumoniae-pangenome	pseudosimplitigsAC	19	11	ones	7551412	10844438	7921330	2923108	379055	2458720	435676	2894396	3149992	spneumoniae-pangenome.S_pseudosimplitigsAC.k_19.d_11.M_ones
spneumoniae-pangenome	pseudosimplitigsAC	19	11	runs	7551412	10844438	7908116	2936322	370255	2458720	434444	2893164	3145268	spneumoniae-pangenome.S_pseudosimplitigsAC.k_19.d_11.M_runs
spneumoniae-pangenome	pseudosimplitigsAC	19	11	zeros	7551412	10844438	7551412	3293026	439538	2458720	487516	2946236	3231484	spneumoniae-pangenome.S_pseudosimplitigsAC.k_19.d_11.M_zeros
spneumoniae-pangenome	pseudosimplitigsAC	19	12	default	7551412	10827555	7551412	3276143	439466	2443420	471316	2914736	3213072	spneumoniae-pangenome.S_pseudosimplitigsAC.k_19.d_12.M_default
spneumoniae-pangenome	pseudosimplitigsAC	19	12	ones	7551412	10827555	7922543	2905012	384094	2443420	437428	2880848	3143700	spneumoniae-pangenome.S_pseudosimplitigsAC.k_19.d_12.M_ones
spneumoniae-pangenome	pseudosimplitigsAC	19	12	runs	7551412	10827555	7909072	2918483	375181	2443420	436448	2879868	3139700	spneumoniae-pangenome.S_pseudosimplitigsAC.k_19.d_12.M_runs
spneumoniae-pangenome	pseudosimplitigsAC	19	12	zeros	7551412	10827555	7551412	3276143	444686	2443420	490956	2934376	3223828	spneumoniae-pangenome.S_pseudosimplitigsAC.k_19.d_12.M_zeros
spneumoniae-pangenome	pseudosimplitigsAC	19	2	default	7551412	10413184	7551412	2861772	169363	2307596	198436	2506032	2804448	spneumoniae-pangenome.S_pseudosimplitigsAC.k_19.d_2.M_default
spneumoniae-pangenome	pseudosimplitigsAC	19	2	ones	7551412	10413184	7678909	2734275	159549	2307596	229948	2537544	2792024	spneumoniae-pangenome.S_pseudosimplitigsAC.k_19.d_2.M_ones
spneumoniae-pangenome	pseudosimplitigsAC	19	2	runs	7551412	10413184	7677821	2735363	158781	2307596	228140	2535736	2790192	spneumoniae-pangenome.S_pseudosimplitigsAC.k_19.d_2.M_runs
spneumoniae-pangenome	pseudosimplitigsAC	19	2	zeros	7551412	10413184	7551412	2861772	169876	2307596	200676	2508272	2804032	spneumoniae-pangenome.S_pseudosimplitigsAC.k_19.d_2.M_zeros
spneumoniae-pangenome	pseudosimplitigsAC	19	3	default	7551412	10179465	7551412	2628053	170683	2247648	208828	2456476	2738456	spneumoniae-pangenome.S_pseudosimplitigsAC.k_19.d_3.M_default
spneumoniae-pangenome	pseudosimplitigsAC	19	3	ones	7551412	10179465	7698717	2480748	145546	2247648	216776	2464424	2696916	spneumoniae-pangenome.S_pseudosimplitigsAC.k_19.d_3.M_ones
spneumoniae-pangenome	pseudosimplitigsAC	19	3	runs	7551412	10179465	7697847	2481618	144921	2247648	215268	2462916	2696080	spneumoniae-pangenome.S_pseudosimplitigsAC.k_19.d_3.M_runs
spneumoniae-pangenome	pseudosimplitigsAC	19	3	zeros	7551412	10179465	7551412	2628053	170867	2247648	209532	2457180	2738688	spneumoniae-pangenome.S_pseudosimplitigsAC.k_19.d_3.M_zeros
spneumoniae-pangenome	pseudosimplitigsAC	19	4	default	7551412	10087554	7551412	2536142	173219	2225080	217384	2442464	2714628	spneumoniae-pangenome.S_pseudosimplitigsAC.k_19.d_4.M_default
spneumoniae-pangenome	pseudosimplitigsAC	19	4	ones	7551412	10087554	7715869	2371685	141258	2225080	214724	2439804	2660660	spneumoniae-pangenome.S_pseudosimplitigsAC.k_19.d_4.M_ones
spneumoniae-pangenome	pseudosimplitigsAC	19	4	runs	7551412	10087554	7715006	2372548	140638	2225080	213412	2438492	2659916	spneumoniae-pangenome.S_pseudosimplitigsAC.k_19.d_4.M_runs
spneumoniae-pangenome	pseudosimplitigsAC	19	4	zeros	7551412	10087554	7551412	2536142	173315	2225080	217696	2442776	2714852	spneumoniae-pangenome.S_pseudosimplitigsAC.k_19.d_4.M_zeros
spneumoniae-pangenome	pseudosimplitigsAC	19	5	default	7551412	10025887	7551412	2474475	178971	2211960	230528	2442488	2705952	spneumoniae-pangenome.S_pseudosimplitigsAC.k_19.d_5.M_default
spneumoniae-pangenome	pseudosimplitigsAC	19	5	ones	7551412	10025887	7738832	2287055	141188	2211960	219340	2431300	2639872	spneumoniae-pangenome.S_pseudosimplitigsAC.k_19.d_5.M_ones
spneumoniae-pangenome	pseudosimplitigsAC	19	5	runs	7551412	10025887	7737826	2288061	140499	2211960	217964	2429924	2638820	spneumoniae-pangenome.S_pseudosimplitigsAC.k_19.d_5.M_runs
spneumoniae-pangenome	pseudosimplitigsAC	19	5	zeros	7551412	10025887	7551412	2474475	179059	2211960	230840	2442800	2705904	spneumoniae-pangenome.S_pseudosimplitigsAC.k_19.d_5.M_zeros
spneumoniae-pangenome	pseudosimplitigsAC	19	6	default	7551412	9968101	7551412	2416689	193934	2205672	257712	2463384	2712432	spneumoniae-pangenome.S_pseudosimplitigsAC.k_19.d_6.M_default
spneumoniae-pangenome	pseudosimplitigsAC	19	6	ones	7551412	9968101	7784610	2183491	147273	2205672	234388	2440060	2629300	spneumoniae-pangenome.S_pseudosimplitigsAC.k_19.d_6.M_ones
spneumoniae-pangenome	pseudosimplitigsAC	19	6	runs	7551412	9968101	7783330	2184771	146407	2205672	233132	2438804	2627936	spneumoniae-pangenome.S_pseudosimplitigsAC.k_19.d_6.M_runs
spneumoniae-pangenome	pseudosimplitigsAC	19	6	zeros	7551412	9968101	7551412	2416689	193990	2205672	257964	2463636	2711996	spneumoniae-pangenome.S_pseudosimplitigsAC.k_19.d_6.M_zeros
spneumoniae-pangenome	pseudosimplitigsAC	19	7	default	7551412	10074458	7551412	2523046	229652	2250956	306444	2557400	2793480	spneumoniae-pangenome.S_pseudosimplitigsAC.k_19.d_7.M_default
spneumoniae-pangenome	pseudosimplitigsAC	19	7	ones	7551412	10074458	7821844	2252614	178550	2250956	278208	2529164	2707676	spneumoniae-pangenome.S_pseudosimplitigsAC.k_19.d_7.M_ones
spneumoniae-pangenome	pseudosimplitigsAC	19	7	runs	7551412	10074458	7819231	2255227	176901	2250956	276932	2527888	2705816	spneumoniae-pangenome.S_pseudosimplitigsAC.k_19.d_7.M_runs
spneumoniae-pangenome	pseudosimplitigsAC	19	7	zeros	7551412	10074458	7551412	2523046	229699	2250956	306608	2557564	2793424	spneumoniae-pangenome.S_pseudosimplitigsAC.k_19.d_7.M_zeros
spneumoniae-pangenome	pseudosimplitigsAC	19	8	default	7551412	10358763	7551412	2807351	294822	2340740	376000	2716740	2957960	spneumoniae-pangenome.S_pseudosimplitigsAC.k_19.d_8.M_default
spneumoniae-pangenome	pseudosimplitigsAC	19	8	ones	7551412	10358763	7863603	2495160	240795	2340740	346464	2687204	2876172	spneumoniae-pangenome.S_pseudosimplitigsAC.k_19.d_8.M_ones
spneumoniae-pangenome	pseudosimplitigsAC	19	8	runs	7551412	10358763	7858116	2500647	237398	2340740	344804	2685544	2872712	spneumoniae-pangenome.S_pseudosimplitigsAC.k_19.d_8.M_runs
spneumoniae-pangenome	pseudosimplitigsAC	19	8	zeros	7551412	10358763	7551412	2807351	294849	2340740	376120	2716860	2958228	spneumoniae-pangenome.S_pseudosimplitigsAC.k_19.d_8.M_zeros
spneumoniae-pangenome	pseudosimplitigsAC	19	9	default	7551412	10676442	7551412	3125030	368864	2420856	434736	2855592	3118880	spneumoniae-pangenome.S_pseudosimplitigsAC.k_19.d_9.M_default
spneumoniae-pangenome	pseudosimplitigsAC	19	9	ones	7551412	10676442	7902208	2774234	313199	2420856	404840	2825696	3042324	spneumoniae-pangenome.S_pseudosimplitigsAC.k_19.d_9.M_ones
spneumoniae-pangenome	pseudosimplitigsAC	19	9	runs	7551412	10676442	7892586	2783856	307138	2420856	403048	2823904	3038412	spneumoniae-pangenome.S_pseudosimplitigsAC.k_19.d_9.M_runs
spneumoniae-pangenome	pseudosimplitigsAC	19	9	zeros	7551412	10676442	7551412	3125030	368901	2420856	434876	2855732	3120780	spneumoniae-pangenome.S_pseudosimplitigsAC.k_19.d_9.M_zeros
spneumoniae-pangenome	pseudosimplitigs	20	1	default	7731727	10909344	7731727	3177617	167243	2312716	191340	2504056	2880360	spneumoniae-pangenome.S_pseudosimplitigs.k_20.d_1.M_default
spneumoniae-pangenome	pseudosimplitigs	20	1	ones	7731727	10909344	7858428	3050916	167670	2312716	241008	2553724	2884188	spneumoniae-pangenome.S_pseudosimplitigs.k_20.d_1.M_ones
spneumoniae-pangenome	pseudosimplitigs	20	1	runs	7731727	10909344	7857382	3051962	167052	2312716	240008	2552724	2884536	spneumoniae-pangenome.S_pseudosimplitigs.k_20.d_1.M_runs
spneumoniae-pangenome	pseudosimplitigs	20	1	zeros	7731727	10909344	7731727	3177617	168994	2312716	198564	2511280	2883356	spneumoniae-pangenome.S_pseudosimplitigs.k_20.d_1.M_zeros
spneumoniae-pangenome	pseudosimplitigs	20	10	default	7731727	11082895	7731727	3351168	361261	2450448	439088	2889536	3197156	spneumoniae-pangenome.S_pseudosimplitigs.k_20.d_10.M_default
spneumoniae-pangenome	pseudosimplitigs	20	10	ones	7731727	11082895	8108868	2974027	301036	2450448	401908	2852356	3103628	spneumoniae-pangenome.S_pseudosimplitigs.k_20.d_10.M_ones
spneumoniae-pangenome	pseudosimplitigs	20	10	runs	7731727	11082895	8099865	2983030	295452	2450448	400164	2850612	3100500	spneumoniae-pangenome.S_pseudosimplitigs.k_20.d_10.M_runs
spneumoniae-pangenome	pseudosimplitigs	20	10	zeros	7731727	11082895	7731727	3351168	361393	2450448	439504	2889952	3195936	spneumoniae-pangenome.S_pseudosimplitigs.k_20.d_10.M_zeros
spneumoniae-pangenome	pseudosimplitigs	20	11	default	7731727	11302437	7731727	3570710	409140	2501324	467500	2968824	3300288	spneumoniae-pangenome.S_pseudosimplitigs.k_20.d_11.M_default
spneumoniae-pangenome	pseudosimplitigs	20	11	ones	7731727	11302437	8126883	3175554	348850	2501324	429460	2930784	3210740	spneumoniae-pangenome.S_pseudosimplitigs.k_20.d_11.M_ones
spneumoniae-pangenome	pseudosimplitigs	20	11	runs	7731727	11302437	8115010	3187427	341276	2501324	428388	2929712	3205832	spneumoniae-pangenome.S_pseudosimplitigs.k_20.d_11.M_runs
spneumoniae-pangenome	pseudosimplitigs	20	11	zeros	7731727	11302437	7731727	3570710	410363	2501324	473504	2974828	3301992	spneumoniae-pangenome.S_pseudosimplitigs.k_20.d_11.M_zeros
spneumoniae-pangenome	pseudosimplitigs	20	12	default	7731727	11363052	7731727	3631325	428481	2518616	478380	2996996	3334204	spneumoniae-pangenome.S_pseudosimplitigs.k_20.d_12.M_default
spneumoniae-pangenome	pseudosimplitigs	20	12	ones	7731727	11363052	8130885	3232167	368413	2518616	438700	2957316	3249708	spneumoniae-pangenome.S_pseudosimplitigs.k_20.d_12.M_ones
spneumoniae-pangenome	pseudosimplitigs	20	12	runs	7731727	11363052	8117252	3245800	359572	2518616	437860	2956476	3246232	spneumoniae-pangenome.S_pseudosimplitigs.k_20.d_12.M_runs
spneumoniae-pangenome	pseudosimplitigs	20	12	zeros	7731727	11363052	7731727	3631325	433023	2518616	496776	3015392	3345736	spneumoniae-pangenome.S_pseudosimplitigs.k_20.d_12.M_zeros
spneumoniae-pangenome	pseudosimplitigs	20	2	default	7731727	10614931	7731727	2883204	168192	2244060	201684	2445744	2796184	spneumoniae-pangenome.S_pseudosimplitigs.k_20.d_2.M_default
spneumoniae-pangenome	pseudosimplitigs	20	2	ones	7731727	10614931	7860905	2754026	151445	2244060	224396	2468456	2769932	spneumoniae-pangenome.S_pseudosimplitigs.k_20.d_2.M_ones
spneumoniae-pangenome	pseudosimplitigs	20	2	runs	7731727	10614931	7860399	2754532	151096	2244060	223540	2467600	2770400	spneumoniae-pangenome.S_pseudosimplitigs.k_20.d_2.M_runs
spneumoniae-pangenome	pseudosimplitigs	20	2	zeros	7731727	10614931	7731727	2883204	168576	2244060	203276	2447336	2795812	spneumoniae-pangenome.S_pseudosimplitigs.k_20.d_2.M_zeros
spneumoniae-pangenome	pseudosimplitigs	20	3	default	7731727	10487996	7731727	2756269	169000	2213596	208304	2421900	2757472	spneumoniae-pangenome.S_pseudosimplitigs.k_20.d_3.M_default
spneumoniae-pangenome	pseudosimplitigs	20	3	ones	7731727	10487996	7871185	2616811	144351	2213596	217540	2431136	2720144	spneumoniae-pangenome.S_pseudosimplitigs.k_20.d_3.M_ones
spneumoniae-pangenome	pseudosimplitigs	20	3	runs	7731727	10487996	7870724	2617272	144025	2213596	216780	2430376	2719192	spneumoniae-pangenome.S_pseudosimplitigs.k_20.d_3.M_runs
spneumoniae-pangenome	pseudosimplitigs	20	3	zeros	7731727	10487996	7731727	2756269	169163	2213596	208948	2422544	2760328	spneumoniae-pangenome.S_pseudosimplitigs.k_20.d_3.M_zeros
spneumoniae-pangenome	pseudosimplitigs	20	4	default	7731727	10392563	7731727	2660836	170461	2190328	214824	2405152	2732416	spneumoniae-pangenome.S_pseudosimplitigs.k_20.d_4.M_default
spneumoniae-pangenome	pseudosimplitigs	20	4	ones	7731727	10392563	7887483	2505080	139254	2190328	213712	2404040	2680300	spneumoniae-pangenome.S_pseudosimplitigs.k_20.d_4.M_ones
spneumoniae-pangenome	pseudosimplitigs	20	4	runs	7731727	10392563	7887053	2505510	138942	2190328	213044	2403372	2680032	spneumoniae-pangenome.S_pseudosimplitigs.k_20.d_4.M_runs
spneumoniae-pangenome	pseudosimplitigs	20	4	zeros	7731727	10392563	7731727	2660836	170551	2190328	215200	2405528	2733448	spneumoniae-pangenome.S_pseudosimplitigs.k_20.d_4.M_zeros
spneumoniae-pangenome	pseudosimplitigs	20	5	default	7731727	10255627	7731727	2523900	172578	2152920	224176	2377096	2689956	spneumoniae-pangenome.S_pseudosimplitigs.k_20.d_5.M_default
spneumoniae-pangenome	pseudosimplitigs	20	5	ones	7731727	10255627	7923542	2332085	131455	2152920	207640	2360560	2616608	spneumoniae-pangenome.S_pseudosimplitigs.k_20.d_5.M_ones
spneumoniae-pangenome	pseudosimplitigs	20	5	runs	7731727	10255627	7923100	2332527	131146	2152920	206984	2359904	2615728	spneumoniae-pangenome.S_pseudosimplitigs.k_20.d_5.M_runs
spneumoniae-pangenome	pseudosimplitigs	20	5	zeros	7731727	10255627	7731727	2523900	172645	2152920	224404	2377324	2690892	spneumoniae-pangenome.S_pseudosimplitigs.k_20.d_5.M_zeros
spneumoniae-pangenome	pseudosimplitigs	20	6	default	7731727	10208638	7731727	2476911	178065	2145404	236692	2382096	2683964	spneumoniae-pangenome.S_pseudosimplitigs.k_20.d_6.M_default
spneumoniae-pangenome	pseudosimplitigs	20	6	ones	7731727	10208638	7948544	2260094	131872	2145404	212552	2357956	2599892	spneumoniae-pangenome.S_pseudosimplitigs.k_20.d_6.M_ones
spneumoniae-pangenome	pseudosimplitigs	20	6	runs	7731727	10208638	7947958	2260680	131492	2145404	211944	2357348	2599072	spneumoniae-pangenome.S_pseudosimplitigs.k_20.d_6.M_runs
spneumoniae-pangenome	pseudosimplitigs	20	6	zeros	7731727	10208638	7731727	2476911	178088	2145404	236788	2382192	2684464	spneumoniae-pangenome.S_pseudosimplitigs.k_20.d_6.M_zeros
spneumoniae-pangenome	pseudosimplitigs	20	7	default	7731727	10224240	7731727	2492513	192775	2169052	262096	2431148	2718848	spneumoniae-pangenome.S_pseudosimplitigs.k_20.d_7.M_default
spneumoniae-pangenome	pseudosimplitigs	20	7	ones	7731727	10224240	7979643	2244597	142182	2169052	231720	2400772	2625964	spneumoniae-pangenome.S_pseudosimplitigs.k_20.d_7.M_ones
spneumoniae-pangenome	pseudosimplitigs	20	7	runs	7731727	10224240	7978601	2245639	141501	2169052	230860	2399912	2625816	spneumoniae-pangenome.S_pseudosimplitigs.k_20.d_7.M_runs
spneumoniae-pangenome	pseudosimplitigs	20	7	zeros	7731727	10224240	7731727	2492513	192795	2169052	262140	2431192	2718932	spneumoniae-pangenome.S_pseudosimplitigs.k_20.d_7.M_zeros
spneumoniae-pangenome	pseudosimplitigs	20	8	default	7731727	10340698	7731727	2608971	226516	2225936	309268	2535204	2812736	spneumoniae-pangenome.S_pseudosimplitigs.k_20.d_8.M_default
spneumoniae-pangenome	pseudosimplitigs	20	8	ones	7731727	10340698	8031140	2309558	170196	2225936	272024	2497960	2710148	spneumoniae-pangenome.S_pseudosimplitigs.k_20.d_8.M_ones
spneumoniae-pangenome	pseudosimplitigs	20	8	runs	7731727	10340698	8028901	2311797	168824	2225936	271020	2496956	2708060	spneumoniae-pangenome.S_pseudosimplitigs.k_20.d_8.M_runs
spneumoniae-pangenome	pseudosimplitigs	20	8	zeros	7731727	10340698	7731727	2608971	226546	2225936	309428	2535364	2811308	spneumoniae-pangenome.S_pseudosimplitigs.k_20.d_8.M_zeros
spneumoniae-pangenome	pseudosimplitigs	20	9	default	7731727	10679001	7731727	2947274	288867	2341760	377480	2719240	3003392	spneumoniae-pangenome.S_pseudosimplitigs.k_20.d_9.M_default
spneumoniae-pangenome	pseudosimplitigs	20	9	ones	7731727	10679001	8073742	2605259	229584	2341760	339432	2681192	2901432	spneumoniae-pangenome.S_pseudosimplitigs.k_20.d_9.M_ones
spneumoniae-pangenome	pseudosimplitigs	20	9	runs	7731727	10679001	8068865	2610136	226632	2341760	337932	2679692	2899372	spneumoniae-pangenome.S_pseudosimplitigs.k_20.d_9.M_runs
spneumoniae-pangenome	pseudosimplitigs	20	9	zeros	7731727	10679001	7731727	2947274	288893	2341760	377612	2719372	3003556	spneumoniae-pangenome.S_pseudosimplitigs.k_20.d_9.M_zeros
spneumoniae-pangenome	pseudosimplitigsAC	20	1	default	7731727	10909344	7731727	3177617	167243	2373816	192108	2565924	2903080	spneumoniae-pangenome.S_pseudosimplitigsAC.k_20.d_1.M_default
spneumoniae-pangenome	pseudosimplitigsAC	20	1	ones	7731727	10909344	7859189	3050155	167650	2373816	241028	2614844	2914968	spneumoniae-pangenome.S_pseudosimplitigsAC.k_20.d_1.M_ones
spneumoniae-pangenome	pseudosimplitigsAC	20	1	runs	7731727	10909344	7858044	3051300	166997	2373816	240084	2613900	2915088	spneumoniae-pangenome.S_pseudosimplitigsAC.k_20.d_1.M_runs
spneumoniae-pangenome	pseudosimplitigsAC	20	1	zeros	7731727	10909344	7731727	3177617	168935	2373816	199288	2573104	2907592	spneumoniae-pangenome.S_pseudosimplitigsAC.k_20.d_1.M_zeros
spneumoniae-pangenome	pseudosimplitigsAC	20	10	default	7731727	11082094	7731727	3350367	361356	2454304	439560	2893864	3203092	spneumoniae-pangenome.S_pseudosimplitigsAC.k_20.d_10.M_default
spneumoniae-pangenome	pseudosimplitigsAC	20	10	ones	7731727	11082094	8108542	2973552	301026	2454304	401932	2856236	3110876	spneumoniae-pangenome.S_pseudosimplitigsAC.k_20.d_10.M_ones
spneumoniae-pangenome	pseudosimplitigsAC	20	10	runs	7731727	11082094	8099918	2982176	295641	2454304	400340	2854644	3106020	spneumoniae-pangenome.S_pseudosimplitigsAC.k_20.d_10.M_runs
spneumoniae-pangenome	pseudosimplitigsAC	20	10	zeros	7731727	11082094	7731727	3350367	361426	2454304	439720	2894024	3202876	spneumoniae-pangenome.S_pseudosimplitigsAC.k_20.d_10.M_zeros
spneumoniae-pangenome	pseudosimplitigsAC	20	11	default	7731727	11292565	7731727	3560838	408875	2497500	466632	2964132	3298824	spneumoniae-pangenome.S_pseudosimplitigsAC.k_20.d_11.M_default
spneumoniae-pangenome	pseudosimplitigsAC	20	11	ones	7731727	11292565	8124392	3168173	348488	2497500	427872	2925372	3209348	spneumoniae-pangenome.S_pseudosimplitigsAC.k_20.d_11.M_ones
spneumoniae-pangenome	pseudosimplitigsAC	20	11	runs	7731727	11292565	8112670	3179895	341026	2497500	426840	2924340	3204672	spneumoniae-pangenome.S_pseudosimplitigsAC.k_20.d_11.M_runs
spneumoniae-pangenome	pseudosimplitigsAC	20	11	zeros	7731727	11292565	7731727	3560838	410014	2497500	472532	2970032	3299236	spneumoniae-pangenome.S_pseudosimplitigsAC.k_20.d_11.M_zeros
spneumoniae-pangenome	pseudosimplitigsAC	20	12	default	7731727	11320744	7731727	3589017	426237	2507168	475896	2983064	3319780	spneumoniae-pangenome.S_pseudosimplitigsAC.k_20.d_12.M_default
spneumoniae-pangenome	pseudosimplitigsAC	20	12	ones	7731727	11320744	8129068	3191676	365890	2507168	434672	2941840	3235148	spneumoniae-pangenome.S_pseudosimplitigsAC.k_20.d_12.M_ones
spneumoniae-pangenome	pseudosimplitigsAC	20	12	runs	7731727	11320744	8116645	3204099	357816	2507168	434008	2941176	3231132	spneumoniae-pangenome.S_pseudosimplitigsAC.k_20.d_12.M_runs
spneumoniae-pangenome	pseudosimplitigsAC	20	12	zeros	7731727	11320744	7731727	3589017	427414	2507168	482084	2989252	3322008	spneumoniae-pangenome.S_pseudosimplitigsAC.k_20.d_12.M_zeros
spneumoniae-pangenome	pseudosimplitigsAC	20	2	default	7731727	10614819	7731727	2883092	168188	2306000	202896	2508896	2822252	spneumoniae-pangenome.S_pseudosimplitigsAC.k_20.d_2.M_default
spneumoniae-pangenome	pseudosimplitigsAC	20	2	ones	7731727	10614819	7861727	2753092	151438	2306000	224528	2530528	2805940	spneumoniae-pangenome.S_pseudosimplitigsAC.k_20.d_2.M_ones
spneumoniae-pangenome	pseudosimplitigsAC	20	2	runs	7731727	10614819	7861172	2753647	151068	2306000	223648	2529648	2805908	spneumoniae-pangenome.S_pseudosimplitigsAC.k_20.d_2.M_runs
spneumoniae-pangenome	pseudosimplitigsAC	20	2	zeros	7731727	10614819	7731727	2883092	168516	2306000	204332	2510332	2823508	spneumoniae-pangenome.S_pseudosimplitigsAC.k_20.d_2.M_zeros
spneumoniae-pangenome	pseudosimplitigsAC	20	3	default	7731727	10488358	7731727	2756631	169010	2274916	209212	2484128	2787868	spneumoniae-pangenome.S_pseudosimplitigsAC.k_20.d_3.M_default
spneumoniae-pangenome	pseudosimplitigsAC	20	3	ones	7731727	10488358	7871988	2616370	144339	2274916	218016	2492932	2755220	spneumoniae-pangenome.S_pseudosimplitigsAC.k_20.d_3.M_ones
spneumoniae-pangenome	pseudosimplitigsAC	20	3	runs	7731727	10488358	7871508	2616850	144018	2274916	217164	2492080	2755680	spneumoniae-pangenome.S_pseudosimplitigsAC.k_20.d_3.M_runs
spneumoniae-pangenome	pseudosimplitigsAC	20	3	zeros	7731727	10488358	7731727	2756631	169136	2274916	209716	2484632	2787824	spneumoniae-pangenome.S_pseudosimplitigsAC.k_20.d_3.M_zeros
spneumoniae-pangenome	pseudosimplitigsAC	20	4	default	7731727	10392735	7731727	2661008	170378	2251336	215576	2466912	2762536	spneumoniae-pangenome.S_pseudosimplitigsAC.k_20.d_4.M_default
spneumoniae-pangenome	pseudosimplitigsAC	20	4	ones	7731727	10392735	7887462	2505273	139193	2251336	213708	2465044	2715908	spneumoniae-pangenome.S_pseudosimplitigsAC.k_20.d_4.M_ones
spneumoniae-pangenome	pseudosimplitigsAC	20	4	runs	7731727	10392735	7886976	2505759	138863	2251336	212948	2464284	2715180	spneumoniae-pangenome.S_pseudosimplitigsAC.k_20.d_4.M_runs
spneumoniae-pangenome	pseudosimplitigsAC	20	4	zeros	7731727	10392735	7731727	2661008	170461	2251336	215948	2467284	2760384	spneumoniae-pangenome.S_pseudosimplitigsAC.k_20.d_4.M_zeros
spneumoniae-pangenome	pseudosimplitigsAC	20	5	default	7731727	10255307	7731727	2523580	172576	2213296	224784	2438080	2722784	spneumoniae-pangenome.S_pseudosimplitigsAC.k_20.d_5.M_default
spneumoniae-pangenome	pseudosimplitigsAC	20	5	ones	7731727	10255307	7923198	2332109	131452	2213296	207812	2421108	2651968	spneumoniae-pangenome.S_pseudosimplitigsAC.k_20.d_5.M_ones
spneumoniae-pangenome	pseudosimplitigsAC	20	5	runs	7731727	10255307	7922728	2332579	131132	2213296	207124	2420420	2652964	spneumoniae-pangenome.S_pseudosimplitigsAC.k_20.d_5.M_runs
spneumoniae-pangenome	pseudosimplitigsAC	20	5	zeros	7731727	10255307	7731727	2523580	172642	2213296	225000	2438296	2722972	spneumoniae-pangenome.S_pseudosimplitigsAC.k_20.d_5.M_zeros
spneumoniae-pangenome	pseudosimplitigsAC	20	6	default	7731727	10207852	7731727	2476125	177906	2204372	237292	2441664	2717400	spneumoniae-pangenome.S_pseudosimplitigsAC.k_20.d_6.M_default
spneumoniae-pangenome	pseudosimplitigsAC	20	6	ones	7731727	10207852	7948547	2259305	131687	2204372	212236	2416608	2637104	spneumoniae-pangenome.S_pseudosimplitigsAC.k_20.d_6.M_ones
spneumoniae-pangenome	pseudosimplitigsAC	20	6	runs	7731727	10207852	7948017	2259835	131321	2204372	211616	2415988	2638460	spneumoniae-pangenome.S_pseudosimplitigsAC.k_20.d_6.M_runs
spneumoniae-pangenome	pseudosimplitigsAC	20	6	zeros	7731727	10207852	7731727	2476125	177954	2204372	237492	2441864	2716564	spneumoniae-pangenome.S_pseudosimplitigsAC.k_20.d_6.M_zeros
spneumoniae-pangenome	pseudosimplitigsAC	20	7	default	7731727	10221383	7731727	2489656	192249	2218068	262340	2480408	2747560	spneumoniae-pangenome.S_pseudosimplitigsAC.k_20.d_7.M_default
spneumoniae-pangenome	pseudosimplitigsAC	20	7	ones	7731727	10221383	7979291	2242092	141641	2218068	231340	2449408	2657528	spneumoniae-pangenome.S_pseudosimplitigsAC.k_20.d_7.M_ones
spneumoniae-pangenome	pseudosimplitigsAC	20	7	runs	7731727	10221383	7978351	2243032	141036	2218068	230724	2448792	2655908	spneumoniae-pangenome.S_pseudosimplitigsAC.k_20.d_7.M_runs
spneumoniae-pangenome	pseudosimplitigsAC	20	7	zeros	7731727	10221383	7731727	2489656	192280	2218068	262512	2480580	2748132	spneumoniae-pangenome.S_pseudosimplitigsAC.k_20.d_7.M_zeros
spneumoniae-pangenome	pseudosimplitigsAC	20	8	default	7731727	10338759	7731727	2607032	226515	2261432	310248	2571680	2835564	spneumoniae-pangenome.S_pseudosimplitigsAC.k_20.d_8.M_default
spneumoniae-pangenome	pseudosimplitigsAC	20	8	ones	7731727	10338759	8031045	2307714	170051	2261432	272244	2533676	2733784	spneumoniae-pangenome.S_pseudosimplitigsAC.k_20.d_8.M_ones
spneumoniae-pangenome	pseudosimplitigsAC	20	8	runs	7731727	10338759	8028985	2309774	168738	2261432	271332	2532764	2732564	spneumoniae-pangenome.S_pseudosimplitigsAC.k_20.d_8.M_runs
spneumoniae-pangenome	pseudosimplitigsAC	20	8	zeros	7731727	10338759	7731727	2607032	226548	2261432	310416	2571848	2836516	spneumoniae-pangenome.S_pseudosimplitigsAC.k_20.d_8.M_zeros
spneumoniae-pangenome	pseudosimplitigsAC	20	9	default	7731727	10682193	7731727	2950466	289304	2359860	378732	2738592	3017288	spneumoniae-pangenome.S_pseudosimplitigsAC.k_20.d_9.M_default
spneumoniae-pangenome	pseudosimplitigsAC	20	9	ones	7731727	10682193	8073003	2609190	230192	2359860	340328	2700188	2920040	spneumoniae-pangenome.S_pseudosimplitigsAC.k_20.d_9.M_ones
spneumoniae-pangenome	pseudosimplitigsAC	20	9	runs	7731727	10682193	8067982	2614211	227147	2359860	338908	2698768	2916364	spneumoniae-pangenome.S_pseudosimplitigsAC.k_20.d_9.M_runs
spneumoniae-pangenome	pseudosimplitigsAC	20	9	zeros	7731727	10682193	7731727	2950466	289329	2359860	378816	2738676	3017624	spneumoniae-pangenome.S_pseudosimplitigsAC.k_20.d_9.M_zeros
spneumoniae-pangenome	pseudosimplitigs	21	1	default	7910060	11084300	7910060	3174240	158712	2300184	188772	2488956	2871272	spneumoniae-pangenome.S_pseudosimplitigs.k_21.d_1.M_default
spneumoniae-pangenome	pseudosimplitigs	21	1	ones	7910060	11084300	8029875	3054425	158966	2300184	236064	2536248	2883320	spneumoniae-pangenome.S_pseudosimplitigs.k_21.d_1.M_ones
spneumoniae-pangenome	pseudosimplitigs	21	1	runs	7910060	11084300	8029295	3055005	158612	2300184	235448	2535632	2882448	spneumoniae-pangenome.S_pseudosimplitigs.k_21.d_1.M_runs
spneumoniae-pangenome	pseudosimplitigs	21	1	zeros	7910060	11084300	7910060	3174240	159835	2300184	193620	2493804	2873412	spneumoniae-pangenome.S_pseudosimplitigs.k_21.d_1.M_zeros
spneumoniae-pangenome	pseudosimplitigs	21	10	default	7910060	10995357	7910060	3085297	277483	2361528	374936	2736464	3050924	spneumoniae-pangenome.S_pseudosimplitigs.k_21.d_10.M_default
spneumoniae-pangenome	pseudosimplitigs	21	10	ones	7910060	10995357	8277289	2718068	220700	2361528	334824	2696352	2948052	spneumoniae-pangenome.S_pseudosimplitigs.k_21.d_10.M_ones
spneumoniae-pangenome	pseudosimplitigs	21	10	runs	7910060	10995357	8272703	2722654	217957	2361528	333576	2695104	2944060	spneumoniae-pangenome.S_pseudosimplitigs.k_21.d_10.M_runs
spneumoniae-pangenome	pseudosimplitigs	21	10	zeros	7910060	10995357	7910060	3085297	277498	2361528	374940	2736468	3051696	spneumoniae-pangenome.S_pseudosimplitigs.k_21.d_10.M_zeros
spneumoniae-pangenome	pseudosimplitigs	21	11	default	7910060	11467937	7910060	3557877	348654	2480848	438600	2919448	3268972	spneumoniae-pangenome.S_pseudosimplitigs.k_21.d_11.M_default
spneumoniae-pangenome	pseudosimplitigs	21	11	ones	7910060	11467937	8313732	3154205	290522	2480848	399776	2880624	3169592	spneumoniae-pangenome.S_pseudosimplitigs.k_21.d_11.M_ones
spneumoniae-pangenome	pseudosimplitigs	21	11	runs	7910060	11467937	8305286	3162651	285344	2480848	398244	2879092	3165740	spneumoniae-pangenome.S_pseudosimplitigs.k_21.d_11.M_runs
spneumoniae-pangenome	pseudosimplitigs	21	11	zeros	7910060	11467937	7910060	3557877	348683	2480848	438612	2919460	3268892	spneumoniae-pangenome.S_pseudosimplitigs.k_21.d_11.M_zeros
spneumoniae-pangenome	pseudosimplitigs	21	12	default	7910060	11749889	7910060	3839829	396471	2545888	471072	3016960	3388812	spneumoniae-pangenome.S_pseudosimplitigs.k_21.d_12.M_default
spneumoniae-pangenome	pseudosimplitigs	21	12	ones	7910060	11749889	8330205	3419684	338386	2545888	431152	2977040	3295040	spneumoniae-pangenome.S_pseudosimplitigs.k_21.d_12.M_ones
spneumoniae-pangenome	pseudosimplitigs	21	12	runs	7910060	11749889	8318901	3430988	331163	2545888	430280	2976168	3290516	spneumoniae-pangenome.S_pseudosimplitigs.k_21.d_12.M_runs
spneumoniae-pangenome	pseudosimplitigs	21	12	zeros	7910060	11749889	7910060	3839829	396601	2545888	471800	3017688	3388396	spneumoniae-pangenome.S_pseudosimplitigs.k_21.d_12.M_zeros
spneumoniae-pangenome	pseudosimplitigs	21	2	default	7910060	10921210	7910060	3011150	159611	2265784	196132	2461916	2826172	spneumoniae-pangenome.S_pseudosimplitigs.k_21.d_2.M_default
spneumoniae-pangenome	pseudosimplitigs	21	2	ones	7910060	10921210	8031083	2890127	150525	2265784	227216	2493000	2821792	spneumoniae-pangenome.S_pseudosimplitigs.k_21.d_2.M_ones
spneumoniae-pangenome	pseudosimplitigs	21	2	runs	7910060	10921210	8030713	2890497	150292	2265784	226696	2492480	2822296	spneumoniae-pangenome.S_pseudosimplitigs.k_21.d_2.M_runs
spneumoniae-pangenome	pseudosimplitigs	21	2	zeros	7910060	10921210	7910060	3011150	159972	2265784	197700	2463484	2826768	spneumoniae-pangenome.S_pseudosimplitigs.k_21.d_2.M_zeros
spneumoniae-pangenome	pseudosimplitigs	21	3	default	7910060	10792996	7910060	2882936	160325	2235148	202268	2437416	2790196	spneumoniae-pangenome.S_pseudosimplitigs.k_21.d_3.M_default
spneumoniae-pangenome	pseudosimplitigs	21	3	ones	7910060	10792996	8040746	2752250	143613	2235148	220500	2455648	2772788	spneumoniae-pangenome.S_pseudosimplitigs.k_21.d_3.M_ones
spneumoniae-pangenome	pseudosimplitigs	21	3	runs	7910060	10792996	8040423	2752573	143399	2235148	220008	2455156	2772376	spneumoniae-pangenome.S_pseudosimplitigs.k_21.d_3.M_runs
spneumoniae-pangenome	pseudosimplitigs	21	3	zeros	7910060	10792996	7910060	2882936	160480	2235148	202908	2438056	2790844	spneumoniae-pangenome.S_pseudosimplitigs.k_21.d_3.M_zeros
spneumoniae-pangenome	pseudosimplitigs	21	4	default	7910060	10619018	7910060	2708958	161614	2190864	210052	2400916	2739792	spneumoniae-pangenome.S_pseudosimplitigs.k_21.d_4.M_default
spneumoniae-pangenome	pseudosimplitigs	21	4	ones	7910060	10619018	8067493	2551525	133812	2190864	210524	2401388	2694844	spneumoniae-pangenome.S_pseudosimplitigs.k_21.d_4.M_ones
spneumoniae-pangenome	pseudosimplitigs	21	4	runs	7910060	10619018	8067208	2551810	133632	2190864	210112	2400976	2695352	spneumoniae-pangenome.S_pseudosimplitigs.k_21.d_4.M_runs
spneumoniae-pangenome	pseudosimplitigs	21	4	zeros	7910060	10619018	7910060	2708958	161682	2190864	210352	2401216	2742220	spneumoniae-pangenome.S_pseudosimplitigs.k_21.d_4.M_zeros
spneumoniae-pangenome	pseudosimplitigs	21	5	default	7910060	10536411	7910060	2626351	162771	2170272	215656	2385928	2715516	spneumoniae-pangenome.S_pseudosimplitigs.k_21.d_5.M_default
spneumoniae-pangenome	pseudosimplitigs	21	5	ones	7910060	10536411	8087457	2448954	129258	2170272	206924	2377196	2659208	spneumoniae-pangenome.S_pseudosimplitigs.k_21.d_5.M_ones
spneumoniae-pangenome	pseudosimplitigs	21	5	runs	7910060	10536411	8087156	2449255	129066	2170272	206544	2376816	2659168	spneumoniae-pangenome.S_pseudosimplitigs.k_21.d_5.M_runs
spneumoniae-pangenome	pseudosimplitigs	21	5	zeros	7910060	10536411	7910060	2626351	162821	2170272	215828	2386100	2716232	spneumoniae-pangenome.S_pseudosimplitigs.k_21.d_5.M_zeros
spneumoniae-pangenome	pseudosimplitigs	21	6	default	7910060	10474491	7910060	2564431	164838	2155220	222656	2377876	2700312	spneumoniae-pangenome.S_pseudosimplitigs.k_21.d_6.M_default
spneumoniae-pangenome	pseudosimplitigs	21	6	ones	7910060	10474491	8110884	2363607	126453	2155220	205796	2361016	2631784	spneumoniae-pangenome.S_pseudosimplitigs.k_21.d_6.M_ones
spneumoniae-pangenome	pseudosimplitigs	21	6	runs	7910060	10474491	8110538	2363953	126236	2155220	205416	2360636	2630984	spneumoniae-pangenome.S_pseudosimplitigs.k_21.d_6.M_runs
spneumoniae-pangenome	pseudosimplitigs	21	6	zeros	7910060	10474491	7910060	2564431	164875	2155220	222816	2378036	2700236	spneumoniae-pangenome.S_pseudosimplitigs.k_21.d_6.M_zeros
spneumoniae-pangenome	pseudosimplitigs	21	7	default	7910060	10408419	7910060	2498359	170586	2141016	236392	2377408	2688652	spneumoniae-pangenome.S_pseudosimplitigs.k_21.d_7.M_default
spneumoniae-pangenome	pseudosimplitigs	21	7	ones	7910060	10408419	8154532	2253887	125012	2141016	208628	2349644	2603084	spneumoniae-pangenome.S_pseudosimplitigs.k_21.d_7.M_ones
spneumoniae-pangenome	pseudosimplitigs	21	7	runs	7910060	10408419	8154055	2254364	124712	2141016	208172	2349188	2602668	spneumoniae-pangenome.S_pseudosimplitigs.k_21.d_7.M_runs
spneumoniae-pangenome	pseudosimplitigs	21	7	zeros	7910060	10408419	7910060	2498359	170612	2141016	236504	2377520	2688832	spneumoniae-pangenome.S_pseudosimplitigs.k_21.d_7.M_zeros
spneumoniae-pangenome	pseudosimplitigs	21	8	default	7910060	10440385	7910060	2530325	184191	2168348	260588	2428936	2727564	spneumoniae-pangenome.S_pseudosimplitigs.k_21.d_8.M_default
spneumoniae-pangenome	pseudosimplitigs	21	8	ones	7910060	10440385	8185749	2254636	134770	2168348	226836	2395184	2631148	spneumoniae-pangenome.S_pseudosimplitigs.k_21.d_8.M_ones
spneumoniae-pangenome	pseudosimplitigs	21	8	runs	7910060	10440385	8184949	2255436	134270	2168348	226368	2394716	2632180	spneumoniae-pangenome.S_pseudosimplitigs.k_21.d_8.M_runs
spneumoniae-pangenome	pseudosimplitigs	21	8	zeros	7910060	10440385	7910060	2530325	184212	2168348	260704	2429052	2726816	spneumoniae-pangenome.S_pseudosimplitigs.k_21.d_8.M_zeros
spneumoniae-pangenome	pseudosimplitigs	21	9	default	7910060	10612738	7910060	2702678	217005	2239860	307328	2547188	2842616	spneumoniae-pangenome.S_pseudosimplitigs.k_21.d_9.M_default
spneumoniae-pangenome	pseudosimplitigs	21	9	ones	7910060	10612738	8224559	2388179	163987	2239860	269024	2508884	2742000	spneumoniae-pangenome.S_pseudosimplitigs.k_21.d_9.M_ones
spneumoniae-pangenome	pseudosimplitigs	21	9	runs	7910060	10612738	8222479	2390259	162762	2239860	268136	2507996	2741032	spneumoniae-pangenome.S_pseudosimplitigs.k_21.d_9.M_runs
spneumoniae-pangenome	pseudosimplitigs	21	9	zeros	7910060	10612738	7910060	2702678	217023	2239860	307380	2547240	2841764	spneumoniae-pangenome.S_pseudosimplitigs.k_21.d_9.M_zeros
spneumoniae-pangenome	pseudosimplitigsAC	21	1	default	7910060	11084480	7910060	3174420	158721	2365788	189840	2555628	2901504	spneumoniae-pangenome.S_pseudosimplitigsAC.k_21.d_1.M_default
spneumoniae-pangenome	pseudosimplitigsAC	21	1	ones	7910060	11084480	8028874	3055606	158958	2365788	235956	2601744	2911788	spneumoniae-pangenome.S_pseudosimplitigsAC.k_21.d_1.M_ones
spneumoniae-pangenome	pseudosimplitigsAC	21	1	runs	7910060	11084480	8028323	3056157	158628	2365788	235500	2601288	2911648	spneumoniae-pangenome.S_pseudosimplitigsAC.k_21.d_1.M_runs
spneumoniae-pangenome	pseudosimplitigsAC	21	1	zeros	7910060	11084480	7910060	3174420	159796	2365788	194608	2560396	2902864	spneumoniae-pangenome.S_pseudosimplitigsAC.k_21.d_1.M_zeros
spneumoniae-pangenome	pseudosimplitigsAC	21	10	default	7910060	10996305	7910060	3086245	277464	2375012	374488	2749500	3059572	spneumoniae-pangenome.S_pseudosimplitigsAC.k_21.d_10.M_default
spneumoniae-pangenome	pseudosimplitigsAC	21	10	ones	7910060	10996305	8278600	2717705	220568	2375012	334768	2709780	2958088	spneumoniae-pangenome.S_pseudosimplitigsAC.k_21.d_10.M_ones
spneumoniae-pangenome	pseudosimplitigsAC	21	10	runs	7910060	10996305	8273962	2722343	217857	2375012	333424	2708436	2955548	spneumoniae-pangenome.S_pseudosimplitigsAC.k_21.d_10.M_runs
spneumoniae-pangenome	pseudosimplitigsAC	21	10	zeros	7910060	10996305	7910060	3086245	277493	2375012	374696	2749708	3060136	spneumoniae-pangenome.S_pseudosimplitigsAC.k_21.d_10.M_zeros
spneumoniae-pangenome	pseudosimplitigsAC	21	11	default	7910060	11471364	7910060	3561304	348628	2485020	438456	2923476	3272808	spneumoniae-pangenome.S_pseudosimplitigsAC.k_21.d_11.M_default
spneumoniae-pangenome	pseudosimplitigsAC	21	11	ones	7910060	11471364	8313441	3157923	290647	2485020	399660	2884680	3176608	spneumoniae-pangenome.S_pseudosimplitigsAC.k_21.d_11.M_ones
spneumoniae-pangenome	pseudosimplitigsAC	21	11	runs	7910060	11471364	8305084	3166280	285535	2485020	398140	2883160	3173168	spneumoniae-pangenome.S_pseudosimplitigsAC.k_21.d_11.M_runs
spneumoniae-pangenome	pseudosimplitigsAC	21	11	zeros	7910060	11471364	7910060	3561304	348657	2485020	438680	2923700	3273160	spneumoniae-pangenome.S_pseudosimplitigsAC.k_21.d_11.M_zeros
spneumoniae-pangenome	pseudosimplitigsAC	21	12	default	7910060	11724302	7910060	3814242	394762	2534464	468856	3003320	3374276	spneumoniae-pangenome.S_pseudosimplitigsAC.k_21.d_12.M_default
spneumoniae-pangenome	pseudosimplitigsAC	21	12	ones	7910060	11724302	8329796	3394506	336696	2534464	429264	2963728	3282148	spneumoniae-pangenome.S_pseudosimplitigsAC.k_21.d_12.M_ones
spneumoniae-pangenome	pseudosimplitigsAC	21	12	runs	7910060	11724302	8318478	3405824	329633	2534464	428360	2962824	3276588	spneumoniae-pangenome.S_pseudosimplitigsAC.k_21.d_12.M_runs
spneumoniae-pangenome	pseudosimplitigsAC	21	12	zeros	7910060	11724302	7910060	3814242	394984	2534464	469492	3003956	3375064	spneumoniae-pangenome.S_pseudosimplitigsAC.k_21.d_12.M_zeros
spneumoniae-pangenome	pseudosimplitigsAC	21	2	default	7910060	10921641	7910060	3011581	159643	2328776	197424	2526200	2856712	spneumoniae-pangenome.S_pseudosimplitigsAC.k_21.d_2.M_default
spneumoniae-pangenome	pseudosimplitigsAC	21	2	ones	7910060	10921641	8030471	2891170	150544	2328776	227392	2556168	2853800	spneumoniae-pangenome.S_pseudosimplitigsAC.k_21.d_2.M_ones
spneumoniae-pangenome	pseudosimplitigsAC	21	2	runs	7910060	10921641	8030124	2891517	150320	2328776	226924	2555700	2852640	spneumoniae-pangenome.S_pseudosimplitigsAC.k_21.d_2.M_runs
spneumoniae-pangenome	pseudosimplitigsAC	21	2	zeros	7910060	10921641	7910060	3011581	159949	2328776	198860	2527636	2857200	spneumoniae-pangenome.S_pseudosimplitigsAC.k_21.d_2.M_zeros
spneumoniae-pangenome	pseudosimplitigsAC	21	3	default	7910060	10793483	7910060	2883423	160340	2298792	203848	2502640	2822232	spneumoniae-pangenome.S_pseudosimplitigsAC.k_21.d_3.M_default
spneumoniae-pangenome	pseudosimplitigsAC	21	3	ones	7910060	10793483	8040248	2753235	143640	2298792	220776	2519568	2804608	spneumoniae-pangenome.S_pseudosimplitigsAC.k_21.d_3.M_ones
spneumoniae-pangenome	pseudosimplitigsAC	21	3	runs	7910060	10793483	8039944	2753539	143437	2298792	220372	2519164	2804220	spneumoniae-pangenome.S_pseudosimplitigsAC.k_21.d_3.M_runs
spneumoniae-pangenome	pseudosimplitigsAC	21	3	zeros	7910060	10793483	7910060	2883423	160460	2298792	204412	2503204	2821628	spneumoniae-pangenome.S_pseudosimplitigsAC.k_21.d_3.M_zeros
spneumoniae-pangenome	pseudosimplitigsAC	21	4	default	7910060	10619439	7910060	2709379	161627	2253856	211352	2465208	2772912	spneumoniae-pangenome.S_pseudosimplitigsAC.k_21.d_4.M_default
spneumoniae-pangenome	pseudosimplitigsAC	21	4	ones	7910060	10619439	8066733	2552706	133836	2253856	210860	2464716	2730400	spneumoniae-pangenome.S_pseudosimplitigsAC.k_21.d_4.M_ones
spneumoniae-pangenome	pseudosimplitigsAC	21	4	runs	7910060	10619439	8066462	2552977	133650	2253856	210428	2464284	2730440	spneumoniae-pangenome.S_pseudosimplitigsAC.k_21.d_4.M_runs
spneumoniae-pangenome	pseudosimplitigsAC	21	4	zeros	7910060	10619439	7910060	2709379	161677	2253856	211564	2465420	2772788	spneumoniae-pangenome.S_pseudosimplitigsAC.k_21.d_4.M_zeros
spneumoniae-pangenome	pseudosimplitigsAC	21	5	default	7910060	10536774	7910060	2626714	162642	2232032	217236	2449268	2748732	spneumoniae-pangenome.S_pseudosimplitigsAC.k_21.d_5.M_default
spneumoniae-pangenome	pseudosimplitigsAC	21	5	ones	7910060	10536774	8086674	2450100	129233	2232032	207116	2439148	2696116	spneumoniae-pangenome.S_pseudosimplitigsAC.k_21.d_5.M_ones
spneumoniae-pangenome	pseudosimplitigsAC	21	5	runs	7910060	10536774	8086401	2450373	129046	2232032	206744	2438776	2696096	spneumoniae-pangenome.S_pseudosimplitigsAC.k_21.d_5.M_runs
spneumoniae-pangenome	pseudosimplitigsAC	21	5	zeros	7910060	10536774	7910060	2626714	162683	2232032	217448	2449480	2748860	spneumoniae-pangenome.S_pseudosimplitigsAC.k_21.d_5.M_zeros
spneumoniae-pangenome	pseudosimplitigsAC	21	6	default	7910060	10474497	7910060	2564437	164841	2216828	224256	2441084	2732276	spneumoniae-pangenome.S_pseudosimplitigsAC.k_21.d_6.M_default
spneumoniae-pangenome	pseudosimplitigsAC	21	6	ones	7910060	10474497	8110848	2363649	126433	2216828	206192	2423020	2666188	spneumoniae-pangenome.S_pseudosimplitigsAC.k_21.d_6.M_ones
spneumoniae-pangenome	pseudosimplitigsAC	21	6	runs	7910060	10474497	8110511	2363986	126219	2216828	205748	2422576	2665780	spneumoniae-pangenome.S_pseudosimplitigsAC.k_21.d_6.M_runs
spneumoniae-pangenome	pseudosimplitigsAC	21	6	zeros	7910060	10474497	7910060	2564437	164877	2216828	224388	2441216	2732804	spneumoniae-pangenome.S_pseudosimplitigsAC.k_21.d_6.M_zeros
spneumoniae-pangenome	pseudosimplitigsAC	21	7	default	7910060	10406376	7910060	2496316	170475	2197800	237380	2435180	2720968	spneumoniae-pangenome.S_pseudosimplitigsAC.k_21.d_7.M_default
spneumoniae-pangenome	pseudosimplitigsAC	21	7	ones	7910060	10406376	8154928	2251448	124832	2197800	208760	2406560	2635476	spneumoniae-pangenome.S_pseudosimplitigsAC.k_21.d_7.M_ones
spneumoniae-pangenome	pseudosimplitigsAC	21	7	runs	7910060	10406376	8154449	2251927	124534	2197800	208392	2406192	2635692	spneumoniae-pangenome.S_pseudosimplitigsAC.k_21.d_7.M_runs
spneumoniae-pangenome	pseudosimplitigsAC	21	7	zeros	7910060	10406376	7910060	2496316	170497	2197800	237556	2435356	2720164	spneumoniae-pangenome.S_pseudosimplitigsAC.k_21.d_7.M_zeros
spneumoniae-pangenome	pseudosimplitigsAC	21	8	default	7910060	10438583	7910060	2528523	183947	2216560	261268	2477828	2757584	spneumoniae-pangenome.S_pseudosimplitigsAC.k_21.d_8.M_default
spneumoniae-pangenome	pseudosimplitigsAC	21	8	ones	7910060	10438583	8186773	2251810	134501	2216560	226900	2443460	2663628	spneumoniae-pangenome.S_pseudosimplitigsAC.k_21.d_8.M_ones
spneumoniae-pangenome	pseudosimplitigsAC	21	8	runs	7910060	10438583	8185916	2252667	133967	2216560	226332	2442892	2663564	spneumoniae-pangenome.S_pseudosimplitigsAC.k_21.d_8.M_runs
spneumoniae-pangenome	pseudosimplitigsAC	21	8	zeros	7910060	10438583	7910060	2528523	183972	2216560	261340	2477900	2757508	spneumoniae-pangenome.S_pseudosimplitigsAC.k_21.d_8.M_zeros
spneumoniae-pangenome	pseudosimplitigsAC	21	9	default	7910060	10605569	7910060	2695509	216197	2272536	306572	2579108	2863232	spneumoniae-pangenome.S_pseudosimplitigsAC.k_21.d_9.M_default
spneumoniae-pangenome	pseudosimplitigsAC	21	9	ones	7910060	10605569	8224585	2380984	163158	2272536	268400	2540936	2763304	spneumoniae-pangenome.S_pseudosimplitigsAC.k_21.d_9.M_ones
spneumoniae-pangenome	pseudosimplitigsAC	21	9	runs	7910060	10605569	8222754	2382815	162049	2272536	267728	2540264	2761536	spneumoniae-pangenome.S_pseudosimplitigsAC.k_21.d_9.M_runs
spneumoniae-pangenome	pseudosimplitigsAC	21	9	zeros	7910060	10605569	7910060	2695509	216217	2272536	306672	2579208	2864180	spneumoniae-pangenome.S_pseudosimplitigsAC.k_21.d_9.M_zeros
yeast	pseudosimplitigs	2	1	default	10	11	10	1	1	68	68	136	68	yeast.S_pseudosimplitigs.k_2.d_1.M_default
yeast	pseudosimplitigs	2	1	ones	10	11	10	1	1	68	68	136	68	yeast.S_pseudosimplitigs.k_2.d_1.M_ones
yeast	pseudosimplitigs	2	1	runs	10	11	10	1	1	68	68	136	68	yeast.S_pseudosimplitigs.k_2.d_1.M_runs
yeast	pseudosimplitigs	2	1	zeros	10	11	10	1	1	68	68	136	68	yeast.S_pseudosimplitigs.k_2.d_1.M_zeros
yeast	pseudosimplitigsAC	2	1	default	10	11	10	1	1	68	68	136	68	yeast.S_pseudosimplitigsAC.k_2.d_1.M_default
yeast	pseudosimplitigsAC	2	1	ones	10	11	10	1	1	68	68	136	68	yeast.S_pseudosimplitigsAC.k_2.d_1.M_ones
yeast	pseudosimplitigsAC	2	1	runs	10	11	10	1	1	68	68	136	68	yeast.S_pseudosimplitigsAC.k_2.d_1.M_runs
yeast	pseudosimplitigsAC	2	1	zeros	10	11	10	1	1	68	68	136	68	yeast.S_pseudosimplitigsAC.k_2.d_1.M_zeros
yeast	pseudosimplitigs	3	1	default	32	38	32	6	3	92	72	164	96	yeast.S_pseudosimplitigs.k_3.d_1.M_default
yeast	pseudosimplitigs	3	1	ones	32	38	36	2	1	92	72	164	96	yeast.S_pseudosimplitigs.k_3.d_1.M_ones
yeast	pseudosimplitigs	3	1	runs	32	38	36	2	1	92	72	164	96	yeast.S_pseudosimplitigs.k_3.d_1.M_runs
yeast	pseudosimplitigs	3	1	zeros	32	38	32	6	4	92	76	168	96	yeast.S_pseudosimplitigs.k_3.d_1.M_zeros
yeast	pseudosimplitigs	3	2	default	32	37	32	5	3	92	72	164	96	yeast.S_pseudosimplitigs.k_3.d_2.M_default
yeast	pseudosimplitigs	3	2	ones	32	37	35	2	1	92	72	164	92	yeast.S_pseudosimplitigs.k_3.d_2.M_ones
yeast	pseudosimplitigs	3	2	runs	32	37	35	2	1	92	72	164	92	yeast.S_pseudosimplitigs.k_3.d_2.M_runs
yeast	pseudosimplitigs	3	2	zeros	32	37	32	5	3	92	72	164	96	yeast.S_pseudosimplitigs.k_3.d_2.M_zeros
yeast	pseudosimplitigsAC	3	1	default	32	34	32	2	1	92	72	164	92	yeast.S_pseudosimplitigsAC.k_3.d_1.M_default
yeast	pseudosimplitigsAC	3	1	ones	32	34	32	2	1	92	72	164	92	yeast.S_pseudosimplitigsAC.k_3.d_1.M_ones
yeast	pseudosimplitigsAC	3	1	runs	32	34	32	2	1	92	72	164	92	yeast.S_pseudosimplitigsAC.k_3.d_1.M_runs
yeast	pseudosimplitigsAC	3	1	zeros	32	34	32	2	1	92	72	164	92	yeast.S_pseudosimplitigsAC.k_3.d_1.M_zeros
yeast	pseudosimplitigsAC	3	2	default	32	34	32	2	1	92	72	164	92	yeast.S_pseudosimplitigsAC.k_3.d_2.M_default
yeast	pseudosimplitigsAC	3	2	ones	32	34	32	2	1	92	72	164	92	yeast.S_pseudosimplitigsAC.k_3.d_2.M_ones
yeast	pseudosimplitigsAC	3	2	runs	32	34	32	2	1	92	72	164	92	yeast.S_pseudosimplitigsAC.k_3.d_2.M_runs
yeast	pseudosimplitigsAC	3	2	zeros	32	34	32	2	1	92	72	164	92	yeast.S_pseudosimplitigsAC.k_3.d_2.M_zeros
yeast	pseudosimplitigs	4	1	default	136	169	136	33	11	164	88	252	180	yeast.S_pseudosimplitigs.k_4.d_1.M_default
yeast	pseudosimplitigs	4	1	ones	136	169	166	3	1	164	76	240	164	yeast.S_pseudosimplitigs.k_4.d_1.M_ones
yeast	pseudosimplitigs	4	1	runs	136	169	166	3	1	164	76	240	164	yeast.S_pseudosimplitigs.k_4.d_1.M_runs
yeast	pseudosimplitigs	4	1	zeros	136	169	136	33	14	164	92	256	180	yeast.S_pseudosimplitigs.k_4.d_1.M_zeros
yeast	pseudosimplitigs	4	2	default	136	159	136	23	9	156	84	240	172	yeast.S_pseudosimplitigs.k_4.d_2.M_default
yeast	pseudosimplitigs	4	2	ones	136	159	156	3	1	156	76	232	160	yeast.S_pseudosimplitigs.k_4.d_2.M_ones
yeast	pseudosimplitigs	4	2	runs	136	159	156	3	1	156	76	232	160	yeast.S_pseudosimplitigs.k_4.d_2.M_runs
yeast	pseudosimplitigs	4	2	zeros	136	159	136	23	10	156	88	244	172	yeast.S_pseudosimplitigs.k_4.d_2.M_zeros
yeast	pseudosimplitigs	4	3	default	136	155	136	19	10	156	84	240	164	yeast.S_pseudosimplitigs.k_4.d_3.M_default
yeast	pseudosimplitigs	4	3	ones	136	155	152	3	1	156	76	232	156	yeast.S_pseudosimplitigs.k_4.d_3.M_ones
yeast	pseudosimplitigs	4	3	runs	136	155	152	3	1	156	76	232	156	yeast.S_pseudosimplitigs.k_4.d_3.M_runs
yeast	pseudosimplitigs	4	3	zeros	136	155	136	19	10	156	84	240	164	yeast.S_pseudosimplitigs.k_4.d_3.M_zeros
yeast	pseudosimplitigsAC	4	1	default	136	160	136	24	8	160	80	240	176	yeast.S_pseudosimplitigsAC.k_4.d_1.M_default
yeast	pseudosimplitigsAC	4	1	ones	136	160	157	3	1	160	76	236	164	yeast.S_pseudosimplitigsAC.k_4.d_1.M_ones
yeast	pseudosimplitigsAC	4	1	runs	136	160	157	3	1	160	76	236	164	yeast.S_pseudosimplitigsAC.k_4.d_1.M_runs
yeast	pseudosimplitigsAC	4	1	zeros	136	160	136	24	9	160	80	240	176	yeast.S_pseudosimplitigsAC.k_4.d_1.M_zeros
yeast	pseudosimplitigsAC	4	2	default	136	146	136	10	8	156	80	236	160	yeast.S_pseudosimplitigsAC.k_4.d_2.M_default
yeast	pseudosimplitigsAC	4	2	ones	136	146	143	3	1	156	76	232	156	yeast.S_pseudosimplitigsAC.k_4.d_2.M_ones
yeast	pseudosimplitigsAC	4	2	runs	136	146	143	3	1	156	76	232	156	yeast.S_pseudosimplitigsAC.k_4.d_2.M_runs
yeast	pseudosimplitigsAC	4	2	zeros	136	146	136	10	8	156	80	236	160	yeast.S_pseudosimplitigsAC.k_4.d_2.M_zeros
yeast	pseudosimplitigsAC	4	3	default	136	146	136	10	8	156	80	236	160	yeast.S_pseudosimplitigsAC.k_4.d_3.M_default
yeast	pseudosimplitigsAC	4	3	ones	136	146	143	3	1	156	76	232	156	yeast.S_pseudosimplitigsAC.k_4.d_3.M_ones
yeast	pseudosimplitigsAC	4	3	runs	136	146	143	3	1	156	76	232	156	yeast.S_pseudosimplitigsAC.k_4.d_3.M_runs
yeast	pseudosimplitigsAC	4	3	zeros	136	146	136	10	8	156	80	236	160	yeast.S_pseudosimplitigsAC.k_4.d_3.M_zeros
yeast	pseudosimplitigs	5	1	default	512	544	512	32	8	260	92	352	288	yeast.S_pseudosimplitigs.k_5.d_1.M_default
yeast	pseudosimplitigs	5	1	ones	512	544	540	4	1	260	76	336	264	yeast.S_pseudosimplitigs.k_5.d_1.M_ones
yeast	pseudosimplitigs	5	1	runs	512	544	540	4	1	260	76	336	264	yeast.S_pseudosimplitigs.k_5.d_1.M_runs
yeast	pseudosimplitigs	5	1	zeros	512	544	512	32	10	260	96	356	292	yeast.S_pseudosimplitigs.k_5.d_1.M_zeros
yeast	pseudosimplitigs	5	2	default	512	540	512	28	13	272	96	368	288	yeast.S_pseudosimplitigs.k_5.d_2.M_default
yeast	pseudosimplitigs	5	2	ones	512	540	536	4	1	272	76	348	276	yeast.S_pseudosimplitigs.k_5.d_2.M_ones
yeast	pseudosimplitigs	5	2	runs	512	540	536	4	1	272	76	348	276	yeast.S_pseudosimplitigs.k_5.d_2.M_runs
yeast	pseudosimplitigs	5	2	zeros	512	540	512	28	13	272	96	368	296	yeast.S_pseudosimplitigs.k_5.d_2.M_zeros
yeast	pseudosimplitigs	5	3	default	512	533	512	21	13	260	96	356	284	yeast.S_pseudosimplitigs.k_5.d_3.M_default
yeast	pseudosimplitigs	5	3	ones	512	533	529	4	1	260	76	336	260	yeast.S_pseudosimplitigs.k_5.d_3.M_ones
yeast	pseudosimplitigs	5	3	runs	512	533	529	4	1	260	76	336	260	yeast.S_pseudosimplitigs.k_5.d_3.M_runs
yeast	pseudosimplitigs	5	3	zeros	512	533	512	21	14	260	104	364	280	yeast.S_pseudosimplitigs.k_5.d_3.M_zeros
yeast	pseudosimplitigs	5	4	default	512	533	512	21	13	260	96	356	284	yeast.S_pseudosimplitigs.k_5.d_4.M_default
yeast	pseudosimplitigs	5	4	ones	512	533	529	4	1	260	76	336	260	yeast.S_pseudosimplitigs.k_5.d_4.M_ones
yeast	pseudosimplitigs	5	4	runs	512	533	529	4	1	260	76	336	260	yeast.S_pseudosimplitigs.k_5.d_4.M_runs
yeast	pseudosimplitigs	5	4	zeros	512	533	512	21	14	260	104	364	280	yeast.S_pseudosimplitigs.k_5.d_4.M_zeros
yeast	pseudosimplitigsAC	5	1	default	512	520	512	8	2	308	80	388	312	yeast.S_pseudosimplitigsAC.k_5.d_1.M_default
yeast	pseudosimplitigsAC	5	1	ones	512	520	516	4	1	308	76	384	308	yeast.S_pseudosimplitigsAC.k_5.d_1.M_ones
yeast	pseudosimplitigsAC	5	1	runs	512	520	516	4	1	308	76	384	308	yeast.S_pseudosimplitigsAC.k_5.d_1.M_runs
yeast	pseudosimplitigsAC	5	1	zeros	512	520	512	8	2	308	80	388	312	yeast.S_pseudosimplitigsAC.k_5.d_1.M_zeros
yeast	pseudosimplitigsAC	5	2	default	512	521	512	9	3	304	84	388	312	yeast.S_pseudosimplitigsAC.k_5.d_2.M_default
yeast	pseudosimplitigsAC	5	2	ones	512	521	517	4	1	304	76	380	308	yeast.S_pseudosimplitigsAC.k_5.d_2.M_ones
yeast	pseudosimplitigsAC	5	2	runs	512	521	517	4	1	304	76	380	308	yeast.S_pseudosimplitigsAC.k_5.d_2.M_runs
yeast	pseudosimplitigsAC	5	2	zeros	512	521	512	9	3	304	84	388	312	yeast.S_pseudosimplitigsAC.k_5.d_2.M_zeros
yeast	pseudosimplitigsAC	5	3	default	512	519	512	7	3	300	84	384	312	yeast.S_pseudosimplitigsAC.k_5.d_3.M_default
yeast	pseudosimplitigsAC	5	3	ones	512	519	515	4	1	300	76	376	304	yeast.S_pseudosimplitigsAC.k_5.d_3.M_ones
yeast	pseudosimplitigsAC	5	3	runs	512	519	515	4	1	300	76	376	304	yeast.S_pseudosimplitigsAC.k_5.d_3.M_runs
yeast	pseudosimplitigsAC	5	3	zeros	512	519	512	7	3	300	84	384	312	yeast.S_pseudosimplitigsAC.k_5.d_3.M_zeros
yeast	pseudosimplitigsAC	5	4	default	512	519	512	7	3	300	84	384	312	yeast.S_pseudosimplitigsAC.k_5.d_4.M_default
yeast	pseudosimplitigsAC	5	4	ones	512	519	515	4	1	300	76	376	304	yeast.S_pseudosimplitigsAC.k_5.d_4.M_ones
yeast	pseudosimplitigsAC	5	4	runs	512	519	515	4	1	300	76	376	304	yeast.S_pseudosimplitigsAC.k_5.d_4.M_runs
yeast	pseudosimplitigsAC	5	4	zeros	512	519	512	7	3	300	84	384	312	yeast.S_pseudosimplitigsAC.k_5.d_4.M_zeros
yeast	pseudosimplitigs	6	1	default	2080	2315	2080	235	47	704	152	856	776	yeast.S_pseudosimplitigs.k_6.d_1.M_default
yeast	pseudosimplitigs	6	1	ones	2080	2315	2310	5	1	704	88	792	708	yeast.S_pseudosimplitigs.k_6.d_1.M_ones
yeast	pseudosimplitigs	6	1	runs	2080	2315	2310	5	1	704	88	792	708	yeast.S_pseudosimplitigs.k_6.d_1.M_runs
yeast	pseudosimplitigs	6	1	zeros	2080	2315	2080	235	73	704	204	908	804	yeast.S_pseudosimplitigs.k_6.d_1.M_zeros
yeast	pseudosimplitigs	6	2	default	2080	2264	2080	184	92	688	188	876	772	yeast.S_pseudosimplitigs.k_6.d_2.M_default
yeast	pseudosimplitigs	6	2	ones	2080	2264	2259	5	1	688	88	776	692	yeast.S_pseudosimplitigs.k_6.d_2.M_ones
yeast	pseudosimplitigs	6	2	runs	2080	2264	2259	5	1	688	88	776	692	yeast.S_pseudosimplitigs.k_6.d_2.M_runs
yeast	pseudosimplitigs	6	2	zeros	2080	2264	2080	184	98	688	208	896	788	yeast.S_pseudosimplitigs.k_6.d_2.M_zeros
yeast	pseudosimplitigs	6	3	default	2080	2272	2080	192	115	672	220	892	772	yeast.S_pseudosimplitigs.k_6.d_3.M_default
yeast	pseudosimplitigs	6	3	ones	2080	2272	2267	5	1	672	88	760	676	yeast.S_pseudosimplitigs.k_6.d_3.M_ones
yeast	pseudosimplitigs	6	3	runs	2080	2272	2267	5	1	672	88	760	676	yeast.S_pseudosimplitigs.k_6.d_3.M_runs
yeast	pseudosimplitigs	6	3	zeros	2080	2272	2080	192	110	672	228	900	780	yeast.S_pseudosimplitigs.k_6.d_3.M_zeros
yeast	pseudosimplitigs	6	4	default	2080	2224	2080	144	89	616	200	816	708	yeast.S_pseudosimplitigs.k_6.d_4.M_default
yeast	pseudosimplitigs	6	4	ones	2080	2224	2219	5	1	616	88	704	620	yeast.S_pseudosimplitigs.k_6.d_4.M_ones
yeast	pseudosimplitigs	6	4	runs	2080	2224	2219	5	1	616	88	704	620	yeast.S_pseudosimplitigs.k_6.d_4.M_runs
yeast	pseudosimplitigs	6	4	zeros	2080	2224	2080	144	91	616	200	816	708	yeast.S_pseudosimplitigs.k_6.d_4.M_zeros
yeast	pseudosimplitigs	6	5	default	2080	2224	2080	144	89	620	200	820	712	yeast.S_pseudosimplitigs.k_6.d_5.M_default
yeast	pseudosimplitigs	6	5	ones	2080	2224	2219	5	1	620	88	708	624	yeast.S_pseudosimplitigs.k_6.d_5.M_ones
yeast	pseudosimplitigs	6	5	runs	2080	2224	2219	5	1	620	88	708	624	yeast.S_pseudosimplitigs.k_6.d_5.M_runs
yeast	pseudosimplitigs	6	5	zeros	2080	2224	2080	144	90	620	204	824	692	yeast.S_pseudosimplitigs.k_6.d_5.M_zeros
yeast	pseudosimplitigsAC	6	1	default	2080	2230	2080	150	30	872	112	984	932	yeast.S_pseudosimplitigsAC.k_6.d_1.M_default
yeast	pseudosimplitigsAC	6	1	ones	2080	2230	2225	5	1	872	88	960	876	yeast.S_pseudosimplitigsAC.k_6.d_1.M_ones
yeast	pseudosimplitigsAC	6	1	runs	2080	2230	2225	5	1	872	88	960	876	yeast.S_pseudosimplitigsAC.k_6.d_1.M_runs
yeast	pseudosimplitigsAC	6	1	zeros	2080	2230	2080	150	31	872	116	988	932	yeast.S_pseudosimplitigsAC.k_6.d_1.M_zeros
yeast	pseudosimplitigsAC	6	2	default	2080	2205	2080	125	45	868	144	1012	932	yeast.S_pseudosimplitigsAC.k_6.d_2.M_default
yeast	pseudosimplitigsAC	6	2	ones	2080	2205	2200	5	1	868	84	952	872	yeast.S_pseudosimplitigsAC.k_6.d_2.M_ones
yeast	pseudosimplitigsAC	6	2	runs	2080	2205	2200	5	1	868	84	952	872	yeast.S_pseudosimplitigsAC.k_6.d_2.M_runs
yeast	pseudosimplitigsAC	6	2	zeros	2080	2205	2080	125	45	868	152	1020	928	yeast.S_pseudosimplitigsAC.k_6.d_2.M_zeros
yeast	pseudosimplitigsAC	6	3	default	2080	2177	2080	97	47	860	152	1012	920	yeast.S_pseudosimplitigsAC.k_6.d_3.M_default
yeast	pseudosimplitigsAC	6	3	ones	2080	2177	2172	5	1	860	84	944	860	yeast.S_pseudosimplitigsAC.k_6.d_3.M_ones
yeast	pseudosimplitigsAC	6	3	runs	2080	2177	2172	5	1	860	84	944	860	yeast.S_pseudosimplitigsAC.k_6.d_3.M_runs
yeast	pseudosimplitigsAC	6	3	zeros	2080	2177	2080	97	48	860	156	1016	916	yeast.S_pseudosimplitigsAC.k_6.d_3.M_zeros
yeast	pseudosimplitigsAC	6	4	default	2080	2167	2080	87	47	852	152	1004	912	yeast.S_pseudosimplitigsAC.k_6.d_4.M_default
yeast	pseudosimplitigsAC	6	4	ones	2080	2167	2162	5	1	852	84	936	856	yeast.S_pseudosimplitigsAC.k_6.d_4.M_ones
yeast	pseudosimplitigsAC	6	4	runs	2080	2167	2162	5	1	852	84	936	856	yeast.S_pseudosimplitigsAC.k_6.d_4.M_runs
yeast	pseudosimplitigsAC	6	4	zeros	2080	2167	2080	87	48	852	156	1008	912	yeast.S_pseudosimplitigsAC.k_6.d_4.M_zeros
yeast	pseudosimplitigsAC	6	5	default	2080	2165	2080	85	47	852	152	1004	912	yeast.S_pseudosimplitigsAC.k_6.d_5.M_default
yeast	pseudosimplitigsAC	6	5	ones	2080	2165	2160	5	1	852	84	936	856	yeast.S_pseudosimplitigsAC.k_6.d_5.M_ones
yeast	pseudosimplitigsAC	6	5	runs	2080	2165	2160	5	1	852	84	936	856	yeast.S_pseudosimplitigsAC.k_6.d_5.M_runs
yeast	pseudosimplitigsAC	6	5	zeros	2080	2165	2080	85	50	852	164	1016	912	yeast.S_pseudosimplitigsAC.k_6.d_5.M_zeros
yeast	pseudosimplitigs	7	1	default	8192	8774	8192	582	97	1724	220	1944	1972	yeast.S_pseudosimplitigs.k_7.d_1.M_default
yeast	pseudosimplitigs	7	1	ones	8192	8774	8768	6	1	1724	108	1832	1728	yeast.S_pseudosimplitigs.k_7.d_1.M_ones
yeast	pseudosimplitigs	7	1	runs	8192	8774	8768	6	1	1724	108	1832	1728	yeast.S_pseudosimplitigs.k_7.d_1.M_runs
yeast	pseudosimplitigs	7	1	zeros	8192	8774	8192	582	159	1724	360	2084	2048	yeast.S_pseudosimplitigs.k_7.d_1.M_zeros
yeast	pseudosimplitigs	7	2	default	8192	8483	8192	291	96	1600	240	1840	1732	yeast.S_pseudosimplitigs.k_7.d_2.M_default
yeast	pseudosimplitigs	7	2	ones	8192	8483	8477	6	1	1600	108	1708	1608	yeast.S_pseudosimplitigs.k_7.d_2.M_ones
yeast	pseudosimplitigs	7	2	runs	8192	8483	8477	6	1	1600	108	1708	1608	yeast.S_pseudosimplitigs.k_7.d_2.M_runs
yeast	pseudosimplitigs	7	2	zeros	8192	8483	8192	291	103	1600	280	1880	1708	yeast.S_pseudosimplitigs.k_7.d_2.M_zeros
yeast	pseudosimplitigs	7	3	default	8192	8475	8192	283	171	1596	336	1932	1668	yeast.S_pseudosimplitigs.k_7.d_3.M_default
yeast	pseudosimplitigs	7	3	ones	8192	8475	8469	6	1	1596	108	1704	1604	yeast.S_pseudosimplitigs.k_7.d_3.M_ones
yeast	pseudosimplitigs	7	3	runs	8192	8475	8469	6	1	1596	108	1704	1604	yeast.S_pseudosimplitigs.k_7.d_3.M_runs
yeast	pseudosimplitigs	7	3	zeros	8192	8475	8192	283	137	1596	344	1940	1680	yeast.S_pseudosimplitigs.k_7.d_3.M_zeros
yeast	pseudosimplitigs	7	4	default	8192	8469	8192	277	187	1488	340	1828	1672	yeast.S_pseudosimplitigs.k_7.d_4.M_default
yeast	pseudosimplitigs	7	4	ones	8192	8469	8463	6	1	1488	108	1596	1496	yeast.S_pseudosimplitigs.k_7.d_4.M_ones
yeast	pseudosimplitigs	7	4	runs	8192	8469	8463	6	1	1488	108	1596	1496	yeast.S_pseudosimplitigs.k_7.d_4.M_runs
yeast	pseudosimplitigs	7	4	zeros	8192	8469	8192	277	165	1488	368	1856	1640	yeast.S_pseudosimplitigs.k_7.d_4.M_zeros
yeast	pseudosimplitigs	7	5	default	8192	8468	8192	276	187	1488	340	1828	1668	yeast.S_pseudosimplitigs.k_7.d_5.M_default
yeast	pseudosimplitigs	7	5	ones	8192	8468	8462	6	1	1488	108	1596	1496	yeast.S_pseudosimplitigs.k_7.d_5.M_ones
yeast	pseudosimplitigs	7	5	runs	8192	8468	8462	6	1	1488	108	1596	1496	yeast.S_pseudosimplitigs.k_7.d_5.M_runs
yeast	pseudosimplitigs	7	5	zeros	8192	8468	8192	276	165	1488	368	1856	1640	yeast.S_pseudosimplitigs.k_7.d_5.M_zeros
yeast	pseudosimplitigs	7	6	default	8192	8467	8192	275	187	1488	340	1828	1672	yeast.S_pseudosimplitigs.k_7.d_6.M_default
yeast	pseudosimplitigs	7	6	ones	8192	8467	8461	6	1	1488	108	1596	1496	yeast.S_pseudosimplitigs.k_7.d_6.M_ones
yeast	pseudosimplitigs	7	6	runs	8192	8467	8461	6	1	1488	108	1596	1496	yeast.S_pseudosimplitigs.k_7.d_6.M_runs
yeast	pseudosimplitigs	7	6	zeros	8192	8467	8192	275	165	1488	368	1856	1644	yeast.S_pseudosimplitigs.k_7.d_6.M_zeros
yeast	pseudosimplitigsAC	7	1	default	8192	8210	8192	18	3	2628	112	2740	2644	yeast.S_pseudosimplitigsAC.k_7.d_1.M_default
yeast	pseudosimplitigsAC	7	1	ones	8192	8210	8204	6	1	2628	108	2736	2636	yeast.S_pseudosimplitigsAC.k_7.d_1.M_ones
yeast	pseudosimplitigsAC	7	1	runs	8192	8210	8204	6	1	2628	108	2736	2636	yeast.S_pseudosimplitigsAC.k_7.d_1.M_runs
yeast	pseudosimplitigsAC	7	1	zeros	8192	8210	8192	18	3	2628	112	2740	2644	yeast.S_pseudosimplitigsAC.k_7.d_1.M_zeros
yeast	pseudosimplitigsAC	7	2	default	8192	8210	8192	18	3	2628	112	2740	2644	yeast.S_pseudosimplitigsAC.k_7.d_2.M_default
yeast	pseudosimplitigsAC	7	2	ones	8192	8210	8204	6	1	2628	108	2736	2636	yeast.S_pseudosimplitigsAC.k_7.d_2.M_ones
yeast	pseudosimplitigsAC	7	2	runs	8192	8210	8204	6	1	2628	108	2736	2636	yeast.S_pseudosimplitigsAC.k_7.d_2.M_runs
yeast	pseudosimplitigsAC	7	2	zeros	8192	8210	8192	18	3	2628	112	2740	2644	yeast.S_pseudosimplitigsAC.k_7.d_2.M_zeros
yeast	pseudosimplitigsAC	7	3	default	8192	8210	8192	18	3	2628	112	2740	2644	yeast.S_pseudosimplitigsAC.k_7.d_3.M_default
yeast	pseudosimplitigsAC	7	3	ones	8192	8210	8204	6	1	2628	108	2736	2636	yeast.S_pseudosimplitigsAC.k_7.d_3.M_ones
yeast	pseudosimplitigsAC	7	3	runs	8192	8210	8204	6	1	2628	108	2736	2636	yeast.S_pseudosimplitigsAC.k_7.d_3.M_runs
yeast	pseudosimplitigsAC	7	3	zeros	8192	8210	8192	18	3	2628	112	2740	2644	yeast.S_pseudosimplitigsAC.k_7.d_3.M_zeros
yeast	pseudosimplitigsAC	7	4	default	8192	8204	8192	12	3	2628	112	2740	2640	yeast.S_pseudosimplitigsAC.k_7.d_4.M_default
yeast	pseudosimplitigsAC	7	4	ones	8192	8204	8198	6	1	2628	108	2736	2632	yeast.S_pseudosimplitigsAC.k_7.d_4.M_ones
yeast	pseudosimplitigsAC	7	4	runs	8192	8204	8198	6	1	2628	108	2736	2632	yeast.S_pseudosimplitigsAC.k_7.d_4.M_runs
yeast	pseudosimplitigsAC	7	4	zeros	8192	8204	8192	12	5	2628	124	2752	2628	yeast.S_pseudosimplitigsAC.k_7.d_4.M_zeros
yeast	pseudosimplitigsAC	7	5	default	8192	8204	8192	12	3	2628	112	2740	2640	yeast.S_pseudosimplitigsAC.k_7.d_5.M_default
yeast	pseudosimplitigsAC	7	5	ones	8192	8204	8198	6	1	2628	108	2736	2632	yeast.S_pseudosimplitigsAC.k_7.d_5.M_ones
yeast	pseudosimplitigsAC	7	5	runs	8192	8204	8198	6	1	2628	108	2736	2632	yeast.S_pseudosimplitigsAC.k_7.d_5.M_runs
yeast	pseudosimplitigsAC	7	5	zeros	8192	8204	8192	12	5	2628	124	2752	2628	yeast.S_pseudosimplitigsAC.k_7.d_5.M_zeros
yeast	pseudosimplitigsAC	7	6	default	8192	8204	8192	12	3	2628	112	2740	2640	yeast.S_pseudosimplitigsAC.k_7.d_6.M_default
yeast	pseudosimplitigsAC	7	6	ones	8192	8204	8198	6	1	2628	108	2736	2632	yeast.S_pseudosimplitigsAC.k_7.d_6.M_ones
yeast	pseudosimplitigsAC	7	6	runs	8192	8204	8198	6	1	2628	108	2736	2632	yeast.S_pseudosimplitigsAC.k_7.d_6.M_runs
yeast	pseudosimplitigsAC	7	6	zeros	8192	8204	8192	12	5	2628	124	2752	2628	yeast.S_pseudosimplitigsAC.k_7.d_6.M_zeros
yeast	pseudosimplitigs	8	1	default	32896	34891	32896	1995	285	4704	536	5240	5416	yeast.S_pseudosimplitigs.k_8.d_1.M_default
yeast	pseudosimplitigs	8	1	ones	32896	34891	34884	7	1	4704	136	4840	4708	yeast.S_pseudosimplitigs.k_8.d_1.M_ones
yeast	pseudosimplitigs	8	1	runs	32896	34891	34884	7	1	4704	136	4840	4708	yeast.S_pseudosimplitigs.k_8.d_1.M_runs
yeast	pseudosimplitigs	8	1	zeros	32896	34891	32896	1995	474	4704	876	5580	5688	yeast.S_pseudosimplitigs.k_8.d_1.M_zeros
yeast	pseudosimplitigs	8	2	default	32896	34362	32896	1466	416	4460	724	5184	5272	yeast.S_pseudosimplitigs.k_8.d_2.M_default
yeast	pseudosimplitigs	8	2	ones	32896	34362	34355	7	1	4460	136	4596	4464	yeast.S_pseudosimplitigs.k_8.d_2.M_ones
yeast	pseudosimplitigs	8	2	runs	32896	34362	34355	7	1	4460	136	4596	4464	yeast.S_pseudosimplitigs.k_8.d_2.M_runs
yeast	pseudosimplitigs	8	2	zeros	32896	34362	32896	1466	449	4460	812	5272	5276	yeast.S_pseudosimplitigs.k_8.d_2.M_zeros
yeast	pseudosimplitigs	8	3	default	32896	34202	32896	1306	653	4212	960	5172	5172	yeast.S_pseudosimplitigs.k_8.d_3.M_default
yeast	pseudosimplitigs	8	3	ones	32896	34202	34195	7	1	4212	136	4348	4216	yeast.S_pseudosimplitigs.k_8.d_3.M_ones
yeast	pseudosimplitigs	8	3	runs	32896	34202	34195	7	1	4212	136	4348	4216	yeast.S_pseudosimplitigs.k_8.d_3.M_runs
yeast	pseudosimplitigs	8	3	zeros	32896	34202	32896	1306	609	4212	972	5184	5044	yeast.S_pseudosimplitigs.k_8.d_3.M_zeros
yeast	pseudosimplitigs	8	4	default	32896	34207	32896	1311	763	4188	1064	5252	5176	yeast.S_pseudosimplitigs.k_8.d_4.M_default
yeast	pseudosimplitigs	8	4	ones	32896	34207	34200	7	1	4188	136	4324	4192	yeast.S_pseudosimplitigs.k_8.d_4.M_ones
yeast	pseudosimplitigs	8	4	runs	32896	34207	34200	7	1	4188	136	4324	4192	yeast.S_pseudosimplitigs.k_8.d_4.M_runs
yeast	pseudosimplitigs	8	4	zeros	32896	34207	32896	1311	748	4188	1120	5308	5320	yeast.S_pseudosimplitigs.k_8.d_4.M_zeros
yeast	pseudosimplitigs	8	5	default	32896	34222	32896	1326	773	4228	1064	5292	5228	yeast.S_pseudosimplitigs.k_8.d_5.M_default
yeast	pseudosimplitigs	8	5	ones	32896	34222	34215	7	1	4228	136	4364	4236	yeast.S_pseudosimplitigs.k_8.d_5.M_ones
yeast	pseudosimplitigs	8	5	runs	32896	34222	34215	7	1	4228	136	4364	4236	yeast.S_pseudosimplitigs.k_8.d_5.M_runs
yeast	pseudosimplitigs	8	5	zeros	32896	34222	32896	1326	855	4228	1284	5512	5464	yeast.S_pseudosimplitigs.k_8.d_5.M_zeros
yeast	pseudosimplitigs	8	6	default	32896	34201	32896	1305	775	4224	1068	5292	5212	yeast.S_pseudosimplitigs.k_8.d_6.M_default
yeast	pseudosimplitigs	8	6	ones	32896	34201	34194	7	1	4224	136	4360	4228	yeast.S_pseudosimplitigs.k_8.d_6.M_ones
yeast	pseudosimplitigs	8	6	runs	32896	34201	34194	7	1	4224	136	4360	4228	yeast.S_pseudosimplitigs.k_8.d_6.M_runs
yeast	pseudosimplitigs	8	6	zeros	32896	34201	32896	1305	855	4224	1284	5508	5448	yeast.S_pseudosimplitigs.k_8.d_6.M_zeros
yeast	pseudosimplitigs	8	7	default	32896	34205	32896	1309	776	4220	1072	5292	5220	yeast.S_pseudosimplitigs.k_8.d_7.M_default
yeast	pseudosimplitigs	8	7	ones	32896	34205	34198	7	1	4220	136	4356	4228	yeast.S_pseudosimplitigs.k_8.d_7.M_ones
yeast	pseudosimplitigs	8	7	runs	32896	34205	34198	7	1	4220	136	4356	4228	yeast.S_pseudosimplitigs.k_8.d_7.M_runs
yeast	pseudosimplitigs	8	7	zeros	32896	34205	32896	1309	855	4220	1288	5508	5460	yeast.S_pseudosimplitigs.k_8.d_7.M_zeros
yeast	pseudosimplitigsAC	8	1	default	32896	33799	32896	903	129	9812	312	10124	10080	yeast.S_pseudosimplitigsAC.k_8.d_1.M_default
yeast	pseudosimplitigsAC	8	1	ones	32896	33799	33792	7	1	9812	136	9948	9820	yeast.S_pseudosimplitigsAC.k_8.d_1.M_ones
yeast	pseudosimplitigsAC	8	1	runs	32896	33799	33792	7	1	9812	136	9948	9820	yeast.S_pseudosimplitigsAC.k_8.d_1.M_runs
yeast	pseudosimplitigsAC	8	1	zeros	32896	33799	32896	903	162	9812	392	10204	10140	yeast.S_pseudosimplitigsAC.k_8.d_1.M_zeros
yeast	pseudosimplitigsAC	8	2	default	32896	33820	32896	924	210	9792	476	10268	10172	yeast.S_pseudosimplitigsAC.k_8.d_2.M_default
yeast	pseudosimplitigsAC	8	2	ones	32896	33820	33813	7	1	9792	136	9928	9796	yeast.S_pseudosimplitigsAC.k_8.d_2.M_ones
yeast	pseudosimplitigsAC	8	2	runs	32896	33820	33813	7	1	9792	136	9928	9796	yeast.S_pseudosimplitigsAC.k_8.d_2.M_runs
yeast	pseudosimplitigsAC	8	2	zeros	32896	33820	32896	924	214	9792	476	10268	10176	yeast.S_pseudosimplitigsAC.k_8.d_2.M_zeros
yeast	pseudosimplitigsAC	8	3	default	32896	33798	32896	902	261	9804	572	10376	10252	yeast.S_pseudosimplitigsAC.k_8.d_3.M_default
yeast	pseudosimplitigsAC	8	3	ones	32896	33798	33791	7	1	9804	136	9940	9812	yeast.S_pseudosimplitigsAC.k_8.d_3.M_ones
yeast	pseudosimplitigsAC	8	3	runs	32896	33798	33791	7	1	9804	136	9940	9812	yeast.S_pseudosimplitigsAC.k_8.d_3.M_runs
yeast	pseudosimplitigsAC	8	3	zeros	32896	33798	32896	902	263	9804	572	10376	10248	yeast.S_pseudosimplitigsAC.k_8.d_3.M_zeros
yeast	pseudosimplitigsAC	8	4	default	32896	33665	32896	769	302	9768	620	10388	10200	yeast.S_pseudosimplitigsAC.k_8.d_4.M_default
yeast	pseudosimplitigsAC	8	4	ones	32896	33665	33658	7	1	9768	136	9904	9776	yeast.S_pseudosimplitigsAC.k_8.d_4.M_ones
yeast	pseudosimplitigsAC	8	4	runs	32896	33665	33658	7	1	9768	136	9904	9776	yeast.S_pseudosimplitigsAC.k_8.d_4.M_runs
yeast	pseudosimplitigsAC	8	4	zeros	32896	33665	32896	769	307	9768	632	10400	10192	yeast.S_pseudosimplitigsAC.k_8.d_4.M_zeros
yeast	pseudosimplitigsAC	8	5	default	32896	33645	32896	749	312	9764	620	10384	10188	yeast.S_pseudosimplitigsAC.k_8.d_5.M_default
yeast	pseudosimplitigsAC	8	5	ones	32896	33645	33638	7	1	9764	136	9900	9772	yeast.S_pseudosimplitigsAC.k_8.d_5.M_ones
yeast	pseudosimplitigsAC	8	5	runs	32896	33645	33638	7	1	9764	136	9900	9772	yeast.S_pseudosimplitigsAC.k_8.d_5.M_runs
yeast	pseudosimplitigsAC	8	5	zeros	32896	33645	32896	749	317	9764	628	10392	10180	yeast.S_pseudosimplitigsAC.k_8.d_5.M_zeros
yeast	pseudosimplitigsAC	8	6	default	32896	33641	32896	745	313	9760	624	10384	10212	yeast.S_pseudosimplitigsAC.k_8.d_6.M_default
yeast	pseudosimplitigsAC	8	6	ones	32896	33641	33634	7	1	9760	136	9896	9768	yeast.S_pseudosimplitigsAC.k_8.d_6.M_ones
yeast	pseudosimplitigsAC	8	6	runs	32896	33641	33634	7	1	9760	136	9896	9768	yeast.S_pseudosimplitigsAC.k_8.d_6.M_runs
yeast	pseudosimplitigsAC	8	6	zeros	32896	33641	32896	745	333	9760	664	10424	10228	yeast.S_pseudosimplitigsAC.k_8.d_6.M_zeros
yeast	pseudosimplitigsAC	8	7	default	32896	33637	32896	741	313	9760	624	10384	10212	yeast.S_pseudosimplitigsAC.k_8.d_7.M_default
yeast	pseudosimplitigsAC	8	7	ones	32896	33637	33630	7	1	9760	136	9896	9768	yeast.S_pseudosimplitigsAC.k_8.d_7.M_ones
yeast	pseudosimplitigsAC	8	7	runs	32896	33637	33630	7	1	9760	136	9896	9768	yeast.S_pseudosimplitigsAC.k_8.d_7.M_runs
yeast	pseudosimplitigsAC	8	7	zeros	32896	33637	32896	741	333	9760	668	10428	10228	yeast.S_pseudosimplitigsAC.k_8.d_7.M_zeros
yeast	pseudosimplitigs	9	1	default	131071	136151	131071	5080	635	13312	1008	14320	15520	yeast.S_pseudosimplitigs.k_9.d_1.M_default
yeast	pseudosimplitigs	9	1	ones	131071	136151	136142	9	2	13312	164	13476	13320	yeast.S_pseudosimplitigs.k_9.d_1.M_ones
yeast	pseudosimplitigs	9	1	runs	131071	136151	136142	9	2	13312	164	13476	13320	yeast.S_pseudosimplitigs.k_9.d_1.M_runs
yeast	pseudosimplitigs	9	1	zeros	131071	136151	131071	5080	1068	13312	2028	15340	16192	yeast.S_pseudosimplitigs.k_9.d_1.M_zeros
yeast	pseudosimplitigs	9	2	default	131071	134391	131071	3320	961	12240	1524	13764	14428	yeast.S_pseudosimplitigs.k_9.d_2.M_default
yeast	pseudosimplitigs	9	2	ones	131071	134391	134383	8	1	12240	156	12396	12244	yeast.S_pseudosimplitigs.k_9.d_2.M_ones
yeast	pseudosimplitigs	9	2	runs	131071	134391	134383	8	1	12240	156	12396	12244	yeast.S_pseudosimplitigs.k_9.d_2.M_runs
yeast	pseudosimplitigs	9	2	zeros	131071	134391	131071	3320	1002	12240	1784	14024	14516	yeast.S_pseudosimplitigs.k_9.d_2.M_zeros
yeast	pseudosimplitigs	9	3	default	131071	135197	131071	4126	2815	15628	3340	18968	19612	yeast.S_pseudosimplitigs.k_9.d_3.M_default
yeast	pseudosimplitigs	9	3	ones	131071	135197	135189	8	1	15628	156	15784	15636	yeast.S_pseudosimplitigs.k_9.d_3.M_ones
yeast	pseudosimplitigs	9	3	runs	131071	135197	135189	8	1	15628	156	15784	15636	yeast.S_pseudosimplitigs.k_9.d_3.M_runs
yeast	pseudosimplitigs	9	3	zeros	131071	135197	131071	4126	2618	15628	3224	18852	19316	yeast.S_pseudosimplitigs.k_9.d_3.M_zeros
yeast	pseudosimplitigs	9	4	default	131071	134872	131071	3801	2876	15356	3452	18808	19540	yeast.S_pseudosimplitigs.k_9.d_4.M_default
yeast	pseudosimplitigs	9	4	ones	131071	134872	134863	9	2	15356	164	15520	15400	yeast.S_pseudosimplitigs.k_9.d_4.M_ones
yeast	pseudosimplitigs	9	4	runs	131071	134872	134863	9	2	15356	164	15520	15400	yeast.S_pseudosimplitigs.k_9.d_4.M_runs
yeast	pseudosimplitigs	9	4	zeros	131071	134872	131071	3801	2732	15356	3732	19088	19676	yeast.S_pseudosimplitigs.k_9.d_4.M_zeros
yeast	pseudosimplitigs	9	5	default	131071	134830	131071	3759	2888	15348	3464	18812	19528	yeast.S_pseudosimplitigs.k_9.d_5.M_default
yeast	pseudosimplitigs	9	5	ones	131071	134830	134821	9	2	15348	160	15508	15320	yeast.S_pseudosimplitigs.k_9.d_5.M_ones
yeast	pseudosimplitigs	9	5	runs	131071	134830	134821	9	2	15348	160	15508	15320	yeast.S_pseudosimplitigs.k_9.d_5.M_runs
yeast	pseudosimplitigs	9	5	zeros	131071	134830	131071	3759	2764	15348	3780	19128	19668	yeast.S_pseudosimplitigs.k_9.d_5.M_zeros
yeast	pseudosimplitigs	9	6	default	131071	134823	131071	3752	2886	15428	3468	18896	19592	yeast.S_pseudosimplitigs.k_9.d_6.M_default
yeast	pseudosimplitigs	9	6	ones	131071	134823	134814	9	2	15428	164	15592	15396	yeast.S_pseudosimplitigs.k_9.d_6.M_ones
yeast	pseudosimplitigs	9	6	runs	131071	134823	134814	9	2	15428	164	15592	15396	yeast.S_pseudosimplitigs.k_9.d_6.M_runs
yeast	pseudosimplitigs	9	6	zeros	131071	134823	131071	3752	2787	15428	3816	19244	19720	yeast.S_pseudosimplitigs.k_9.d_6.M_zeros
yeast	pseudosimplitigs	9	7	default	131071	134825	131071	3754	2886	15416	3468	18884	19608	yeast.S_pseudosimplitigs.k_9.d_7.M_default
yeast	pseudosimplitigs	9	7	ones	131071	134825	134816	9	2	15416	164	15580	15440	yeast.S_pseudosimplitigs.k_9.d_7.M_ones
yeast	pseudosimplitigs	9	7	runs	131071	134825	134816	9	2	15416	164	15580	15440	yeast.S_pseudosimplitigs.k_9.d_7.M_runs
yeast	pseudosimplitigs	9	7	zeros	131071	134825	131071	3754	2789	15416	3820	19236	19704	yeast.S_pseudosimplitigs.k_9.d_7.M_zeros
yeast	pseudosimplitigs	9	8	default	131071	134825	131071	3754	2886	15416	3468	18884	19608	yeast.S_pseudosimplitigs.k_9.d_8.M_default
yeast	pseudosimplitigs	9	8	ones	131071	134825	134816	9	2	15416	164	15580	15440	yeast.S_pseudosimplitigs.k_9.d_8.M_ones
yeast	pseudosimplitigs	9	8	runs	131071	134825	134816	9	2	15416	164	15580	15440	yeast.S_pseudosimplitigs.k_9.d_8.M_runs
yeast	pseudosimplitigs	9	8	zeros	131071	134825	131071	3754	2789	15416	3820	19236	19704	yeast.S_pseudosimplitigs.k_9.d_8.M_zeros
yeast	pseudosimplitigsAC	9	1	default	131071	131135	131071	64	8	36784	180	36964	36828	yeast.S_pseudosimplitigsAC.k_9.d_1.M_default
yeast	pseudosimplitigsAC	9	1	ones	131071	131135	131127	8	1	36784	156	36940	36792	yeast.S_pseudosimplitigsAC.k_9.d_1.M_ones
yeast	pseudosimplitigsAC	9	1	runs	131071	131135	131127	8	1	36784	156	36940	36792	yeast.S_pseudosimplitigsAC.k_9.d_1.M_runs
yeast	pseudosimplitigsAC	9	1	zeros	131071	131135	131071	64	10	36784	192	36976	36832	yeast.S_pseudosimplitigsAC.k_9.d_1.M_zeros
yeast	pseudosimplitigsAC	9	2	default	131071	131128	131071	57	8	36784	180	36964	36828	yeast.S_pseudosimplitigsAC.k_9.d_2.M_default
yeast	pseudosimplitigsAC	9	2	ones	131071	131128	131120	8	1	36784	156	36940	36792	yeast.S_pseudosimplitigsAC.k_9.d_2.M_ones
yeast	pseudosimplitigsAC	9	2	runs	131071	131128	131120	8	1	36784	156	36940	36792	yeast.S_pseudosimplitigsAC.k_9.d_2.M_runs
yeast	pseudosimplitigsAC	9	2	zeros	131071	131128	131071	57	10	36784	188	36972	36828	yeast.S_pseudosimplitigsAC.k_9.d_2.M_zeros
yeast	pseudosimplitigsAC	9	3	default	131071	131105	131071	34	5	36780	176	36956	36808	yeast.S_pseudosimplitigsAC.k_9.d_3.M_default
yeast	pseudosimplitigsAC	9	3	ones	131071	131105	131097	8	1	36780	156	36936	36788	yeast.S_pseudosimplitigsAC.k_9.d_3.M_ones
yeast	pseudosimplitigsAC	9	3	runs	131071	131105	131097	8	1	36780	156	36936	36788	yeast.S_pseudosimplitigsAC.k_9.d_3.M_runs
yeast	pseudosimplitigsAC	9	3	zeros	131071	131105	131071	34	5	36780	176	36956	36808	yeast.S_pseudosimplitigsAC.k_9.d_3.M_zeros
yeast	pseudosimplitigsAC	9	4	default	131071	131100	131071	29	5	36804	172	36976	36832	yeast.S_pseudosimplitigsAC.k_9.d_4.M_default
yeast	pseudosimplitigsAC	9	4	ones	131071	131100	131092	8	1	36804	156	36960	36812	yeast.S_pseudosimplitigsAC.k_9.d_4.M_ones
yeast	pseudosimplitigsAC	9	4	runs	131071	131100	131092	8	1	36804	156	36960	36812	yeast.S_pseudosimplitigsAC.k_9.d_4.M_runs
yeast	pseudosimplitigsAC	9	4	zeros	131071	131100	131071	29	6	36804	176	36980	36836	yeast.S_pseudosimplitigsAC.k_9.d_4.M_zeros
yeast	pseudosimplitigsAC	9	5	default	131071	131100	131071	29	5	36804	172	36976	36832	yeast.S_pseudosimplitigsAC.k_9.d_5.M_default
yeast	pseudosimplitigsAC	9	5	ones	131071	131100	131092	8	1	36804	156	36960	36812	yeast.S_pseudosimplitigsAC.k_9.d_5.M_ones
yeast	pseudosimplitigsAC	9	5	runs	131071	131100	131092	8	1	36804	156	36960	36812	yeast.S_pseudosimplitigsAC.k_9.d_5.M_runs
yeast	pseudosimplitigsAC	9	5	zeros	131071	131100	131071	29	6	36804	176	36980	36836	yeast.S_pseudosimplitigsAC.k_9.d_5.M_zeros
yeast	pseudosimplitigsAC	9	6	default	131071	131100	131071	29	5	36804	172	36976	36832	yeast.S_pseudosimplitigsAC.k_9.d_6.M_default
yeast	pseudosimplitigsAC	9	6	ones	131071	131100	131092	8	1	36804	156	36960	36812	yeast.S_pseudosimplitigsAC.k_9.d_6.M_ones
yeast	pseudosimplitigsAC	9	6	runs	131071	131100	131092	8	1	36804	156	36960	36812	yeast.S_pseudosimplitigsAC.k_9.d_6.M_runs
yeast	pseudosimplitigsAC	9	6	zeros	131071	131100	131071	29	6	36804	176	36980	36836	yeast.S_pseudosimplitigsAC.k_9.d_6.M_zeros
yeast	pseudosimplitigsAC	9	7	default	131071	131096	131071	25	5	36800	172	36972	36828	yeast.S_pseudosimplitigsAC.k_9.d_7.M_default
yeast	pseudosimplitigsAC	9	7	ones	131071	131096	131088	8	1	36800	156	36956	36808	yeast.S_pseudosimplitigsAC.k_9.d_7.M_ones
yeast	pseudosimplitigsAC	9	7	runs	131071	131096	131088	8	1	36800	156	36956	36808	yeast.S_pseudosimplitigsAC.k_9.d_7.M_runs
yeast	pseudosimplitigsAC	9	7	zeros	131071	131096	131071	25	6	36800	176	36976	36832	yeast.S_pseudosimplitigsAC.k_9.d_7.M_zeros
yeast	pseudosimplitigsAC	9	8	default	131071	131096	131071	25	5	36800	172	36972	36828	yeast.S_pseudosimplitigsAC.k_9.d_8.M_default
yeast	pseudosimplitigsAC	9	8	ones	131071	131096	131088	8	1	36800	156	36956	36808	yeast.S_pseudosimplitigsAC.k_9.d_8.M_ones
yeast	pseudosimplitigsAC	9	8	runs	131071	131096	131088	8	1	36800	156	36956	36808	yeast.S_pseudosimplitigsAC.k_9.d_8.M_runs
yeast	pseudosimplitigsAC	9	8	zeros	131071	131096	131071	25	6	36800	176	36976	36832	yeast.S_pseudosimplitigsAC.k_9.d_8.M_zeros
yeast	pseudosimplitigs	10	1	default	521542	560962	521542	39420	4380	70160	6176	76336	81188	yeast.S_pseudosimplitigs.k_10.d_1.M_default
yeast	pseudosimplitigs	10	1	ones	521542	560962	558613	2349	2016	70160	4152	74312	72364	yeast.S_pseudosimplitigs.k_10.d_1.M_ones
yeast	pseudosimplitigs	10	1	runs	521542	560962	556595	4367	1462	70160	4008	74168	72724	yeast.S_pseudosimplitigs.k_10.d_1.M_runs
yeast	pseudosimplitigs	10	1	zeros	521542	560962	521542	39420	7959	70160	11752	81912	85376	yeast.S_pseudosimplitigs.k_10.d_1.M_zeros
yeast	pseudosimplitigs	10	2	default	521542	544687	521542	23145	7169	63620	9808	73428	75792	yeast.S_pseudosimplitigs.k_10.d_2.M_default
yeast	pseudosimplitigs	10	2	ones	521542	544687	542726	1961	1855	63620	4448	68068	66156	yeast.S_pseudosimplitigs.k_10.d_2.M_ones
yeast	pseudosimplitigs	10	2	runs	521542	544687	542432	2255	1747	63620	4460	68080	66236	yeast.S_pseudosimplitigs.k_10.d_2.M_runs
yeast	pseudosimplitigs	10	2	zeros	521542	544687	521542	23145	7338	63620	10508	74128	76020	yeast.S_pseudosimplitigs.k_10.d_2.M_zeros
yeast	pseudosimplitigs	10	3	default	521542	538409	521542	16867	7688	61988	10596	72584	72968	yeast.S_pseudosimplitigs.k_10.d_3.M_default
yeast	pseudosimplitigs	10	3	ones	521542	538409	536483	1926	1815	61988	4408	66396	63884	yeast.S_pseudosimplitigs.k_10.d_3.M_ones
yeast	pseudosimplitigs	10	3	runs	521542	538409	536350	2059	1767	61988	4424	66412	63936	yeast.S_pseudosimplitigs.k_10.d_3.M_runs
yeast	pseudosimplitigs	10	3	zeros	521542	538409	521542	16867	7340	61988	10444	72432	72312	yeast.S_pseudosimplitigs.k_10.d_3.M_zeros
yeast	pseudosimplitigs	10	4	default	521542	539119	521542	17577	9571	61760	11980	73740	74416	yeast.S_pseudosimplitigs.k_10.d_4.M_default
yeast	pseudosimplitigs	10	4	ones	521542	539119	537291	1828	1726	61760	4276	66036	63736	yeast.S_pseudosimplitigs.k_10.d_4.M_ones
yeast	pseudosimplitigs	10	4	runs	521542	539119	537215	1904	1691	61760	4300	66060	63752	yeast.S_pseudosimplitigs.k_10.d_4.M_runs
yeast	pseudosimplitigs	10	4	zeros	521542	539119	521542	17577	9212	61760	11972	73732	74388	yeast.S_pseudosimplitigs.k_10.d_4.M_zeros
yeast	pseudosimplitigs	10	5	default	521542	539886	521542	18344	10705	62160	12548	74708	76124	yeast.S_pseudosimplitigs.k_10.d_5.M_default
yeast	pseudosimplitigs	10	5	ones	521542	539886	538138	1748	1655	62160	4136	66296	63404	yeast.S_pseudosimplitigs.k_10.d_5.M_ones
yeast	pseudosimplitigs	10	5	runs	521542	539886	538109	1777	1634	62160	4152	66312	63376	yeast.S_pseudosimplitigs.k_10.d_5.M_runs
yeast	pseudosimplitigs	10	5	zeros	521542	539886	521542	18344	10574	62160	12928	75088	75504	yeast.S_pseudosimplitigs.k_10.d_5.M_zeros
yeast	pseudosimplitigs	10	6	default	521542	539663	521542	18121	10779	61336	12696	74032	76624	yeast.S_pseudosimplitigs.k_10.d_6.M_default
yeast	pseudosimplitigs	10	6	ones	521542	539663	537894	1769	1674	61336	4204	65540	63492	yeast.S_pseudosimplitigs.k_10.d_6.M_ones
yeast	pseudosimplitigs	10	6	runs	521542	539663	537847	1816	1644	61336	4216	65552	63720	yeast.S_pseudosimplitigs.k_10.d_6.M_runs
yeast	pseudosimplitigs	10	6	zeros	521542	539663	521542	18121	11832	61336	15552	76888	79948	yeast.S_pseudosimplitigs.k_10.d_6.M_zeros
yeast	pseudosimplitigs	10	7	default	521542	539663	521542	18121	10792	61520	12680	74200	76580	yeast.S_pseudosimplitigs.k_10.d_7.M_default
yeast	pseudosimplitigs	10	7	ones	521542	539663	537923	1740	1660	61520	4184	65704	63504	yeast.S_pseudosimplitigs.k_10.d_7.M_ones
yeast	pseudosimplitigs	10	7	runs	521542	539663	537873	1790	1631	61520	4200	65720	63592	yeast.S_pseudosimplitigs.k_10.d_7.M_runs
yeast	pseudosimplitigs	10	7	zeros	521542	539663	521542	18121	12066	61520	15848	77368	80344	yeast.S_pseudosimplitigs.k_10.d_7.M_zeros
yeast	pseudosimplitigs	10	8	default	521542	539663	521542	18121	10801	61568	12700	74268	76552	yeast.S_pseudosimplitigs.k_10.d_8.M_default
yeast	pseudosimplitigs	10	8	ones	521542	539663	537899	1764	1674	61568	4200	65768	64680	yeast.S_pseudosimplitigs.k_10.d_8.M_ones
yeast	pseudosimplitigs	10	8	runs	521542	539663	537839	1824	1643	61568	4212	65780	64020	yeast.S_pseudosimplitigs.k_10.d_8.M_runs
yeast	pseudosimplitigs	10	8	zeros	521542	539663	521542	18121	12219	61568	16156	77724	80492	yeast.S_pseudosimplitigs.k_10.d_8.M_zeros
yeast	pseudosimplitigs	10	9	default	521542	539643	521542	18101	10798	61328	12684	74012	76612	yeast.S_pseudosimplitigs.k_10.d_9.M_default
yeast	pseudosimplitigs	10	9	ones	521542	539643	537898	1745	1662	61328	4172	65500	63604	yeast.S_pseudosimplitigs.k_10.d_9.M_ones
yeast	pseudosimplitigs	10	9	runs	521542	539643	537843	1800	1632	61328	4192	65520	63788	yeast.S_pseudosimplitigs.k_10.d_9.M_runs
yeast	pseudosimplitigs	10	9	zeros	521542	539643	521542	18101	12281	61328	16176	77504	80548	yeast.S_pseudosimplitigs.k_10.d_9.M_zeros
yeast	pseudosimplitigsAC	10	1	default	521542	544969	521542	23427	2603	150944	4572	155516	155364	yeast.S_pseudosimplitigsAC.k_10.d_1.M_default
yeast	pseudosimplitigsAC	10	1	ones	521542	544969	542348	2621	2195	150944	4276	155220	153660	yeast.S_pseudosimplitigsAC.k_10.d_1.M_ones
yeast	pseudosimplitigsAC	10	1	runs	521542	544969	539563	5406	1470	150944	4044	154988	153696	yeast.S_pseudosimplitigsAC.k_10.d_1.M_runs
yeast	pseudosimplitigsAC	10	1	zeros	521542	544969	521542	23427	4592	150944	7708	158652	157388	yeast.S_pseudosimplitigsAC.k_10.d_1.M_zeros
yeast	pseudosimplitigsAC	10	2	default	521542	535918	521542	14376	4296	148812	6836	155648	154224	yeast.S_pseudosimplitigsAC.k_10.d_2.M_default
yeast	pseudosimplitigsAC	10	2	ones	521542	535918	534117	1801	1680	148812	3908	152720	150604	yeast.S_pseudosimplitigsAC.k_10.d_2.M_ones
yeast	pseudosimplitigsAC	10	2	runs	521542	535918	533754	2164	1567	148812	3912	152724	150624	yeast.S_pseudosimplitigsAC.k_10.d_2.M_runs
yeast	pseudosimplitigsAC	10	2	zeros	521542	535918	521542	14376	4425	148812	7184	155996	154100	yeast.S_pseudosimplitigsAC.k_10.d_2.M_zeros
yeast	pseudosimplitigsAC	10	3	default	521542	535409	521542	13867	5135	148660	7760	156420	152744	yeast.S_pseudosimplitigsAC.k_10.d_3.M_default
yeast	pseudosimplitigsAC	10	3	ones	521542	535409	533673	1736	1615	148660	3836	152496	151104	yeast.S_pseudosimplitigsAC.k_10.d_3.M_ones
yeast	pseudosimplitigsAC	10	3	runs	521542	535409	533580	1829	1574	148660	3864	152524	150808	yeast.S_pseudosimplitigsAC.k_10.d_3.M_runs
yeast	pseudosimplitigsAC	10	3	zeros	521542	535409	521542	13867	5161	148660	8288	156948	154620	yeast.S_pseudosimplitigsAC.k_10.d_3.M_zeros
yeast	pseudosimplitigsAC	10	4	default	521542	534709	521542	13167	5579	148412	8196	156608	154524	yeast.S_pseudosimplitigsAC.k_10.d_4.M_default
yeast	pseudosimplitigsAC	10	4	ones	521542	534709	533049	1660	1548	148412	3808	152220	152220	yeast.S_pseudosimplitigsAC.k_10.d_4.M_ones
yeast	pseudosimplitigsAC	10	4	runs	521542	534709	532999	1710	1521	148412	3816	152228	150696	yeast.S_pseudosimplitigsAC.k_10.d_4.M_runs
yeast	pseudosimplitigsAC	10	4	zeros	521542	534709	521542	13167	5675	148412	9004	157416	155812	yeast.S_pseudosimplitigsAC.k_10.d_4.M_zeros
yeast	pseudosimplitigsAC	10	5	default	521542	533842	521542	12300	5738	148104	8292	156396	153752	yeast.S_pseudosimplitigsAC.k_10.d_5.M_default
yeast	pseudosimplitigsAC	10	5	ones	521542	533842	532188	1654	1539	148104	3792	151896	150248	yeast.S_pseudosimplitigsAC.k_10.d_5.M_ones
yeast	pseudosimplitigsAC	10	5	runs	521542	533842	532148	1694	1514	148104	3800	151904	150424	yeast.S_pseudosimplitigsAC.k_10.d_5.M_runs
yeast	pseudosimplitigsAC	10	5	zeros	521542	533842	521542	12300	5864	148104	9184	157288	156480	yeast.S_pseudosimplitigsAC.k_10.d_5.M_zeros
yeast	pseudosimplitigsAC	10	6	default	521542	533523	521542	11981	5787	147324	8324	155648	154192	yeast.S_pseudosimplitigsAC.k_10.d_6.M_default
yeast	pseudosimplitigsAC	10	6	ones	521542	533523	531847	1676	1553	147324	3812	151136	149512	yeast.S_pseudosimplitigsAC.k_10.d_6.M_ones
yeast	pseudosimplitigsAC	10	6	runs	521542	533523	531803	1720	1527	147324	3816	151140	149992	yeast.S_pseudosimplitigsAC.k_10.d_6.M_runs
yeast	pseudosimplitigsAC	10	6	zeros	521542	533523	521542	11981	6084	147324	9744	157068	154628	yeast.S_pseudosimplitigsAC.k_10.d_6.M_zeros
yeast	pseudosimplitigsAC	10	7	default	521542	533483	521542	11941	5798	146624	8356	154980	152712	yeast.S_pseudosimplitigsAC.k_10.d_7.M_default
yeast	pseudosimplitigsAC	10	7	ones	521542	533483	531801	1682	1559	146624	3824	150448	149852	yeast.S_pseudosimplitigsAC.k_10.d_7.M_ones
yeast	pseudosimplitigsAC	10	7	runs	521542	533483	531749	1734	1530	146624	3832	150456	150580	yeast.S_pseudosimplitigsAC.k_10.d_7.M_runs
yeast	pseudosimplitigsAC	10	7	zeros	521542	533483	521542	11941	6144	146624	9892	156516	155480	yeast.S_pseudosimplitigsAC.k_10.d_7.M_zeros
yeast	pseudosimplitigsAC	10	8	default	521542	533431	521542	11889	5798	146616	8364	154980	152688	yeast.S_pseudosimplitigsAC.k_10.d_8.M_default
yeast	pseudosimplitigsAC	10	8	ones	521542	533431	531755	1676	1558	146616	3820	150436	149828	yeast.S_pseudosimplitigsAC.k_10.d_8.M_ones
yeast	pseudosimplitigsAC	10	8	runs	521542	533431	531706	1725	1532	146616	3820	150436	148864	yeast.S_pseudosimplitigsAC.k_10.d_8.M_runs
yeast	pseudosimplitigsAC	10	8	zeros	521542	533431	521542	11889	6143	146616	9904	156520	155464	yeast.S_pseudosimplitigsAC.k_10.d_8.M_zeros
yeast	pseudosimplitigsAC	10	9	default	521542	533433	521542	11891	5798	147964	8364	156328	153820	yeast.S_pseudosimplitigsAC.k_10.d_9.M_default
yeast	pseudosimplitigsAC	10	9	ones	521542	533433	531754	1679	1558	147964	3820	151784	149228	yeast.S_pseudosimplitigsAC.k_10.d_9.M_ones
yeast	pseudosimplitigsAC	10	9	runs	521542	533433	531711	1722	1532	147964	3820	151784	150536	yeast.S_pseudosimplitigsAC.k_10.d_9.M_runs
yeast	pseudosimplitigsAC	10	9	zeros	521542	533433	521542	11891	6194	147964	10052	158016	154368	yeast.S_pseudosimplitigsAC.k_10.d_9.M_zeros
yeast	pseudosimplitigs	11	1	default	1865531	2584771	1865531	719240	71924	570228	68948	639176	666060	yeast.S_pseudosimplitigs.k_11.d_1.M_default
yeast	pseudosimplitigs	11	1	ones	1865531	2584771	2406552	178219	112661	570228	116448	686676	674560	yeast.S_pseudosimplitigs.k_11.d_1.M_ones
yeast	pseudosimplitigs	11	1	runs	1865531	2584771	2245023	339748	57076	570228	92108	662336	656228	yeast.S_pseudosimplitigs.k_11.d_1.M_runs
yeast	pseudosimplitigs	11	1	zeros	1865531	2584771	1865531	719240	118940	570228	129924	700152	712912	yeast.S_pseudosimplitigs.k_11.d_1.M_zeros
yeast	pseudosimplitigs	11	10	default	1865531	2091662	1865531	226131	129542	413040	107544	520584	512612	yeast.S_pseudosimplitigs.k_11.d_10.M_default
yeast	pseudosimplitigs	11	10	ones	1865531	2091662	2016631	75031	63415	413040	74456	487496	474976	yeast.S_pseudosimplitigs.k_11.d_10.M_ones
yeast	pseudosimplitigs	11	10	runs	1865531	2091662	2011215	80447	60254	413040	74600	487640	474244	yeast.S_pseudosimplitigs.k_11.d_10.M_runs
yeast	pseudosimplitigs	11	10	zeros	1865531	2091662	1865531	226131	138716	413040	124124	537164	539972	yeast.S_pseudosimplitigs.k_11.d_10.M_zeros
yeast	pseudosimplitigs	11	2	default	1865531	2223198	1865531	357667	113740	452916	96464	549380	553868	yeast.S_pseudosimplitigs.k_11.d_2.M_default
yeast	pseudosimplitigs	11	2	ones	1865531	2223198	2118527	104671	78810	452916	86276	539192	524648	yeast.S_pseudosimplitigs.k_11.d_2.M_ones
yeast	pseudosimplitigs	11	2	runs	1865531	2223198	2072029	151169	60534	452916	81264	534180	521956	yeast.S_pseudosimplitigs.k_11.d_2.M_runs
yeast	pseudosimplitigs	11	2	zeros	1865531	2223198	1865531	357667	116791	452916	103632	556548	561628	yeast.S_pseudosimplitigs.k_11.d_2.M_zeros
yeast	pseudosimplitigs	11	3	default	1865531	2127465	1865531	261934	119855	426684	101364	528048	526036	yeast.S_pseudosimplitigs.k_11.d_3.M_default
yeast	pseudosimplitigs	11	3	ones	1865531	2127465	2042265	85200	69519	426684	78696	505380	490988	yeast.S_pseudosimplitigs.k_11.d_3.M_ones
yeast	pseudosimplitigs	11	3	runs	1865531	2127465	2024241	103224	61997	426684	77480	504164	490096	yeast.S_pseudosimplitigs.k_11.d_3.M_runs
yeast	pseudosimplitigs	11	3	zeros	1865531	2127465	1865531	261934	119772	426684	102740	529424	525072	yeast.S_pseudosimplitigs.k_11.d_3.M_zeros
yeast	pseudosimplitigs	11	4	default	1865531	2101476	1865531	235945	124468	419448	104272	523720	515692	yeast.S_pseudosimplitigs.k_11.d_4.M_default
yeast	pseudosimplitigs	11	4	ones	1865531	2101476	2023646	77830	65062	419448	74528	493976	478368	yeast.S_pseudosimplitigs.k_11.d_4.M_ones
yeast	pseudosimplitigs	11	4	runs	1865531	2101476	2013955	87521	60602	419448	74388	493836	477780	yeast.S_pseudosimplitigs.k_11.d_4.M_runs
yeast	pseudosimplitigs	11	4	zeros	1865531	2101476	1865531	235945	124089	419448	106536	525984	518648	yeast.S_pseudosimplitigs.k_11.d_4.M_zeros
yeast	pseudosimplitigs	11	5	default	1865531	2095292	1865531	229761	129367	414212	106880	521092	516684	yeast.S_pseudosimplitigs.k_11.d_5.M_default
yeast	pseudosimplitigs	11	5	ones	1865531	2095292	2019809	75483	63699	414212	74204	488416	474072	yeast.S_pseudosimplitigs.k_11.d_5.M_ones
yeast	pseudosimplitigs	11	5	runs	1865531	2095292	2012531	82761	60217	414212	74324	488536	475052	yeast.S_pseudosimplitigs.k_11.d_5.M_runs
yeast	pseudosimplitigs	11	5	zeros	1865531	2095292	1865531	229761	132038	414212	115288	529500	529008	yeast.S_pseudosimplitigs.k_11.d_5.M_zeros
yeast	pseudosimplitigs	11	6	default	1865531	2092089	1865531	226558	129422	413360	107128	520488	514272	yeast.S_pseudosimplitigs.k_11.d_6.M_default
yeast	pseudosimplitigs	11	6	ones	1865531	2092089	2017206	74883	63451	413360	74388	487748	474040	yeast.S_pseudosimplitigs.k_11.d_6.M_ones
yeast	pseudosimplitigs	11	6	runs	1865531	2092089	2011134	80955	60274	413360	74360	487720	473360	yeast.S_pseudosimplitigs.k_11.d_6.M_runs
yeast	pseudosimplitigs	11	6	zeros	1865531	2092089	1865531	226558	133561	413360	118052	531412	532476	yeast.S_pseudosimplitigs.k_11.d_6.M_zeros
yeast	pseudosimplitigs	11	7	default	1865531	2091313	1865531	225782	129553	413196	107208	520404	513460	yeast.S_pseudosimplitigs.k_11.d_7.M_default
yeast	pseudosimplitigs	11	7	ones	1865531	2091313	2016507	74806	63394	413196	74416	487612	474988	yeast.S_pseudosimplitigs.k_11.d_7.M_ones
yeast	pseudosimplitigs	11	7	runs	1865531	2091313	2010865	80448	60264	413196	74576	487772	474756	yeast.S_pseudosimplitigs.k_11.d_7.M_runs
yeast	pseudosimplitigs	11	7	zeros	1865531	2091313	1865531	225782	138727	413196	123808	537004	540732	yeast.S_pseudosimplitigs.k_11.d_7.M_zeros
yeast	pseudosimplitigs	11	8	default	1865531	2091383	1865531	225852	129602	413176	107360	520536	513216	yeast.S_pseudosimplitigs.k_11.d_8.M_default
yeast	pseudosimplitigs	11	8	ones	1865531	2091383	2016403	74980	63354	413176	74408	487584	475020	yeast.S_pseudosimplitigs.k_11.d_8.M_ones
yeast	pseudosimplitigs	11	8	runs	1865531	2091383	2011021	80362	60286	413176	74552	487728	473964	yeast.S_pseudosimplitigs.k_11.d_8.M_runs
yeast	pseudosimplitigs	11	8	zeros	1865531	2091383	1865531	225852	138775	413176	123968	537144	540508	yeast.S_pseudosimplitigs.k_11.d_8.M_zeros
yeast	pseudosimplitigs	11	9	default	1865531	2091359	1865531	225828	129585	413036	107528	520564	512816	yeast.S_pseudosimplitigs.k_11.d_9.M_default
yeast	pseudosimplitigs	11	9	ones	1865531	2091359	2016426	74933	63330	413036	74424	487460	474908	yeast.S_pseudosimplitigs.k_11.d_9.M_ones
yeast	pseudosimplitigs	11	9	runs	1865531	2091359	2011084	80275	60221	413036	74496	487532	474280	yeast.S_pseudosimplitigs.k_11.d_9.M_runs
yeast	pseudosimplitigs	11	9	zeros	1865531	2091359	1865531	225828	138759	413036	124104	537140	540196	yeast.S_pseudosimplitigs.k_11.d_9.M_zeros
yeast	pseudosimplitigsAC	11	1	default	1865531	2579791	1865531	714260	71426	702696	67088	769784	795772	yeast.S_pseudosimplitigsAC.k_11.d_1.M_default
yeast	pseudosimplitigsAC	11	1	ones	1865531	2579791	2398981	180810	114127	702696	115908	818604	804320	yeast.S_pseudosimplitigsAC.k_11.d_1.M_ones
yeast	pseudosimplitigsAC	11	1	runs	1865531	2579791	2232718	347073	57097	702696	92348	795044	785364	yeast.S_pseudosimplitigsAC.k_11.d_1.M_runs
yeast	pseudosimplitigsAC	11	1	zeros	1865531	2579791	1865531	714260	125702	702696	129748	832444	837596	yeast.S_pseudosimplitigsAC.k_11.d_1.M_zeros
yeast	pseudosimplitigsAC	11	10	default	1865531	2070462	1865531	204931	123794	565324	96092	661416	650696	yeast.S_pseudosimplitigsAC.k_11.d_10.M_default
yeast	pseudosimplitigsAC	11	10	ones	1865531	2070462	2001952	68510	57660	565324	65168	630492	617180	yeast.S_pseudosimplitigsAC.k_11.d_10.M_ones
yeast	pseudosimplitigsAC	11	10	runs	1865531	2070462	1998611	71851	55500	565324	65072	630396	616712	yeast.S_pseudosimplitigsAC.k_11.d_10.M_runs
yeast	pseudosimplitigsAC	11	10	zeros	1865531	2070462	1865531	204931	126642	565324	104888	670212	655148	yeast.S_pseudosimplitigsAC.k_11.d_10.M_zeros
yeast	pseudosimplitigsAC	11	2	default	1865531	2230034	1865531	364503	111792	609376	88744	698120	704192	yeast.S_pseudosimplitigsAC.k_11.d_2.M_default
yeast	pseudosimplitigsAC	11	2	ones	1865531	2230034	2130429	99605	74376	609376	79276	688652	674964	yeast.S_pseudosimplitigsAC.k_11.d_2.M_ones
yeast	pseudosimplitigsAC	11	2	runs	1865531	2230034	2084588	145446	56459	609376	74500	683876	672552	yeast.S_pseudosimplitigsAC.k_11.d_2.M_runs
yeast	pseudosimplitigsAC	11	2	zeros	1865531	2230034	1865531	364503	115299	609376	96104	705480	705824	yeast.S_pseudosimplitigsAC.k_11.d_2.M_zeros
yeast	pseudosimplitigsAC	11	3	default	1865531	2129548	1865531	264017	121128	582352	94188	676540	670332	yeast.S_pseudosimplitigsAC.k_11.d_3.M_default
yeast	pseudosimplitigsAC	11	3	ones	1865531	2129548	2053512	76036	62014	582352	68944	651296	636296	yeast.S_pseudosimplitigsAC.k_11.d_3.M_ones
yeast	pseudosimplitigsAC	11	3	runs	1865531	2129548	2038560	90988	55695	582352	68144	650496	636076	yeast.S_pseudosimplitigsAC.k_11.d_3.M_runs
yeast	pseudosimplitigsAC	11	3	zeros	1865531	2129548	1865531	264017	121292	582352	95240	677592	670812	yeast.S_pseudosimplitigsAC.k_11.d_3.M_zeros
yeast	pseudosimplitigsAC	11	4	default	1865531	2091506	1865531	225975	123426	571272	95516	666788	657300	yeast.S_pseudosimplitigsAC.k_11.d_4.M_default
yeast	pseudosimplitigsAC	11	4	ones	1865531	2091506	2022301	69205	58201	571272	65760	637032	623900	yeast.S_pseudosimplitigsAC.k_11.d_4.M_ones
yeast	pseudosimplitigsAC	11	4	runs	1865531	2091506	2016225	75281	55212	571272	65824	637096	623316	yeast.S_pseudosimplitigsAC.k_11.d_4.M_runs
yeast	pseudosimplitigsAC	11	4	zeros	1865531	2091506	1865531	225975	124906	571272	101348	672620	660464	yeast.S_pseudosimplitigsAC.k_11.d_4.M_zeros
yeast	pseudosimplitigsAC	11	5	default	1865531	2076851	1865531	211320	123644	562744	95572	658316	651760	yeast.S_pseudosimplitigsAC.k_11.d_5.M_default
yeast	pseudosimplitigsAC	11	5	ones	1865531	2076851	2009113	67738	57381	562744	64860	627604	617764	yeast.S_pseudosimplitigsAC.k_11.d_5.M_ones
yeast	pseudosimplitigsAC	11	5	runs	1865531	2076851	2005251	71600	55165	562744	65072	627816	620036	yeast.S_pseudosimplitigsAC.k_11.d_5.M_runs
yeast	pseudosimplitigsAC	11	5	zeros	1865531	2076851	1865531	211320	125149	562744	101656	664400	656232	yeast.S_pseudosimplitigsAC.k_11.d_5.M_zeros
yeast	pseudosimplitigsAC	11	6	default	1865531	2072818	1865531	207287	123762	566728	95716	662444	650068	yeast.S_pseudosimplitigsAC.k_11.d_6.M_default
yeast	pseudosimplitigsAC	11	6	ones	1865531	2072818	2005149	67669	57409	566728	64844	631572	617944	yeast.S_pseudosimplitigsAC.k_11.d_6.M_ones
yeast	pseudosimplitigsAC	11	6	runs	1865531	2072818	2001769	71049	55336	566728	65044	631772	617696	yeast.S_pseudosimplitigsAC.k_11.d_6.M_runs
yeast	pseudosimplitigsAC	11	6	zeros	1865531	2072818	1865531	207287	126262	566728	103868	670596	655696	yeast.S_pseudosimplitigsAC.k_11.d_6.M_zeros
yeast	pseudosimplitigsAC	11	7	default	1865531	2071191	1865531	205660	123763	566212	95840	662052	649400	yeast.S_pseudosimplitigsAC.k_11.d_7.M_default
yeast	pseudosimplitigsAC	11	7	ones	1865531	2071191	2003308	67883	57388	566212	64796	631008	617436	yeast.S_pseudosimplitigsAC.k_11.d_7.M_ones
yeast	pseudosimplitigsAC	11	7	runs	1865531	2071191	2000128	71063	55345	566212	64968	631180	612296	yeast.S_pseudosimplitigsAC.k_11.d_7.M_runs
yeast	pseudosimplitigsAC	11	7	zeros	1865531	2071191	1865531	205660	126268	566212	104012	670224	655064	yeast.S_pseudosimplitigsAC.k_11.d_7.M_zeros
yeast	pseudosimplitigsAC	11	8	default	1865531	2070665	1865531	205134	123774	565416	95996	661412	650912	yeast.S_pseudosimplitigsAC.k_11.d_8.M_default
yeast	pseudosimplitigsAC	11	8	ones	1865531	2070665	2002564	68101	57520	565416	65068	630484	617196	yeast.S_pseudosimplitigsAC.k_11.d_8.M_ones
yeast	pseudosimplitigsAC	11	8	runs	1865531	2070665	1999386	71279	55453	565416	65056	630472	616740	yeast.S_pseudosimplitigsAC.k_11.d_8.M_runs
yeast	pseudosimplitigsAC	11	8	zeros	1865531	2070665	1865531	205134	126622	565416	104792	670208	655348	yeast.S_pseudosimplitigsAC.k_11.d_8.M_zeros
yeast	pseudosimplitigsAC	11	9	default	1865531	2070523	1865531	204992	123782	565348	96064	661412	650768	yeast.S_pseudosimplitigsAC.k_11.d_9.M_default
yeast	pseudosimplitigsAC	11	9	ones	1865531	2070523	2002244	68279	57600	565348	65124	630472	617168	yeast.S_pseudosimplitigsAC.k_11.d_9.M_ones
yeast	pseudosimplitigsAC	11	9	runs	1865531	2070523	1998908	71615	55465	565348	65096	630444	617144	yeast.S_pseudosimplitigsAC.k_11.d_9.M_runs
yeast	pseudosimplitigsAC	11	9	zeros	1865531	2070523	1865531	204992	126630	565348	104860	670208	655220	yeast.S_pseudosimplitigsAC.k_11.d_9.M_zeros
yeast	pseudosimplitigs	12	1	default	4774876	9132031	4774876	4357155	396105	2332624	295280	2627904	2795312	yeast.S_pseudosimplitigs.k_12.d_1.M_default
yeast	pseudosimplitigs	12	1	ones	4774876	9132031	7446657	1685374	806257	2332624	724664	3057288	3050972	yeast.S_pseudosimplitigs.k_12.d_1.M_ones
yeast	pseudosimplitigs	12	1	runs	4774876	9132031	6302821	2829210	351484	2332624	484060	2816684	2832372	yeast.S_pseudosimplitigs.k_12.d_1.M_runs
yeast	pseudosimplitigs	12	1	zeros	4774876	9132031	4774876	4357155	635011	2332624	602812	2935436	3014108	yeast.S_pseudosimplitigs.k_12.d_1.M_zeros
yeast	pseudosimplitigs	12	10	default	4774876	5916686	4774876	1141810	692415	1450400	460468	1910868	1889612	yeast.S_pseudosimplitigs.k_12.d_10.M_default
yeast	pseudosimplitigs	12	10	ones	4774876	5916686	5403194	513492	383612	1450400	337128	1787528	1772940	yeast.S_pseudosimplitigs.k_12.d_10.M_ones
yeast	pseudosimplitigs	12	10	runs	4774876	5916686	5372124	544562	362614	1450400	335712	1786112	1770504	yeast.S_pseudosimplitigs.k_12.d_10.M_runs
yeast	pseudosimplitigs	12	10	zeros	4774876	5916686	4774876	1141810	699549	1450400	467236	1917636	1900584	yeast.S_pseudosimplitigs.k_12.d_10.M_zeros
yeast	pseudosimplitigs	12	11	default	4774876	5917495	4774876	1142619	692408	1450520	460444	1910964	1889392	yeast.S_pseudosimplitigs.k_12.d_11.M_default
yeast	pseudosimplitigs	12	11	ones	4774876	5917495	5403667	513828	383765	1450520	337224	1787744	1773144	yeast.S_pseudosimplitigs.k_12.d_11.M_ones
yeast	pseudosimplitigs	12	11	runs	4774876	5917495	5372255	545240	362608	1450520	335672	1786192	1770152	yeast.S_pseudosimplitigs.k_12.d_11.M_runs
yeast	pseudosimplitigs	12	11	zeros	4774876	5917495	4774876	1142619	699543	1450520	467216	1917736	1900388	yeast.S_pseudosimplitigs.k_12.d_11.M_zeros
yeast	pseudosimplitigs	12	2	default	4774876	6981785	4774876	2206909	599179	1745976	401716	2147692	2222932	yeast.S_pseudosimplitigs.k_12.d_2.M_default
yeast	pseudosimplitigs	12	2	ones	4774876	6981785	6039850	941935	537767	1745976	477880	2223856	2208180	yeast.S_pseudosimplitigs.k_12.d_2.M_ones
yeast	pseudosimplitigs	12	2	runs	4774876	6981785	5624755	1357030	355488	1745976	394376	2140352	2146936	yeast.S_pseudosimplitigs.k_12.d_2.M_runs
yeast	pseudosimplitigs	12	2	zeros	4774876	6981785	4774876	2206909	620455	1745976	447948	2193924	2245856	yeast.S_pseudosimplitigs.k_12.d_2.M_zeros
yeast	pseudosimplitigs	12	3	default	4774876	6307873	4774876	1532997	652267	1561020	430576	1991596	2016668	yeast.S_pseudosimplitigs.k_12.d_3.M_default
yeast	pseudosimplitigs	12	3	ones	4774876	6307873	5622584	685289	451997	1561020	396436	1957456	1941280	yeast.S_pseudosimplitigs.k_12.d_3.M_ones
yeast	pseudosimplitigs	12	3	runs	4774876	6307873	5447682	860191	370839	1561020	367648	1928668	1921752	yeast.S_pseudosimplitigs.k_12.d_3.M_runs
yeast	pseudosimplitigs	12	3	zeros	4774876	6307873	4774876	1532997	653803	1561020	437504	1998524	2017932	yeast.S_pseudosimplitigs.k_12.d_3.M_zeros
yeast	pseudosimplitigs	12	4	default	4774876	6043842	4774876	1268966	685112	1488372	451028	1939400	1933868	yeast.S_pseudosimplitigs.k_12.d_4.M_default
yeast	pseudosimplitigs	12	4	ones	4774876	6043842	5488353	555489	396828	1488372	351592	1839964	1820832	yeast.S_pseudosimplitigs.k_12.d_4.M_ones
yeast	pseudosimplitigs	12	4	runs	4774876	6043842	5410285	633557	357383	1488372	341752	1830124	1813628	yeast.S_pseudosimplitigs.k_12.d_4.M_runs
yeast	pseudosimplitigs	12	4	zeros	4774876	6043842	4774876	1268966	685132	1488372	451976	1940348	1933684	yeast.S_pseudosimplitigs.k_12.d_4.M_zeros
yeast	pseudosimplitigs	12	5	default	4774876	5957532	4774876	1182656	691551	1464676	457004	1921680	1904272	yeast.S_pseudosimplitigs.k_12.d_5.M_default
yeast	pseudosimplitigs	12	5	ones	4774876	5957532	5430592	526940	388829	1464676	341444	1806120	1787312	yeast.S_pseudosimplitigs.k_12.d_5.M_ones
yeast	pseudosimplitigs	12	5	runs	4774876	5957532	5383389	574143	361785	1464676	337468	1802144	1785016	yeast.S_pseudosimplitigs.k_12.d_5.M_runs
yeast	pseudosimplitigs	12	5	zeros	4774876	5957532	4774876	1182656	691804	1464676	457452	1922128	1905092	yeast.S_pseudosimplitigs.k_12.d_5.M_zeros
yeast	pseudosimplitigs	12	6	default	4774876	5928311	4774876	1153435	692230	1455152	458664	1913816	1895484	yeast.S_pseudosimplitigs.k_12.d_6.M_default
yeast	pseudosimplitigs	12	6	ones	4774876	5928311	5411125	517186	385545	1455152	338496	1793648	1776072	yeast.S_pseudosimplitigs.k_12.d_6.M_ones
yeast	pseudosimplitigs	12	6	runs	4774876	5928311	5374231	554080	362494	1455152	336596	1791748	1776320	yeast.S_pseudosimplitigs.k_12.d_6.M_runs
yeast	pseudosimplitigs	12	6	zeros	4774876	5928311	4774876	1153435	695161	1455152	461536	1916688	1900604	yeast.S_pseudosimplitigs.k_12.d_6.M_zeros
yeast	pseudosimplitigs	12	7	default	4774876	5918819	4774876	1143943	692316	1450976	459488	1910464	1889324	yeast.S_pseudosimplitigs.k_12.d_7.M_default
yeast	pseudosimplitigs	12	7	ones	4774876	5918819	5404262	514557	384142	1450976	337504	1788480	1774364	yeast.S_pseudosimplitigs.k_12.d_7.M_ones
yeast	pseudosimplitigs	12	7	runs	4774876	5918819	5371633	547186	362559	1450976	335672	1786648	1773668	yeast.S_pseudosimplitigs.k_12.d_7.M_runs
yeast	pseudosimplitigs	12	7	zeros	4774876	5918819	4774876	1143943	698562	1450976	465564	1916540	1901244	yeast.S_pseudosimplitigs.k_12.d_7.M_zeros
yeast	pseudosimplitigs	12	8	default	4774876	5916515	4774876	1141639	692384	1450340	460048	1910388	1889036	yeast.S_pseudosimplitigs.k_12.d_8.M_default
yeast	pseudosimplitigs	12	8	ones	4774876	5916515	5403297	513218	383717	1450340	337092	1787432	1773256	yeast.S_pseudosimplitigs.k_12.d_8.M_ones
yeast	pseudosimplitigs	12	8	runs	4774876	5916515	5372075	544440	362639	1450340	335596	1785936	1771044	yeast.S_pseudosimplitigs.k_12.d_8.M_runs
yeast	pseudosimplitigs	12	8	zeros	4774876	5916515	4774876	1141639	699388	1450340	466624	1916964	1902808	yeast.S_pseudosimplitigs.k_12.d_8.M_zeros
yeast	pseudosimplitigs	12	9	default	4774876	5916368	4774876	1141492	692420	1450100	460324	1910424	1888396	yeast.S_pseudosimplitigs.k_12.d_9.M_default
yeast	pseudosimplitigs	12	9	ones	4774876	5916368	5402846	513522	383670	1450100	337100	1787200	1773148	yeast.S_pseudosimplitigs.k_12.d_9.M_ones
yeast	pseudosimplitigs	12	9	runs	4774876	5916368	5371784	544584	362685	1450100	335600	1785700	1771492	yeast.S_pseudosimplitigs.k_12.d_9.M_runs
yeast	pseudosimplitigs	12	9	zeros	4774876	5916368	4774876	1141492	699428	1450100	466884	1916984	1902180	yeast.S_pseudosimplitigs.k_12.d_9.M_zeros
yeast	pseudosimplitigsAC	12	1	default	4774876	9131954	4774876	4357078	396098	2475940	280252	2756192	2914440	yeast.S_pseudosimplitigsAC.k_12.d_1.M_default
yeast	pseudosimplitigsAC	12	1	ones	4774876	9131954	7433030	1698924	812678	2475940	717328	3193268	3151028	yeast.S_pseudosimplitigsAC.k_12.d_1.M_ones
yeast	pseudosimplitigsAC	12	1	runs	4774876	9131954	6252818	2879136	349836	2475940	479524	2955464	2934064	yeast.S_pseudosimplitigsAC.k_12.d_1.M_runs
yeast	pseudosimplitigsAC	12	1	zeros	4774876	9131954	4774876	4357078	676608	2475940	602508	3078448	3118272	yeast.S_pseudosimplitigsAC.k_12.d_1.M_zeros
yeast	pseudosimplitigsAC	12	10	default	4774876	5842743	4774876	1067867	639107	1561828	392380	1954208	1949812	yeast.S_pseudosimplitigsAC.k_12.d_10.M_default
yeast	pseudosimplitigsAC	12	10	ones	4774876	5842743	5361406	481337	362691	1561828	312572	1874400	1855748	yeast.S_pseudosimplitigsAC.k_12.d_10.M_ones
yeast	pseudosimplitigsAC	12	10	runs	4774876	5842743	5336009	506734	345130	1561828	311796	1873624	1855308	yeast.S_pseudosimplitigsAC.k_12.d_10.M_runs
yeast	pseudosimplitigsAC	12	10	zeros	4774876	5842743	4774876	1067867	659643	1561828	434348	1996176	1985544	yeast.S_pseudosimplitigsAC.k_12.d_10.M_zeros
yeast	pseudosimplitigsAC	12	11	default	4774876	5842623	4774876	1067747	639127	1561736	392464	1954200	1949424	yeast.S_pseudosimplitigsAC.k_12.d_11.M_default
yeast	pseudosimplitigsAC	12	11	ones	4774876	5842623	5360320	482303	362897	1561736	312668	1874404	1855656	yeast.S_pseudosimplitigsAC.k_12.d_11.M_ones
yeast	pseudosimplitigsAC	12	11	runs	4774876	5842623	5334742	507881	345186	1561736	311744	1873480	1854976	yeast.S_pseudosimplitigsAC.k_12.d_11.M_runs
yeast	pseudosimplitigsAC	12	11	zeros	4774876	5842623	4774876	1067747	659664	1561736	434436	1996172	1985168	yeast.S_pseudosimplitigsAC.k_12.d_11.M_zeros
yeast	pseudosimplitigsAC	12	2	default	4774876	6988213	4774876	2213337	586847	1869796	368472	2238268	2318720	yeast.S_pseudosimplitigsAC.k_12.d_2.M_default
yeast	pseudosimplitigsAC	12	2	ones	4774876	6988213	6071752	916461	517054	1869796	451064	2320860	2305416	yeast.S_pseudosimplitigsAC.k_12.d_2.M_ones
yeast	pseudosimplitigsAC	12	2	runs	4774876	6988213	5659726	1328487	337288	1869796	368120	2237916	2244688	yeast.S_pseudosimplitigsAC.k_12.d_2.M_runs
yeast	pseudosimplitigsAC	12	2	zeros	4774876	6988213	4774876	2213337	609613	1869796	415024	2284820	2338856	yeast.S_pseudosimplitigsAC.k_12.d_2.M_zeros
yeast	pseudosimplitigsAC	12	3	default	4774876	6259537	4774876	1484661	634196	1675368	388060	2063428	2091912	yeast.S_pseudosimplitigsAC.k_12.d_3.M_default
yeast	pseudosimplitigsAC	12	3	ones	4774876	6259537	5614473	645064	419593	1675368	362428	2037796	2020224	yeast.S_pseudosimplitigsAC.k_12.d_3.M_ones
yeast	pseudosimplitigsAC	12	3	runs	4774876	6259537	5453513	806024	343806	1675368	335008	2010376	2003260	yeast.S_pseudosimplitigsAC.k_12.d_3.M_runs
yeast	pseudosimplitigsAC	12	3	zeros	4774876	6259537	4774876	1484661	635296	1675368	395460	2070828	2089920	yeast.S_pseudosimplitigsAC.k_12.d_3.M_zeros
yeast	pseudosimplitigsAC	12	4	default	4774876	5979180	4774876	1204304	637831	1624208	389448	2013656	1995356	yeast.S_pseudosimplitigsAC.k_12.d_4.M_default
yeast	pseudosimplitigsAC	12	4	ones	4774876	5979180	5440340	538840	382321	1624208	329848	1954056	1912704	yeast.S_pseudosimplitigsAC.k_12.d_4.M_ones
yeast	pseudosimplitigsAC	12	4	runs	4774876	5979180	5369461	609719	345509	1624208	319976	1944184	1904608	yeast.S_pseudosimplitigsAC.k_12.d_4.M_runs
yeast	pseudosimplitigsAC	12	4	zeros	4774876	5979180	4774876	1204304	642422	1624208	408572	2032780	2010308	yeast.S_pseudosimplitigsAC.k_12.d_4.M_zeros
yeast	pseudosimplitigsAC	12	5	default	4774876	5885720	4774876	1110844	638957	1570276	390340	1960616	1965060	yeast.S_pseudosimplitigsAC.k_12.d_5.M_default
yeast	pseudosimplitigsAC	12	5	ones	4774876	5885720	5386636	499084	368812	1570276	318000	1888276	1873044	yeast.S_pseudosimplitigsAC.k_12.d_5.M_ones
yeast	pseudosimplitigsAC	12	5	runs	4774876	5885720	5346824	538896	345256	1570276	314472	1884748	1877844	yeast.S_pseudosimplitigsAC.k_12.d_5.M_runs
yeast	pseudosimplitigsAC	12	5	zeros	4774876	5885720	4774876	1110844	656073	1570276	428720	1998996	1998824	yeast.S_pseudosimplitigsAC.k_12.d_5.M_zeros
yeast	pseudosimplitigsAC	12	6	default	4774876	5855946	4774876	1081070	639064	1590148	391160	1981308	1949456	yeast.S_pseudosimplitigsAC.k_12.d_6.M_default
yeast	pseudosimplitigsAC	12	6	ones	4774876	5855946	5368872	487074	364567	1590148	314112	1904260	1867152	yeast.S_pseudosimplitigsAC.k_12.d_6.M_ones
yeast	pseudosimplitigsAC	12	6	runs	4774876	5855946	5339190	516756	345210	1590148	312444	1902592	1860320	yeast.S_pseudosimplitigsAC.k_12.d_6.M_runs
yeast	pseudosimplitigsAC	12	6	zeros	4774876	5855946	4774876	1081070	658085	1590148	431280	2021428	1990196	yeast.S_pseudosimplitigsAC.k_12.d_6.M_zeros
yeast	pseudosimplitigsAC	12	7	default	4774876	5846695	4774876	1071819	639016	1563168	391452	1954620	1947596	yeast.S_pseudosimplitigsAC.k_12.d_7.M_default
yeast	pseudosimplitigsAC	12	7	ones	4774876	5846695	5364093	482602	363000	1563168	312916	1876084	1864080	yeast.S_pseudosimplitigsAC.k_12.d_7.M_ones
yeast	pseudosimplitigsAC	12	7	runs	4774876	5846695	5337477	509218	344995	1563168	311800	1874968	1858316	yeast.S_pseudosimplitigsAC.k_12.d_7.M_runs
yeast	pseudosimplitigsAC	12	7	zeros	4774876	5846695	4774876	1071819	659386	1563168	433316	1996484	1988168	yeast.S_pseudosimplitigsAC.k_12.d_7.M_zeros
yeast	pseudosimplitigsAC	12	8	default	4774876	5843911	4774876	1069035	639077	1562344	391856	1954200	1950704	yeast.S_pseudosimplitigsAC.k_12.d_8.M_default
yeast	pseudosimplitigsAC	12	8	ones	4774876	5843911	5362241	481670	362809	1562344	312752	1875096	1856332	yeast.S_pseudosimplitigsAC.k_12.d_8.M_ones
yeast	pseudosimplitigsAC	12	8	runs	4774876	5843911	5336586	507325	345101	1562344	311824	1874168	1857900	yeast.S_pseudosimplitigsAC.k_12.d_8.M_runs
yeast	pseudosimplitigsAC	12	8	zeros	4774876	5843911	4774876	1069035	659614	1562344	433844	1996188	1986440	yeast.S_pseudosimplitigsAC.k_12.d_8.M_zeros
yeast	pseudosimplitigsAC	12	9	default	4774876	5843067	4774876	1068191	639102	1562088	392148	1954236	1950144	yeast.S_pseudosimplitigsAC.k_12.d_9.M_default
yeast	pseudosimplitigsAC	12	9	ones	4774876	5843067	5361664	481403	362605	1562088	312560	1874648	1855968	yeast.S_pseudosimplitigsAC.k_12.d_9.M_ones
yeast	pseudosimplitigsAC	12	9	runs	4774876	5843067	5336275	506792	345090	1562088	311656	1873744	1862980	yeast.S_pseudosimplitigsAC.k_12.d_9.M_runs
yeast	pseudosimplitigsAC	12	9	zeros	4774876	5843067	4774876	1068191	659638	1562088	434144	1996232	1985892	yeast.S_pseudosimplitigsAC.k_12.d_9.M_zeros
yeast	pseudosimplitigs	13	1	default	8043635	16052639	8043635	8009004	667417	4150724	519504	4670228	4970792	yeast.S_pseudosimplitigs.k_13.d_1.M_default
yeast	pseudosimplitigs	13	1	ones	8043635	16052639	11633330	4419309	1516433	4150724	1381664	5532388	5548540	yeast.S_pseudosimplitigs.k_13.d_1.M_ones
yeast	pseudosimplitigs	13	1	runs	8043635	16052639	9736681	6315958	629459	4150724	841232	4991956	5027064	yeast.S_pseudosimplitigs.k_13.d_1.M_runs
yeast	pseudosimplitigs	13	1	zeros	8043635	16052639	8043635	8009004	1045216	4150724	1027484	5178208	5326964	yeast.S_pseudosimplitigs.k_13.d_1.M_zeros
yeast	pseudosimplitigs	13	10	default	8043635	10287836	8043635	2244201	1177601	2640152	811100	3451252	3411608	yeast.S_pseudosimplitigs.k_13.d_10.M_default
yeast	pseudosimplitigs	13	10	ones	8043635	10287836	9026898	1260938	802382	2640152	690672	3330824	3294200	yeast.S_pseudosimplitigs.k_13.d_10.M_ones
yeast	pseudosimplitigs	13	10	runs	8043635	10287836	8941138	1346698	744860	2640152	680796	3320948	3283860	yeast.S_pseudosimplitigs.k_13.d_10.M_runs
yeast	pseudosimplitigs	13	10	zeros	8043635	10287836	8043635	2244201	1262057	2640152	913840	3553992	3533336	yeast.S_pseudosimplitigs.k_13.d_10.M_zeros
yeast	pseudosimplitigs	13	11	default	8043635	10289981	8043635	2246346	1177545	2639408	812012	3451420	3410812	yeast.S_pseudosimplitigs.k_13.d_11.M_default
yeast	pseudosimplitigs	13	11	ones	8043635	10289981	9028384	1261597	802688	2639408	691228	3330636	3292988	yeast.S_pseudosimplitigs.k_13.d_11.M_ones
yeast	pseudosimplitigs	13	11	runs	8043635	10289981	8941769	1348212	744760	2639408	681016	3320424	3283752	yeast.S_pseudosimplitigs.k_13.d_11.M_runs
yeast	pseudosimplitigs	13	11	zeros	8043635	10289981	8043635	2246346	1262167	2639408	914384	3553792	3532740	yeast.S_pseudosimplitigs.k_13.d_11.M_zeros
yeast	pseudosimplitigs	13	12	default	8043635	10294236	8043635	2250601	1177416	2639416	812236	3451652	3409472	yeast.S_pseudosimplitigs.k_13.d_12.M_default
yeast	pseudosimplitigs	13	12	ones	8043635	10294236	9031335	1262901	803192	2639416	691668	3331084	3293796	yeast.S_pseudosimplitigs.k_13.d_12.M_ones
yeast	pseudosimplitigs	13	12	runs	8043635	10294236	8943448	1350788	744602	2639416	681164	3320580	3285908	yeast.S_pseudosimplitigs.k_13.d_12.M_runs
yeast	pseudosimplitigs	13	12	zeros	8043635	10294236	8043635	2250601	1262038	2639416	914616	3554032	3531464	yeast.S_pseudosimplitigs.k_13.d_12.M_zeros
yeast	pseudosimplitigs	13	2	default	8043635	12318973	8043635	4275338	975877	3176784	706516	3883300	4022364	yeast.S_pseudosimplitigs.k_13.d_2.M_default
yeast	pseudosimplitigs	13	2	ones	8043635	12318973	9896627	2422346	992237	3176784	912056	4088840	4070740	yeast.S_pseudosimplitigs.k_13.d_2.M_ones
yeast	pseudosimplitigs	13	2	runs	8043635	12318973	9113086	3205887	601269	3176784	684868	3861652	3884708	yeast.S_pseudosimplitigs.k_13.d_2.M_runs
yeast	pseudosimplitigs	13	2	zeros	8043635	12318973	8043635	4275338	1024191	3176784	790040	3966824	4069468	yeast.S_pseudosimplitigs.k_13.d_2.M_zeros
yeast	pseudosimplitigs	13	3	default	8043635	11137362	8043635	3093727	1116673	2866068	780292	3646360	3707928	yeast.S_pseudosimplitigs.k_13.d_3.M_default
yeast	pseudosimplitigs	13	3	ones	8043635	11137362	9322375	1814987	883623	2866068	785780	3651848	3627392	yeast.S_pseudosimplitigs.k_13.d_3.M_ones
yeast	pseudosimplitigs	13	3	runs	8043635	11137362	8958400	2178962	689115	2866068	684760	3550828	3556088	yeast.S_pseudosimplitigs.k_13.d_3.M_runs
yeast	pseudosimplitigs	13	3	zeros	8043635	11137362	8043635	3093727	1121001	2866068	794440	3660508	3709668	yeast.S_pseudosimplitigs.k_13.d_3.M_zeros
yeast	pseudosimplitigs	13	4	default	8043635	10658773	8043635	2615138	1167700	2749188	803956	3553144	3567608	yeast.S_pseudosimplitigs.k_13.d_4.M_default
yeast	pseudosimplitigs	13	4	ones	8043635	10658773	9116482	1542291	854300	2749188	740944	3490132	3463144	yeast.S_pseudosimplitigs.k_13.d_4.M_ones
yeast	pseudosimplitigs	13	4	runs	8043635	10658773	8918111	1740662	742342	2749188	695168	3444356	3430272	yeast.S_pseudosimplitigs.k_13.d_4.M_runs
yeast	pseudosimplitigs	13	4	zeros	8043635	10658773	8043635	2615138	1166952	2749188	807136	3556324	3570360	yeast.S_pseudosimplitigs.k_13.d_4.M_zeros
yeast	pseudosimplitigs	13	5	default	8043635	10414959	8043635	2371324	1172659	2679248	803976	3483224	3469684	yeast.S_pseudosimplitigs.k_13.d_5.M_default
yeast	pseudosimplitigs	13	5	ones	8043635	10414959	9041733	1373226	818887	2679248	708964	3388212	3355524	yeast.S_pseudosimplitigs.k_13.d_5.M_ones
yeast	pseudosimplitigs	13	5	runs	8043635	10414959	8914547	1500412	741904	2679248	684356	3363604	3337164	yeast.S_pseudosimplitigs.k_13.d_5.M_runs
yeast	pseudosimplitigs	13	5	zeros	8043635	10414959	8043635	2371324	1189596	2679248	839664	3518912	3514572	yeast.S_pseudosimplitigs.k_13.d_5.M_zeros
yeast	pseudosimplitigs	13	6	default	8043635	10320320	8043635	2276685	1175212	2653600	806136	3459736	3431516	yeast.S_pseudosimplitigs.k_13.d_6.M_default
yeast	pseudosimplitigs	13	6	ones	8043635	10320320	9015493	1304827	806947	2653600	695340	3348940	3312708	yeast.S_pseudosimplitigs.k_13.d_6.M_ones
yeast	pseudosimplitigs	13	6	runs	8043635	10320320	8915253	1405067	743309	2653600	679944	3333544	3299976	yeast.S_pseudosimplitigs.k_13.d_6.M_runs
yeast	pseudosimplitigs	13	6	zeros	8043635	10320320	8043635	2276685	1230676	2653600	881412	3535012	3524640	yeast.S_pseudosimplitigs.k_13.d_6.M_zeros
yeast	pseudosimplitigs	13	7	default	8043635	10282377	8043635	2238742	1176014	2642640	808272	3450912	3417660	yeast.S_pseudosimplitigs.k_13.d_7.M_default
yeast	pseudosimplitigs	13	7	ones	8043635	10282377	9008756	1273621	801575	2642640	690192	3332832	3293804	yeast.S_pseudosimplitigs.k_13.d_7.M_ones
yeast	pseudosimplitigs	13	7	runs	8043635	10282377	8920497	1361880	743511	2642640	678652	3321292	3284208	yeast.S_pseudosimplitigs.k_13.d_7.M_runs
yeast	pseudosimplitigs	13	7	zeros	8043635	10282377	8043635	2238742	1259521	2642640	909384	3552024	3539264	yeast.S_pseudosimplitigs.k_13.d_7.M_zeros
yeast	pseudosimplitigs	13	8	default	8043635	10273962	8043635	2230327	1176621	2639600	809908	3449508	3412836	yeast.S_pseudosimplitigs.k_13.d_8.M_default
yeast	pseudosimplitigs	13	8	ones	8043635	10273962	9011332	1262630	800423	2639600	689232	3328832	3289884	yeast.S_pseudosimplitigs.k_13.d_8.M_ones
yeast	pseudosimplitigs	13	8	runs	8043635	10273962	8927260	1346702	744081	2639600	679096	3318696	3281332	yeast.S_pseudosimplitigs.k_13.d_8.M_runs
yeast	pseudosimplitigs	13	8	zeros	8043635	10273962	8043635	2230327	1260124	2639600	911104	3550704	3534372	yeast.S_pseudosimplitigs.k_13.d_8.M_zeros
yeast	pseudosimplitigs	13	9	default	8043635	10282377	8043635	2238742	1177368	2640124	810376	3450500	3412320	yeast.S_pseudosimplitigs.k_13.d_9.M_default
yeast	pseudosimplitigs	13	9	ones	8043635	10282377	9021504	1260873	801761	2640124	689980	3330104	3293016	yeast.S_pseudosimplitigs.k_13.d_9.M_ones
yeast	pseudosimplitigs	13	9	runs	8043635	10282377	8936044	1346333	744593	2640124	680464	3320588	3283548	yeast.S_pseudosimplitigs.k_13.d_9.M_runs
yeast	pseudosimplitigs	13	9	zeros	8043635	10282377	8043635	2238742	1261814	2640124	913140	3553264	3534200	yeast.S_pseudosimplitigs.k_13.d_9.M_zeros
yeast	pseudosimplitigsAC	13	1	default	8043635	16052675	8043635	8009040	667420	4259284	494492	4753776	5049552	yeast.S_pseudosimplitigsAC.k_13.d_1.M_default
yeast	pseudosimplitigsAC	13	1	ones	8043635	16052675	11601446	4451229	1526722	4259284	1364520	5623804	5596984	yeast.S_pseudosimplitigsAC.k_13.d_1.M_ones
yeast	pseudosimplitigsAC	13	1	runs	8043635	16052675	9649477	6403198	626173	4259284	827116	5086400	5085904	yeast.S_pseudosimplitigsAC.k_13.d_1.M_runs
yeast	pseudosimplitigsAC	13	1	zeros	8043635	16052675	8043635	8009040	1083323	4259284	1016764	5276048	5381204	yeast.S_pseudosimplitigsAC.k_13.d_1.M_zeros
yeast	pseudosimplitigsAC	13	10	default	8043635	10071145	8043635	2027510	1112800	2654596	729192	3383788	3376220	yeast.S_pseudosimplitigsAC.k_13.d_10.M_default
yeast	pseudosimplitigsAC	13	10	ones	8043635	10071145	8979069	1092076	699137	2654596	599028	3253624	3230232	yeast.S_pseudosimplitigsAC.k_13.d_10.M_ones
yeast	pseudosimplitigsAC	13	10	runs	8043635	10071145	8921781	1149364	657801	2654596	592332	3246928	3223776	yeast.S_pseudosimplitigsAC.k_13.d_10.M_runs
yeast	pseudosimplitigsAC	13	10	zeros	8043635	10071145	8043635	2027510	1139953	2654596	779884	3434480	3422128	yeast.S_pseudosimplitigsAC.k_13.d_10.M_zeros
yeast	pseudosimplitigsAC	13	11	default	8043635	10070704	8043635	2027069	1112832	2654372	729376	3383748	3375700	yeast.S_pseudosimplitigsAC.k_13.d_11.M_default
yeast	pseudosimplitigsAC	13	11	ones	8043635	10070704	8979477	1091227	699089	2654372	598948	3253320	3229900	yeast.S_pseudosimplitigsAC.k_13.d_11.M_ones
yeast	pseudosimplitigsAC	13	11	runs	8043635	10070704	8922490	1148214	657885	2654372	592396	3246768	3229024	yeast.S_pseudosimplitigsAC.k_13.d_11.M_runs
yeast	pseudosimplitigsAC	13	11	zeros	8043635	10070704	8043635	2027069	1139985	2654372	780052	3434424	3421620	yeast.S_pseudosimplitigsAC.k_13.d_11.M_zeros
yeast	pseudosimplitigsAC	13	12	default	8043635	10070847	8043635	2027212	1112850	2654364	729456	3383820	3375428	yeast.S_pseudosimplitigsAC.k_13.d_12.M_default
yeast	pseudosimplitigsAC	13	12	ones	8043635	10070847	8979564	1091283	699076	2654364	598976	3253340	3229868	yeast.S_pseudosimplitigsAC.k_13.d_12.M_ones
yeast	pseudosimplitigsAC	13	12	runs	8043635	10070847	8922324	1148523	657861	2654364	592972	3247336	3225604	yeast.S_pseudosimplitigsAC.k_13.d_12.M_runs
yeast	pseudosimplitigsAC	13	12	zeros	8043635	10070847	8043635	2027212	1140003	2654364	780124	3434488	3421336	yeast.S_pseudosimplitigsAC.k_13.d_12.M_zeros
yeast	pseudosimplitigsAC	13	2	default	8043635	12269125	8043635	4225490	953815	3242136	652716	3894852	4040520	yeast.S_pseudosimplitigsAC.k_13.d_2.M_default
yeast	pseudosimplitigsAC	13	2	ones	8043635	12269125	9906572	2362553	957019	3242136	862844	4104980	4080620	yeast.S_pseudosimplitigsAC.k_13.d_2.M_ones
yeast	pseudosimplitigsAC	13	2	runs	8043635	12269125	9127326	3141799	570800	3242136	639404	3881540	3899576	yeast.S_pseudosimplitigsAC.k_13.d_2.M_runs
yeast	pseudosimplitigsAC	13	2	zeros	8043635	12269125	8043635	4225490	1002067	3242136	738584	3980720	4083576	yeast.S_pseudosimplitigsAC.k_13.d_2.M_zeros
yeast	pseudosimplitigsAC	13	3	default	8043635	11002570	8043635	2958935	1072102	2913476	710860	3624336	3679084	yeast.S_pseudosimplitigsAC.k_13.d_3.M_default
yeast	pseudosimplitigsAC	13	3	ones	8043635	11002570	9322606	1679964	803238	2913476	706220	3619696	3588660	yeast.S_pseudosimplitigsAC.k_13.d_3.M_ones
yeast	pseudosimplitigsAC	13	3	runs	8043635	11002570	8978411	2024159	620392	2913476	611408	3524884	3521680	yeast.S_pseudosimplitigsAC.k_13.d_3.M_runs
yeast	pseudosimplitigsAC	13	3	zeros	8043635	11002570	8043635	2958935	1075867	2913476	723412	3636888	3682188	yeast.S_pseudosimplitigsAC.k_13.d_3.M_zeros
yeast	pseudosimplitigsAC	13	4	default	8043635	10458138	8043635	2414503	1108698	2770232	724900	3495132	3505260	yeast.S_pseudosimplitigsAC.k_13.d_4.M_default
yeast	pseudosimplitigsAC	13	4	ones	8043635	10458138	9096010	1362128	745408	2770232	643992	3414224	3380276	yeast.S_pseudosimplitigsAC.k_13.d_4.M_ones
yeast	pseudosimplitigsAC	13	4	runs	8043635	10458138	8933174	1524964	650719	2770232	604944	3375176	3353532	yeast.S_pseudosimplitigsAC.k_13.d_4.M_runs
yeast	pseudosimplitigsAC	13	4	zeros	8043635	10458138	8043635	2414503	1109152	2770232	736996	3507228	3514268	yeast.S_pseudosimplitigsAC.k_13.d_4.M_zeros
yeast	pseudosimplitigsAC	13	5	default	8043635	10212522	8043635	2168887	1112175	2695384	725492	3420876	3421412	yeast.S_pseudosimplitigsAC.k_13.d_5.M_default
yeast	pseudosimplitigsAC	13	5	ones	8043635	10212522	9010579	1201943	716541	2695384	615836	3311220	3289392	yeast.S_pseudosimplitigsAC.k_13.d_5.M_ones
yeast	pseudosimplitigsAC	13	5	runs	8043635	10212522	8918321	1294201	657449	2695384	598016	3293400	3273140	yeast.S_pseudosimplitigsAC.k_13.d_5.M_runs
yeast	pseudosimplitigsAC	13	5	zeros	8043635	10212522	8043635	2168887	1118900	2695384	750516	3445900	3443628	yeast.S_pseudosimplitigsAC.k_13.d_5.M_zeros
yeast	pseudosimplitigsAC	13	6	default	8043635	10122547	8043635	2078912	1112813	2671120	726908	3398028	3393852	yeast.S_pseudosimplitigsAC.k_13.d_6.M_default
yeast	pseudosimplitigsAC	13	6	ones	8043635	10122547	8986301	1136246	705704	2671120	605076	3276196	3256848	yeast.S_pseudosimplitigsAC.k_13.d_6.M_ones
yeast	pseudosimplitigsAC	13	6	runs	8043635	10122547	8917046	1205501	658171	2671120	594372	3265492	3242332	yeast.S_pseudosimplitigsAC.k_13.d_6.M_runs
yeast	pseudosimplitigsAC	13	6	zeros	8043635	10122547	8043635	2078912	1131332	2671120	767520	3438640	3431232	yeast.S_pseudosimplitigsAC.k_13.d_6.M_zeros
yeast	pseudosimplitigsAC	13	7	default	8043635	10088445	8043635	2044810	1112708	2687440	727716	3415156	3382820	yeast.S_pseudosimplitigsAC.k_13.d_7.M_default
yeast	pseudosimplitigsAC	13	7	ones	8043635	10088445	8979655	1108790	701416	2687440	601068	3288508	3238176	yeast.S_pseudosimplitigsAC.k_13.d_7.M_ones
yeast	pseudosimplitigsAC	13	7	runs	8043635	10088445	8918223	1170222	657954	2687440	593032	3280472	3234224	yeast.S_pseudosimplitigsAC.k_13.d_7.M_runs
yeast	pseudosimplitigsAC	13	7	zeros	8043635	10088445	8043635	2044810	1133676	2687440	771352	3458792	3422668	yeast.S_pseudosimplitigsAC.k_13.d_7.M_zeros
yeast	pseudosimplitigsAC	13	8	default	8043635	10077064	8043635	2033429	1112782	2656444	728352	3384796	3378916	yeast.S_pseudosimplitigsAC.k_13.d_8.M_default
yeast	pseudosimplitigsAC	13	8	ones	8043635	10077064	8977931	1099133	700153	2656444	599804	3256248	3233032	yeast.S_pseudosimplitigsAC.k_13.d_8.M_ones
yeast	pseudosimplitigsAC	13	8	runs	8043635	10077064	8919101	1157963	657994	2656444	592544	3248988	3232020	yeast.S_pseudosimplitigsAC.k_13.d_8.M_runs
yeast	pseudosimplitigsAC	13	8	zeros	8043635	10077064	8043635	2033429	1139933	2656444	779064	3435508	3424748	yeast.S_pseudosimplitigsAC.k_13.d_8.M_zeros
yeast	pseudosimplitigsAC	13	9	default	8043635	10072173	8043635	2028538	1112783	2654920	728880	3383800	3376908	yeast.S_pseudosimplitigsAC.k_13.d_9.M_default
yeast	pseudosimplitigsAC	13	9	ones	8043635	10072173	8978704	1093469	699401	2654920	599172	3254092	3230852	yeast.S_pseudosimplitigsAC.k_13.d_9.M_ones
yeast	pseudosimplitigsAC	13	9	runs	8043635	10072173	8921018	1151155	657899	2654920	592500	3247420	3226676	yeast.S_pseudosimplitigsAC.k_13.d_9.M_runs
yeast	pseudosimplitigsAC	13	9	zeros	8043635	10072173	8043635	2028538	1139935	2654920	779572	3434492	3422848	yeast.S_pseudosimplitigsAC.k_13.d_9.M_zeros
yeast	pseudosimplitigs	14	1	default	10095869	16634518	10095869	6538649	502973	4280540	491136	4771676	5011392	yeast.S_pseudosimplitigs.k_14.d_1.M_default
yeast	pseudosimplitigs	14	1	ones	10095869	16634518	12004193	4630325	1055902	4280540	1128968	5409508	5445136	yeast.S_pseudosimplitigs.k_14.d_1.M_ones
yeast	pseudosimplitigs	14	1	runs	10095869	16634518	10960477	5674041	488480	4280540	696032	4976572	5030872	yeast.S_pseudosimplitigs.k_14.d_1.M_runs
yeast	pseudosimplitigs	14	1	zeros	10095869	16634518	10095869	6538649	750763	4280540	861384	5141924	5272964	yeast.S_pseudosimplitigs.k_14.d_1.M_zeros
yeast	pseudosimplitigs	14	10	default	10095869	12079829	10095869	1983960	924354	3110900	806784	3917684	3887060	yeast.S_pseudosimplitigs.k_14.d_10.M_default
yeast	pseudosimplitigs	14	10	ones	10095869	12079829	10854754	1225075	600800	3110900	630260	3741160	3701460	yeast.S_pseudosimplitigs.k_14.d_10.M_ones
yeast	pseudosimplitigs	14	10	runs	10095869	12079829	10795039	1284790	556673	3110900	614408	3725308	3686140	yeast.S_pseudosimplitigs.k_14.d_10.M_runs
yeast	pseudosimplitigs	14	10	zeros	10095869	12079829	10095869	1983960	933534	3110900	819812	3930712	3900872	yeast.S_pseudosimplitigs.k_14.d_10.M_zeros
yeast	pseudosimplitigs	14	11	default	10095869	12082765	10095869	1986896	924559	3109612	807220	3916832	3887440	yeast.S_pseudosimplitigs.k_14.d_11.M_default
yeast	pseudosimplitigs	14	11	ones	10095869	12082765	10856576	1226189	601671	3109612	630552	3740164	3702988	yeast.S_pseudosimplitigs.k_14.d_11.M_ones
yeast	pseudosimplitigs	14	11	runs	10095869	12082765	10795673	1287092	556902	3109612	614352	3723964	3687136	yeast.S_pseudosimplitigs.k_14.d_11.M_runs
yeast	pseudosimplitigs	14	11	zeros	10095869	12082765	10095869	1986896	933969	3109612	820372	3929984	3902220	yeast.S_pseudosimplitigs.k_14.d_11.M_zeros
yeast	pseudosimplitigs	14	12	default	10095869	12084356	10095869	1988487	924612	3109100	807360	3916460	3887468	yeast.S_pseudosimplitigs.k_14.d_12.M_default
yeast	pseudosimplitigs	14	12	ones	10095869	12084356	10857175	1227181	601986	3109100	631300	3740400	3703572	yeast.S_pseudosimplitigs.k_14.d_12.M_ones
yeast	pseudosimplitigs	14	12	runs	10095869	12084356	10795847	1288509	556921	3109100	614452	3723552	3686084	yeast.S_pseudosimplitigs.k_14.d_12.M_runs
yeast	pseudosimplitigs	14	12	zeros	10095869	12084356	10095869	1988487	934072	3109100	820496	3929596	3901012	yeast.S_pseudosimplitigs.k_14.d_12.M_zeros
yeast	pseudosimplitigs	14	2	default	10095869	13534809	10095869	3438940	686044	3497912	655012	4152924	4239728	yeast.S_pseudosimplitigs.k_14.d_2.M_default
yeast	pseudosimplitigs	14	2	ones	10095869	13534809	11203764	2331045	650150	3497912	745676	4243588	4216200	yeast.S_pseudosimplitigs.k_14.d_2.M_ones
yeast	pseudosimplitigs	14	2	runs	10095869	13534809	10749636	2785173	395986	3497912	559908	4057820	4059392	yeast.S_pseudosimplitigs.k_14.d_2.M_runs
yeast	pseudosimplitigs	14	2	zeros	10095869	13534809	10095869	3438940	727683	3497912	717548	4215460	4279564	yeast.S_pseudosimplitigs.k_14.d_2.M_zeros
yeast	pseudosimplitigs	14	3	default	10095869	12760501	10095869	2664632	808677	3303736	730292	4034028	4078144	yeast.S_pseudosimplitigs.k_14.d_3.M_default
yeast	pseudosimplitigs	14	3	ones	10095869	12760501	10977365	1783136	600819	3303736	676680	3980416	3941952	yeast.S_pseudosimplitigs.k_14.d_3.M_ones
yeast	pseudosimplitigs	14	3	runs	10095869	12760501	10743065	2017436	461940	3303736	579644	3883380	3869412	yeast.S_pseudosimplitigs.k_14.d_3.M_runs
yeast	pseudosimplitigs	14	3	zeros	10095869	12760501	10095869	2664632	813794	3303736	741076	4044812	4082896	yeast.S_pseudosimplitigs.k_14.d_3.M_zeros
yeast	pseudosimplitigs	14	4	default	10095869	12474753	10095869	2378884	880418	3230252	776396	4006648	4018736	yeast.S_pseudosimplitigs.k_14.d_4.M_default
yeast	pseudosimplitigs	14	4	ones	10095869	12474753	10890202	1584551	612166	3230252	664808	3895060	3857064	yeast.S_pseudosimplitigs.k_14.d_4.M_ones
yeast	pseudosimplitigs	14	4	runs	10095869	12474753	10756286	1718467	527176	3230252	610936	3841188	3818340	yeast.S_pseudosimplitigs.k_14.d_4.M_runs
yeast	pseudosimplitigs	14	4	zeros	10095869	12474753	10095869	2378884	880865	3230252	778100	4008352	4019412	yeast.S_pseudosimplitigs.k_14.d_4.M_zeros
yeast	pseudosimplitigs	14	5	default	10095869	12262722	10095869	2166853	906083	3172492	791948	3964440	3953704	yeast.S_pseudosimplitigs.k_14.d_5.M_default
yeast	pseudosimplitigs	14	5	ones	10095869	12262722	10857220	1405502	605790	3172492	644076	3816568	3776784	yeast.S_pseudosimplitigs.k_14.d_5.M_ones
yeast	pseudosimplitigs	14	5	runs	10095869	12262722	10771479	1491243	547571	3172492	613240	3785732	3754104	yeast.S_pseudosimplitigs.k_14.d_5.M_runs
yeast	pseudosimplitigs	14	5	zeros	10095869	12262722	10095869	2166853	906835	3172492	792736	3965228	3956080	yeast.S_pseudosimplitigs.k_14.d_5.M_zeros
yeast	pseudosimplitigs	14	6	default	10095869	12124891	10095869	2029022	916677	3130528	801676	3932204	3907528	yeast.S_pseudosimplitigs.k_14.d_6.M_default
yeast	pseudosimplitigs	14	6	ones	10095869	12124891	10848412	1276479	595564	3130528	630964	3761492	3720192	yeast.S_pseudosimplitigs.k_14.d_6.M_ones
yeast	pseudosimplitigs	14	6	runs	10095869	12124891	10785503	1339388	549882	3130528	610684	3741212	3704484	yeast.S_pseudosimplitigs.k_14.d_6.M_runs
yeast	pseudosimplitigs	14	6	zeros	10095869	12124891	10095869	2029022	918278	3130528	804188	3934716	3912272	yeast.S_pseudosimplitigs.k_14.d_6.M_zeros
yeast	pseudosimplitigs	14	7	default	10095869	12088448	10095869	1992579	921723	3117668	803248	3920916	3895308	yeast.S_pseudosimplitigs.k_14.d_7.M_default
yeast	pseudosimplitigs	14	7	ones	10095869	12088448	10849233	1239215	598322	3117668	629340	3747008	3707760	yeast.S_pseudosimplitigs.k_14.d_7.M_ones
yeast	pseudosimplitigs	14	7	runs	10095869	12088448	10789894	1298554	554721	3117668	612844	3730512	3691444	yeast.S_pseudosimplitigs.k_14.d_7.M_runs
yeast	pseudosimplitigs	14	7	zeros	10095869	12088448	10095869	1992579	926237	3117668	811184	3928852	3902388	yeast.S_pseudosimplitigs.k_14.d_7.M_zeros
yeast	pseudosimplitigs	14	8	default	10095869	12078943	10095869	1983074	923602	3112304	805172	3917476	3890248	yeast.S_pseudosimplitigs.k_14.d_8.M_default
yeast	pseudosimplitigs	14	8	ones	10095869	12078943	10850707	1228236	599672	3112304	629740	3742044	3702784	yeast.S_pseudosimplitigs.k_14.d_8.M_ones
yeast	pseudosimplitigs	14	8	runs	10095869	12078943	10792419	1286524	556396	3112304	613584	3725888	3690108	yeast.S_pseudosimplitigs.k_14.d_8.M_runs
yeast	pseudosimplitigs	14	8	zeros	10095869	12078943	10095869	1983074	930088	3112304	817032	3929336	3900292	yeast.S_pseudosimplitigs.k_14.d_8.M_zeros
yeast	pseudosimplitigs	14	9	default	10095869	12078161	10095869	1982292	924187	3109340	806456	3915796	3889168	yeast.S_pseudosimplitigs.k_14.d_9.M_default
yeast	pseudosimplitigs	14	9	ones	10095869	12078161	10853065	1225096	600207	3109340	629576	3738916	3705720	yeast.S_pseudosimplitigs.k_14.d_9.M_ones
yeast	pseudosimplitigs	14	9	runs	10095869	12078161	10794335	1283826	556633	3109340	613600	3722940	3687456	yeast.S_pseudosimplitigs.k_14.d_9.M_runs
yeast	pseudosimplitigs	14	9	zeros	10095869	12078161	10095869	1982292	933248	3109340	820580	3929920	3901376	yeast.S_pseudosimplitigs.k_14.d_9.M_zeros
yeast	pseudosimplitigsAC	14	1	default	10095869	16634531	10095869	6538662	502974	4279576	471488	4751064	5028304	yeast.S_pseudosimplitigsAC.k_14.d_1.M_default
yeast	pseudosimplitigsAC	14	1	ones	10095869	16634531	11985646	4648885	1059556	4279576	1113056	5392632	5447660	yeast.S_pseudosimplitigsAC.k_14.d_1.M_ones
yeast	pseudosimplitigsAC	14	1	runs	10095869	16634531	10921035	5713496	486778	4279576	683772	4963348	5042444	yeast.S_pseudosimplitigsAC.k_14.d_1.M_runs
yeast	pseudosimplitigsAC	14	1	zeros	10095869	16634531	10095869	6538662	759884	4279576	847796	5127372	5278644	yeast.S_pseudosimplitigsAC.k_14.d_1.M_zeros
yeast	pseudosimplitigsAC	14	10	default	10095869	11931823	10095869	1835954	876293	3090952	744920	3835872	3833104	yeast.S_pseudosimplitigsAC.k_14.d_10.M_default
yeast	pseudosimplitigsAC	14	10	ones	10095869	11931823	10834315	1097508	549506	3090952	570444	3661396	3642980	yeast.S_pseudosimplitigsAC.k_14.d_10.M_ones
yeast	pseudosimplitigsAC	14	10	runs	10095869	11931823	10783689	1148134	512170	3090952	558168	3649120	3630468	yeast.S_pseudosimplitigsAC.k_14.d_10.M_runs
yeast	pseudosimplitigsAC	14	10	zeros	10095869	11931823	10095869	1835954	892495	3090952	770724	3861676	3856372	yeast.S_pseudosimplitigsAC.k_14.d_10.M_zeros
yeast	pseudosimplitigsAC	14	11	default	10095869	11930141	10095869	1834272	876304	3091208	745232	3836440	3831748	yeast.S_pseudosimplitigsAC.k_14.d_11.M_default
yeast	pseudosimplitigsAC	14	11	ones	10095869	11930141	10834837	1095304	549614	3091208	570676	3661884	3642128	yeast.S_pseudosimplitigsAC.k_14.d_11.M_ones
yeast	pseudosimplitigsAC	14	11	runs	10095869	11930141	10784011	1146130	512173	3091208	557496	3648704	3630188	yeast.S_pseudosimplitigsAC.k_14.d_11.M_runs
yeast	pseudosimplitigsAC	14	11	zeros	10095869	11930141	10095869	1834272	892508	3091208	772384	3863592	3855272	yeast.S_pseudosimplitigsAC.k_14.d_11.M_zeros
yeast	pseudosimplitigsAC	14	12	default	10095869	11929308	10095869	1833439	876304	3091124	745184	3836308	3831084	yeast.S_pseudosimplitigsAC.k_14.d_12.M_default
yeast	pseudosimplitigsAC	14	12	ones	10095869	11929308	10835456	1093852	549605	3091124	570404	3661528	3642132	yeast.S_pseudosimplitigsAC.k_14.d_12.M_ones
yeast	pseudosimplitigsAC	14	12	runs	10095869	11929308	10784521	1144787	512137	3091124	557372	3648496	3629272	yeast.S_pseudosimplitigsAC.k_14.d_12.M_runs
yeast	pseudosimplitigsAC	14	12	zeros	10095869	11929308	10095869	1833439	892508	3091124	772244	3863368	3854904	yeast.S_pseudosimplitigsAC.k_14.d_12.M_zeros
yeast	pseudosimplitigsAC	14	2	default	10095869	13456099	10095869	3360230	669182	3487984	620784	4108768	4215688	yeast.S_pseudosimplitigsAC.k_14.d_2.M_default
yeast	pseudosimplitigsAC	14	2	ones	10095869	13456099	11202820	2253279	620542	3487984	700544	4188528	4176796	yeast.S_pseudosimplitigsAC.k_14.d_2.M_ones
yeast	pseudosimplitigsAC	14	2	runs	10095869	13456099	10754727	2701372	371377	3487984	520440	4008424	4024196	yeast.S_pseudosimplitigsAC.k_14.d_2.M_runs
yeast	pseudosimplitigsAC	14	2	zeros	10095869	13456099	10095869	3360230	710705	3487984	683420	4171404	4253744	yeast.S_pseudosimplitigsAC.k_14.d_2.M_zeros
yeast	pseudosimplitigsAC	14	3	default	10095869	12641301	10095869	2545432	778739	3285372	685860	3971232	4033124	yeast.S_pseudosimplitigsAC.k_14.d_3.M_default
yeast	pseudosimplitigsAC	14	3	ones	10095869	12641301	10979518	1661783	554786	3285372	618004	3903376	3883048	yeast.S_pseudosimplitigsAC.k_14.d_3.M_ones
yeast	pseudosimplitigsAC	14	3	runs	10095869	12641301	10752073	1889228	421234	3285372	526540	3811912	3813212	yeast.S_pseudosimplitigsAC.k_14.d_3.M_runs
yeast	pseudosimplitigsAC	14	3	zeros	10095869	12641301	10095869	2545432	783679	3285372	695808	3981180	4036616	yeast.S_pseudosimplitigsAC.k_14.d_3.M_zeros
yeast	pseudosimplitigsAC	14	4	default	10095869	12333491	10095869	2237622	839849	3206980	725140	3932120	3962240	yeast.S_pseudosimplitigsAC.k_14.d_4.M_default
yeast	pseudosimplitigsAC	14	4	ones	10095869	12333491	10888157	1445334	552376	3206980	596560	3803540	3783156	yeast.S_pseudosimplitigsAC.k_14.d_4.M_ones
yeast	pseudosimplitigsAC	14	4	runs	10095869	12333491	10763729	1569762	473709	3206980	546380	3753360	3747724	yeast.S_pseudosimplitigsAC.k_14.d_4.M_runs
yeast	pseudosimplitigsAC	14	4	zeros	10095869	12333491	10095869	2237622	840358	3206980	728676	3935656	3962688	yeast.S_pseudosimplitigsAC.k_14.d_4.M_zeros
yeast	pseudosimplitigsAC	14	5	default	10095869	12144380	10095869	2048511	866076	3156940	738224	3895164	3905400	yeast.S_pseudosimplitigsAC.k_14.d_5.M_default
yeast	pseudosimplitigsAC	14	5	ones	10095869	12144380	10852355	1292025	553354	3156940	584944	3741884	3717796	yeast.S_pseudosimplitigsAC.k_14.d_5.M_ones
yeast	pseudosimplitigsAC	14	5	runs	10095869	12144380	10774786	1369594	500399	3156940	556704	3713644	3697924	yeast.S_pseudosimplitigsAC.k_14.d_5.M_runs
yeast	pseudosimplitigsAC	14	5	zeros	10095869	12144380	10095869	2048511	866920	3156940	744228	3901168	3905540	yeast.S_pseudosimplitigsAC.k_14.d_5.M_zeros
yeast	pseudosimplitigsAC	14	6	default	10095869	12028823	10095869	1932954	874387	3123612	740704	3864316	3866036	yeast.S_pseudosimplitigsAC.k_14.d_6.M_default
yeast	pseudosimplitigsAC	14	6	ones	10095869	12028823	10836163	1192660	552916	3123612	577328	3700940	3677224	yeast.S_pseudosimplitigsAC.k_14.d_6.M_ones
yeast	pseudosimplitigsAC	14	6	runs	10095869	12028823	10777318	1251505	510327	3123612	558736	3682348	3661904	yeast.S_pseudosimplitigsAC.k_14.d_6.M_runs
yeast	pseudosimplitigsAC	14	6	zeros	10095869	12028823	10095869	1932954	875674	3123612	748604	3872216	3868388	yeast.S_pseudosimplitigsAC.k_14.d_6.M_zeros
yeast	pseudosimplitigsAC	14	7	default	10095869	11968758	10095869	1872889	875759	3103208	743360	3846568	3844248	yeast.S_pseudosimplitigsAC.k_14.d_7.M_default
yeast	pseudosimplitigsAC	14	7	ones	10095869	11968758	10832286	1136472	551040	3103208	572980	3676188	3654172	yeast.S_pseudosimplitigsAC.k_14.d_7.M_ones
yeast	pseudosimplitigsAC	14	7	runs	10095869	11968758	10779188	1189570	512109	3103208	557544	3660752	3642348	yeast.S_pseudosimplitigsAC.k_14.d_7.M_runs
yeast	pseudosimplitigsAC	14	7	zeros	10095869	11968758	10095869	1872889	877043	3103208	749632	3852840	3847320	yeast.S_pseudosimplitigsAC.k_14.d_7.M_zeros
yeast	pseudosimplitigsAC	14	8	default	10095869	11945126	10095869	1849257	876174	3095032	744004	3839036	3836984	yeast.S_pseudosimplitigsAC.k_14.d_8.M_default
yeast	pseudosimplitigsAC	14	8	ones	10095869	11945126	10832073	1113053	550097	3095032	570996	3666028	3646476	yeast.S_pseudosimplitigsAC.k_14.d_8.M_ones
yeast	pseudosimplitigsAC	14	8	runs	10095869	11945126	10781299	1163827	512404	3095032	558280	3653312	3634404	yeast.S_pseudosimplitigsAC.k_14.d_8.M_runs
yeast	pseudosimplitigsAC	14	8	zeros	10095869	11945126	10095869	1849257	880005	3095032	753968	3849000	3842752	yeast.S_pseudosimplitigsAC.k_14.d_8.M_zeros
yeast	pseudosimplitigsAC	14	9	default	10095869	11936562	10095869	1840693	876312	3093468	742460	3835928	3835008	yeast.S_pseudosimplitigsAC.k_14.d_9.M_default
yeast	pseudosimplitigsAC	14	9	ones	10095869	11936562	10833046	1103516	549910	3093468	571988	3665456	3644544	yeast.S_pseudosimplitigsAC.k_14.d_9.M_ones
yeast	pseudosimplitigsAC	14	9	runs	10095869	11936562	10782184	1154378	512297	3093468	557584	3651052	3631860	yeast.S_pseudosimplitigsAC.k_14.d_9.M_runs
yeast	pseudosimplitigsAC	14	9	zeros	10095869	11936562	10095869	1840693	891974	3093468	771352	3864820	3857608	yeast.S_pseudosimplitigsAC.k_14.d_9.M_zeros
yeast	pseudosimplitigs	15	1	default	10976114	14288458	10976114	3312344	236596	3674512	319528	3994040	4100492	yeast.S_pseudosimplitigs.k_15.d_1.M_default
yeast	pseudosimplitigs	15	1	ones	10976114	14288458	11586750	2701708	403609	3674512	571092	4245604	4250440	yeast.S_pseudosimplitigs.k_15.d_1.M_ones
yeast	pseudosimplitigs	15	1	runs	10976114	14288458	11300738	2987720	232918	3674512	401948	4076460	4100604	yeast.S_pseudosimplitigs.k_15.d_1.M_runs
yeast	pseudosimplitigs	15	1	zeros	10976114	14288458	10976114	3312344	322485	3674512	470200	4144712	4201284	yeast.S_pseudosimplitigs.k_15.d_1.M_zeros
yeast	pseudosimplitigs	15	10	default	10976114	12097841	10976114	1121727	431418	3123712	525568	3649280	3604420	yeast.S_pseudosimplitigs.k_15.d_10.M_default
yeast	pseudosimplitigs	15	10	ones	10976114	12097841	11350094	747747	263688	3123712	370744	3494456	3450328	yeast.S_pseudosimplitigs.k_15.d_10.M_ones
yeast	pseudosimplitigs	15	10	runs	10976114	12097841	11323191	774650	243955	3123712	359004	3482716	3440212	yeast.S_pseudosimplitigs.k_15.d_10.M_runs
yeast	pseudosimplitigs	15	10	zeros	10976114	12097841	10976114	1121727	438624	3123712	542076	3665788	3616300	yeast.S_pseudosimplitigs.k_15.d_10.M_zeros
yeast	pseudosimplitigs	15	11	default	10976114	12100450	10976114	1124336	431774	3123716	525952	3649668	3603208	yeast.S_pseudosimplitigs.k_15.d_11.M_default
yeast	pseudosimplitigs	15	11	ones	10976114	12100450	11351237	749213	264206	3123716	371204	3494920	3450452	yeast.S_pseudosimplitigs.k_15.d_11.M_ones
yeast	pseudosimplitigs	15	11	runs	10976114	12100450	11323873	776577	244152	3123716	359532	3483248	3440648	yeast.S_pseudosimplitigs.k_15.d_11.M_runs
yeast	pseudosimplitigs	15	11	zeros	10976114	12100450	10976114	1124336	439204	3123716	542928	3666644	3616972	yeast.S_pseudosimplitigs.k_15.d_11.M_zeros
yeast	pseudosimplitigs	15	12	default	10976114	12103359	10976114	1127245	432023	3124080	526164	3650244	3603964	yeast.S_pseudosimplitigs.k_15.d_12.M_default
yeast	pseudosimplitigs	15	12	ones	10976114	12103359	11352271	751088	264778	3124080	371696	3495776	3452572	yeast.S_pseudosimplitigs.k_15.d_12.M_ones
yeast	pseudosimplitigs	15	12	runs	10976114	12103359	11324191	779168	244292	3124080	359688	3483768	3440952	yeast.S_pseudosimplitigs.k_15.d_12.M_runs
yeast	pseudosimplitigs	15	12	zeros	10976114	12103359	10976114	1127245	439454	3124080	543428	3667508	3615516	yeast.S_pseudosimplitigs.k_15.d_12.M_zeros
yeast	pseudosimplitigs	15	2	default	10976114	12566680	10976114	1590566	290904	3251132	401856	3652988	3653540	yeast.S_pseudosimplitigs.k_15.d_2.M_default
yeast	pseudosimplitigs	15	2	ones	10976114	12566680	11372199	1194481	219217	3251132	355908	3607040	3568928	yeast.S_pseudosimplitigs.k_15.d_2.M_ones
yeast	pseudosimplitigs	15	2	runs	10976114	12566680	11249633	1317047	145775	3251132	284032	3535164	3512976	yeast.S_pseudosimplitigs.k_15.d_2.M_runs
yeast	pseudosimplitigs	15	2	zeros	10976114	12566680	10976114	1590566	307836	3251132	429720	3680852	3671344	yeast.S_pseudosimplitigs.k_15.d_2.M_zeros
yeast	pseudosimplitigs	15	3	default	10976114	12201425	10976114	1225311	335854	3161920	448100	3610020	3584188	yeast.S_pseudosimplitigs.k_15.d_3.M_default
yeast	pseudosimplitigs	15	3	ones	10976114	12201425	11340810	860615	199937	3161920	330184	3492104	3440864	yeast.S_pseudosimplitigs.k_15.d_3.M_ones
yeast	pseudosimplitigs	15	3	runs	10976114	12201425	11272962	928463	157819	3161920	291512	3453432	3413008	yeast.S_pseudosimplitigs.k_15.d_3.M_runs
yeast	pseudosimplitigs	15	3	zeros	10976114	12201425	10976114	1225311	338738	3161920	453396	3615316	3587824	yeast.S_pseudosimplitigs.k_15.d_3.M_zeros
yeast	pseudosimplitigs	15	4	default	10976114	12140529	10976114	1164415	369992	3146512	478236	3624748	3592076	yeast.S_pseudosimplitigs.k_15.d_4.M_default
yeast	pseudosimplitigs	15	4	ones	10976114	12140529	11336176	804353	214650	3146512	341900	3488412	3437940	yeast.S_pseudosimplitigs.k_15.d_4.M_ones
yeast	pseudosimplitigs	15	4	runs	10976114	12140529	11292251	848278	185703	3146512	317104	3463616	3421132	yeast.S_pseudosimplitigs.k_15.d_4.M_runs
yeast	pseudosimplitigs	15	4	zeros	10976114	12140529	10976114	1164415	370426	3146512	479244	3625756	3592240	yeast.S_pseudosimplitigs.k_15.d_4.M_zeros
yeast	pseudosimplitigs	15	5	default	10976114	12139576	10976114	1163462	398112	3144336	500932	3645268	3608376	yeast.S_pseudosimplitigs.k_15.d_5.M_default
yeast	pseudosimplitigs	15	5	ones	10976114	12139576	11335527	804049	235113	3144336	356260	3500596	3454432	yeast.S_pseudosimplitigs.k_15.d_5.M_ones
yeast	pseudosimplitigs	15	5	runs	10976114	12139576	11303903	835673	213010	3144336	339176	3483512	3441244	yeast.S_pseudosimplitigs.k_15.d_5.M_runs
yeast	pseudosimplitigs	15	5	zeros	10976114	12139576	10976114	1163462	398637	3144336	503508	3647844	3611636	yeast.S_pseudosimplitigs.k_15.d_5.M_zeros
yeast	pseudosimplitigs	15	6	default	10976114	12120926	10976114	1144812	415225	3137640	513720	3651360	3610852	yeast.S_pseudosimplitigs.k_15.d_6.M_default
yeast	pseudosimplitigs	15	6	ones	10976114	12120926	11340738	780188	247408	3137640	362192	3499832	3454904	yeast.S_pseudosimplitigs.k_15.d_6.M_ones
yeast	pseudosimplitigs	15	6	runs	10976114	12120926	11314624	806302	228571	3137640	348996	3486636	3444912	yeast.S_pseudosimplitigs.k_15.d_6.M_runs
yeast	pseudosimplitigs	15	6	zeros	10976114	12120926	10976114	1144812	416931	3137640	520092	3657732	3613272	yeast.S_pseudosimplitigs.k_15.d_6.M_zeros
yeast	pseudosimplitigs	15	7	default	10976114	12105473	10976114	1129359	425289	3131748	520876	3652624	3607068	yeast.S_pseudosimplitigs.k_15.d_7.M_default
yeast	pseudosimplitigs	15	7	ones	10976114	12105473	11343888	761585	256650	3131748	367120	3498868	3453256	yeast.S_pseudosimplitigs.k_15.d_7.M_ones
yeast	pseudosimplitigs	15	7	runs	10976114	12105473	11319170	786303	238415	3131748	355192	3486940	3443580	yeast.S_pseudosimplitigs.k_15.d_7.M_runs
yeast	pseudosimplitigs	15	7	zeros	10976114	12105473	10976114	1129359	428980	3131748	531248	3662996	3614324	yeast.S_pseudosimplitigs.k_15.d_7.M_zeros
yeast	pseudosimplitigs	15	8	default	10976114	12097311	10976114	1121197	429585	3125728	523520	3649248	3604016	yeast.S_pseudosimplitigs.k_15.d_8.M_default
yeast	pseudosimplitigs	15	8	ones	10976114	12097311	11346905	750406	261145	3125728	369284	3495012	3450692	yeast.S_pseudosimplitigs.k_15.d_8.M_ones
yeast	pseudosimplitigs	15	8	runs	10976114	12097311	11321587	775724	242410	3125728	358020	3483748	3441580	yeast.S_pseudosimplitigs.k_15.d_8.M_runs
yeast	pseudosimplitigs	15	8	zeros	10976114	12097311	10976114	1121197	433788	3125728	535396	3661124	3611564	yeast.S_pseudosimplitigs.k_15.d_8.M_zeros
yeast	pseudosimplitigs	15	9	default	10976114	12096190	10976114	1120076	430842	3123852	524996	3648848	3604748	yeast.S_pseudosimplitigs.k_15.d_9.M_default
yeast	pseudosimplitigs	15	9	ones	10976114	12096190	11348545	747645	262739	3123852	370232	3494084	3449960	yeast.S_pseudosimplitigs.k_15.d_9.M_ones
yeast	pseudosimplitigs	15	9	runs	10976114	12096190	11322448	773742	243529	3123852	358836	3482688	3440096	yeast.S_pseudosimplitigs.k_15.d_9.M_runs
yeast	pseudosimplitigs	15	9	zeros	10976114	12096190	10976114	1120076	438049	3123852	541492	3665344	3616616	yeast.S_pseudosimplitigs.k_15.d_9.M_zeros
yeast	pseudosimplitigsAC	15	1	default	10976114	14288500	10976114	3312386	236599	3671588	310872	3982460	4098100	yeast.S_pseudosimplitigsAC.k_15.d_1.M_default
yeast	pseudosimplitigsAC	15	1	ones	10976114	14288500	11580627	2707873	404552	3671588	563236	4234824	4248244	yeast.S_pseudosimplitigsAC.k_15.d_1.M_ones
yeast	pseudosimplitigsAC	15	1	runs	10976114	14288500	11290901	2997599	232388	3671588	395356	4066944	4100452	yeast.S_pseudosimplitigsAC.k_15.d_1.M_runs
yeast	pseudosimplitigsAC	15	1	zeros	10976114	14288500	10976114	3312386	322553	3671588	462988	4134576	4198368	yeast.S_pseudosimplitigsAC.k_15.d_1.M_zeros
yeast	pseudosimplitigsAC	15	10	default	10976114	12010323	10976114	1034209	412649	3106384	499108	3605492	3569596	yeast.S_pseudosimplitigsAC.k_15.d_10.M_default
yeast	pseudosimplitigsAC	15	10	ones	10976114	12010323	11341393	668930	239876	3106384	336528	3442912	3408648	yeast.S_pseudosimplitigsAC.k_15.d_10.M_ones
yeast	pseudosimplitigsAC	15	10	runs	10976114	12010323	11319182	691141	223458	3106384	326808	3433192	3399916	yeast.S_pseudosimplitigsAC.k_15.d_10.M_runs
yeast	pseudosimplitigsAC	15	10	zeros	10976114	12010323	10976114	1034209	425560	3106384	530256	3636640	3590108	yeast.S_pseudosimplitigsAC.k_15.d_10.M_zeros
yeast	pseudosimplitigsAC	15	11	default	10976114	12008655	10976114	1032541	412715	3105996	500112	3606108	3569772	yeast.S_pseudosimplitigsAC.k_15.d_11.M_default
yeast	pseudosimplitigsAC	15	11	ones	10976114	12008655	11341619	667036	240124	3105996	336436	3442432	3407840	yeast.S_pseudosimplitigsAC.k_15.d_11.M_ones
yeast	pseudosimplitigsAC	15	11	runs	10976114	12008655	11319332	689323	223608	3105996	326648	3432644	3398620	yeast.S_pseudosimplitigsAC.k_15.d_11.M_runs
yeast	pseudosimplitigsAC	15	11	zeros	10976114	12008655	10976114	1032541	425631	3105996	530292	3636288	3591348	yeast.S_pseudosimplitigsAC.k_15.d_11.M_zeros
yeast	pseudosimplitigsAC	15	12	default	10976114	12007699	10976114	1031585	412716	3107280	499368	3606648	3567072	yeast.S_pseudosimplitigsAC.k_15.d_12.M_default
yeast	pseudosimplitigsAC	15	12	ones	10976114	12007699	11341940	665759	240144	3107280	336568	3443848	3407684	yeast.S_pseudosimplitigsAC.k_15.d_12.M_ones
yeast	pseudosimplitigsAC	15	12	runs	10976114	12007699	11319514	688185	223564	3107280	326884	3434164	3400216	yeast.S_pseudosimplitigsAC.k_15.d_12.M_runs
yeast	pseudosimplitigsAC	15	12	zeros	10976114	12007699	10976114	1031585	425788	3107280	530788	3638068	3588704	yeast.S_pseudosimplitigsAC.k_15.d_12.M_zeros
yeast	pseudosimplitigsAC	15	2	default	10976114	12519706	10976114	1543592	284113	3239808	388000	3627808	3635372	yeast.S_pseudosimplitigsAC.k_15.d_2.M_default
yeast	pseudosimplitigsAC	15	2	ones	10976114	12519706	11370813	1148893	207030	3239808	332184	3571992	3541356	yeast.S_pseudosimplitigsAC.k_15.d_2.M_ones
yeast	pseudosimplitigsAC	15	2	runs	10976114	12519706	11251144	1268562	135741	3239808	263440	3503248	3487096	yeast.S_pseudosimplitigsAC.k_15.d_2.M_runs
yeast	pseudosimplitigsAC	15	2	zeros	10976114	12519706	10976114	1543592	300635	3239808	415500	3655308	3652332	yeast.S_pseudosimplitigsAC.k_15.d_2.M_zeros
yeast	pseudosimplitigsAC	15	3	default	10976114	12134446	10976114	1158332	324466	3145332	429492	3574824	3555740	yeast.S_pseudosimplitigsAC.k_15.d_3.M_default
yeast	pseudosimplitigsAC	15	3	ones	10976114	12134446	11341658	792788	182104	3145332	299648	3444980	3403388	yeast.S_pseudosimplitigsAC.k_15.d_3.M_ones
yeast	pseudosimplitigsAC	15	3	runs	10976114	12134446	11276380	858066	141998	3145332	263312	3408644	3376648	yeast.S_pseudosimplitigsAC.k_15.d_3.M_runs
yeast	pseudosimplitigsAC	15	3	zeros	10976114	12134446	10976114	1158332	327105	3145332	434288	3579620	3558472	yeast.S_pseudosimplitigsAC.k_15.d_3.M_zeros
yeast	pseudosimplitigsAC	15	4	default	10976114	12078241	10976114	1102127	357162	3132124	459024	3591148	3564520	yeast.S_pseudosimplitigsAC.k_15.d_4.M_default
yeast	pseudosimplitigsAC	15	4	ones	10976114	12078241	11336602	741639	195597	3132124	311432	3443556	3402904	yeast.S_pseudosimplitigsAC.k_15.d_4.M_ones
yeast	pseudosimplitigsAC	15	4	runs	10976114	12078241	11295201	783040	168588	3132124	288624	3420748	3385788	yeast.S_pseudosimplitigsAC.k_15.d_4.M_runs
yeast	pseudosimplitigsAC	15	4	zeros	10976114	12078241	10976114	1102127	357581	3132124	459996	3592120	3564964	yeast.S_pseudosimplitigsAC.k_15.d_4.M_zeros
yeast	pseudosimplitigsAC	15	5	default	10976114	12079140	10976114	1103026	382800	3130420	479496	3609916	3580512	yeast.S_pseudosimplitigsAC.k_15.d_5.M_default
yeast	pseudosimplitigsAC	15	5	ones	10976114	12079140	11335296	743844	214782	3130420	325224	3455644	3417996	yeast.S_pseudosimplitigsAC.k_15.d_5.M_ones
yeast	pseudosimplitigsAC	15	5	runs	10976114	12079140	11304836	774304	193846	3130420	309056	3439476	3406616	yeast.S_pseudosimplitigsAC.k_15.d_5.M_runs
yeast	pseudosimplitigsAC	15	5	zeros	10976114	12079140	10976114	1103026	383043	3130420	480360	3610780	3582208	yeast.S_pseudosimplitigsAC.k_15.d_5.M_zeros
yeast	pseudosimplitigsAC	15	6	default	10976114	12070898	10976114	1094784	400487	3130832	491704	3622536	3587156	yeast.S_pseudosimplitigsAC.k_15.d_6.M_default
yeast	pseudosimplitigsAC	15	6	ones	10976114	12070898	11337875	733023	229331	3130832	333280	3464112	3424316	yeast.S_pseudosimplitigsAC.k_15.d_6.M_ones
yeast	pseudosimplitigsAC	15	6	runs	10976114	12070898	11313166	757732	211480	3130832	320712	3451544	3414660	yeast.S_pseudosimplitigsAC.k_15.d_6.M_runs
yeast	pseudosimplitigsAC	15	6	zeros	10976114	12070898	10976114	1094784	402350	3130832	502320	3633152	3590788	yeast.S_pseudosimplitigsAC.k_15.d_6.M_zeros
yeast	pseudosimplitigsAC	15	7	default	10976114	12047862	10976114	1071748	408960	3117764	497636	3615400	3582712	yeast.S_pseudosimplitigsAC.k_15.d_7.M_default
yeast	pseudosimplitigsAC	15	7	ones	10976114	12047862	11338719	709143	236829	3117764	336104	3453868	3419260	yeast.S_pseudosimplitigsAC.k_15.d_7.M_ones
yeast	pseudosimplitigsAC	15	7	runs	10976114	12047862	11316183	731679	220143	3117764	325124	3442888	3410396	yeast.S_pseudosimplitigsAC.k_15.d_7.M_runs
yeast	pseudosimplitigsAC	15	7	zeros	10976114	12047862	10976114	1071748	411828	3117764	509608	3627372	3588044	yeast.S_pseudosimplitigsAC.k_15.d_7.M_zeros
yeast	pseudosimplitigsAC	15	8	default	10976114	12026780	10976114	1050666	411846	3113732	498648	3612380	3576516	yeast.S_pseudosimplitigsAC.k_15.d_8.M_default
yeast	pseudosimplitigsAC	15	8	ones	10976114	12026780	11340052	686728	239028	3113732	336768	3450500	3415300	yeast.S_pseudosimplitigsAC.k_15.d_8.M_ones
yeast	pseudosimplitigsAC	15	8	runs	10976114	12026780	11318190	708590	222793	3113732	326640	3440372	3404932	yeast.S_pseudosimplitigsAC.k_15.d_8.M_runs
yeast	pseudosimplitigsAC	15	8	zeros	10976114	12026780	10976114	1050666	423567	3113732	527744	3641476	3595628	yeast.S_pseudosimplitigsAC.k_15.d_8.M_zeros
yeast	pseudosimplitigsAC	15	9	default	10976114	12015493	10976114	1039379	412616	3109136	499032	3608168	3570364	yeast.S_pseudosimplitigsAC.k_15.d_9.M_default
yeast	pseudosimplitigsAC	15	9	ones	10976114	12015493	11340259	675234	239947	3109136	336516	3445652	3411240	yeast.S_pseudosimplitigsAC.k_15.d_9.M_ones
yeast	pseudosimplitigsAC	15	9	runs	10976114	12015493	11318243	697250	223596	3109136	326652	3435788	3402672	yeast.S_pseudosimplitigsAC.k_15.d_9.M_runs
yeast	pseudosimplitigsAC	15	9	zeros	10976114	12015493	10976114	1039379	424765	3109136	528752	3637888	3591632	yeast.S_pseudosimplitigsAC.k_15.d_9.M_zeros
yeast	pseudosimplitigs	16	1	default	11294786	12692636	11294786	1397850	93190	3274884	174228	3449112	3473364	yeast.S_pseudosimplitigs.k_16.d_1.M_default
yeast	pseudosimplitigs	16	1	ones	11294786	12692636	11475926	1216710	130028	3274884	250544	3525428	3509888	yeast.S_pseudosimplitigs.k_16.d_1.M_ones
yeast	pseudosimplitigs	16	1	runs	11294786	12692636	11413268	1279368	92240	3274884	203952	3478836	3473620	yeast.S_pseudosimplitigs.k_16.d_1.M_runs
yeast	pseudosimplitigs	16	1	zeros	11294786	12692636	11294786	1397850	115183	3274884	221676	3496560	3502184	yeast.S_pseudosimplitigs.k_16.d_1.M_zeros
yeast	pseudosimplitigs	16	10	default	11294786	11826736	11294786	531950	166627	3060412	284536	3344948	3294612	yeast.S_pseudosimplitigs.k_16.d_10.M_default
yeast	pseudosimplitigs	16	10	ones	11294786	11826736	11446648	380088	94290	3060412	171444	3231856	3205724	yeast.S_pseudosimplitigs.k_16.d_10.M_ones
yeast	pseudosimplitigs	16	10	runs	11294786	11826736	11438963	387773	88763	3060412	166880	3227292	3201820	yeast.S_pseudosimplitigs.k_16.d_10.M_runs
yeast	pseudosimplitigs	16	10	zeros	11294786	11826736	11294786	531950	169684	3060412	295168	3355580	3300012	yeast.S_pseudosimplitigs.k_16.d_10.M_zeros
yeast	pseudosimplitigs	16	11	default	11294786	11829177	11294786	534391	167083	3059276	285224	3344500	3294424	yeast.S_pseudosimplitigs.k_16.d_11.M_default
yeast	pseudosimplitigs	16	11	ones	11294786	11829177	11447178	381999	94921	3059276	171876	3231152	3205796	yeast.S_pseudosimplitigs.k_16.d_11.M_ones
yeast	pseudosimplitigs	16	11	runs	11294786	11829177	11439165	390012	89174	3059276	167232	3226508	3202028	yeast.S_pseudosimplitigs.k_16.d_11.M_runs
yeast	pseudosimplitigs	16	11	zeros	11294786	11829177	11294786	534391	170287	3059276	295972	3355248	3300640	yeast.S_pseudosimplitigs.k_16.d_11.M_zeros
yeast	pseudosimplitigs	16	12	default	11294786	11829679	11294786	534893	167221	3059164	285396	3344560	3294240	yeast.S_pseudosimplitigs.k_16.d_12.M_default
yeast	pseudosimplitigs	16	12	ones	11294786	11829679	11447750	381929	95134	3059164	172044	3231208	3205952	yeast.S_pseudosimplitigs.k_16.d_12.M_ones
yeast	pseudosimplitigs	16	12	runs	11294786	11829679	11439477	390202	89246	3059164	167328	3226492	3202476	yeast.S_pseudosimplitigs.k_16.d_12.M_runs
yeast	pseudosimplitigs	16	12	zeros	11294786	11829679	11294786	534893	170427	3059164	296120	3355284	3300448	yeast.S_pseudosimplitigs.k_16.d_12.M_zeros
yeast	pseudosimplitigs	16	2	default	11294786	11941726	11294786	646940	105280	3092984	210012	3302996	3271024	yeast.S_pseudosimplitigs.k_16.d_2.M_default
yeast	pseudosimplitigs	16	2	ones	11294786	11941726	11424630	517096	64492	3092984	143552	3236536	3211684	yeast.S_pseudosimplitigs.k_16.d_2.M_ones
yeast	pseudosimplitigs	16	2	runs	11294786	11941726	11397794	543932	48398	3092984	123832	3216816	3198208	yeast.S_pseudosimplitigs.k_16.d_2.M_runs
yeast	pseudosimplitigs	16	2	zeros	11294786	11941726	11294786	646940	109810	3092984	219020	3312004	3276032	yeast.S_pseudosimplitigs.k_16.d_2.M_zeros
yeast	pseudosimplitigs	16	3	default	11294786	11756074	11294786	461288	115995	3047548	227720	3275268	3229144	yeast.S_pseudosimplitigs.k_16.d_3.M_default
yeast	pseudosimplitigs	16	3	ones	11294786	11756074	11425811	330263	52691	3047548	122924	3170472	3142420	yeast.S_pseudosimplitigs.k_16.d_3.M_ones
yeast	pseudosimplitigs	16	3	runs	11294786	11756074	11410943	345131	43664	3047548	112188	3159736	3134540	yeast.S_pseudosimplitigs.k_16.d_3.M_runs
yeast	pseudosimplitigs	16	3	zeros	11294786	11756074	11294786	461288	116949	3047548	229616	3277164	3229220	yeast.S_pseudosimplitigs.k_16.d_3.M_zeros
yeast	pseudosimplitigs	16	4	default	11294786	11729671	11294786	434885	125230	3042136	241764	3283900	3230400	yeast.S_pseudosimplitigs.k_16.d_4.M_default
yeast	pseudosimplitigs	16	4	ones	11294786	11729671	11429107	300564	55729	3042136	129144	3171280	3138164	yeast.S_pseudosimplitigs.k_16.d_4.M_ones
yeast	pseudosimplitigs	16	4	runs	11294786	11729671	11419286	310385	49414	3042136	122060	3164196	3132828	yeast.S_pseudosimplitigs.k_16.d_4.M_runs
yeast	pseudosimplitigs	16	4	zeros	11294786	11729671	11294786	434885	125407	3042136	242192	3284328	3229772	yeast.S_pseudosimplitigs.k_16.d_4.M_zeros
yeast	pseudosimplitigs	16	5	default	11294786	11747775	11294786	452989	135543	3046040	255068	3301108	3246252	yeast.S_pseudosimplitigs.k_16.d_5.M_default
yeast	pseudosimplitigs	16	5	ones	11294786	11747775	11432952	314823	64369	3046040	143268	3189308	3154412	yeast.S_pseudosimplitigs.k_16.d_5.M_ones
yeast	pseudosimplitigs	16	5	runs	11294786	11747775	11425096	322679	59031	3046040	137800	3183840	3151004	yeast.S_pseudosimplitigs.k_16.d_5.M_runs
yeast	pseudosimplitigs	16	5	zeros	11294786	11747775	11294786	452989	135599	3046040	255220	3301260	3246776	yeast.S_pseudosimplitigs.k_16.d_5.M_zeros
yeast	pseudosimplitigs	16	6	default	11294786	11773084	11294786	478298	145301	3051516	266452	3317968	3264072	yeast.S_pseudosimplitigs.k_16.d_6.M_default
yeast	pseudosimplitigs	16	6	ones	11294786	11773084	11437190	335894	73215	3051516	153948	3205464	3172616	yeast.S_pseudosimplitigs.k_16.d_6.M_ones
yeast	pseudosimplitigs	16	6	runs	11294786	11773084	11430392	342692	68379	3051516	149184	3200700	3170224	yeast.S_pseudosimplitigs.k_16.d_6.M_runs
yeast	pseudosimplitigs	16	6	zeros	11294786	11773084	11294786	478298	145431	3051516	267084	3318600	3265420	yeast.S_pseudosimplitigs.k_16.d_6.M_zeros
yeast	pseudosimplitigs	16	7	default	11294786	11797956	11294786	503170	154192	3057172	274644	3331816	3279260	yeast.S_pseudosimplitigs.k_16.d_7.M_default
yeast	pseudosimplitigs	16	7	ones	11294786	11797956	11440927	357029	81475	3057172	161364	3218536	3187852	yeast.S_pseudosimplitigs.k_16.d_7.M_ones
yeast	pseudosimplitigs	16	7	runs	11294786	11797956	11434441	363515	76799	3057172	157112	3214284	3185868	yeast.S_pseudosimplitigs.k_16.d_7.M_runs
yeast	pseudosimplitigs	16	7	zeros	11294786	11797956	11294786	503170	154666	3057172	277012	3334184	3281096	yeast.S_pseudosimplitigs.k_16.d_7.M_zeros
yeast	pseudosimplitigs	16	8	default	11294786	11821249	11294786	526463	162172	3061724	281516	3343240	3291676	yeast.S_pseudosimplitigs.k_16.d_8.M_default
yeast	pseudosimplitigs	16	8	ones	11294786	11821249	11444282	376967	89689	3061724	168640	3230364	3202656	yeast.S_pseudosimplitigs.k_16.d_8.M_ones
yeast	pseudosimplitigs	16	8	runs	11294786	11821249	11437226	384023	84592	3061724	164216	3225940	3198868	yeast.S_pseudosimplitigs.k_16.d_8.M_runs
yeast	pseudosimplitigs	16	8	zeros	11294786	11821249	11294786	526463	164143	3061724	289292	3351016	3296660	yeast.S_pseudosimplitigs.k_16.d_8.M_zeros
yeast	pseudosimplitigs	16	9	default	11294786	11824882	11294786	530096	165391	3061100	283836	3344936	3294284	yeast.S_pseudosimplitigs.k_16.d_9.M_default
yeast	pseudosimplitigs	16	9	ones	11294786	11824882	11445758	379124	93002	3061100	170688	3231788	3204060	yeast.S_pseudosimplitigs.k_16.d_9.M_ones
yeast	pseudosimplitigs	16	9	runs	11294786	11824882	11438323	386559	87633	3061100	166116	3227216	3200684	yeast.S_pseudosimplitigs.k_16.d_9.M_runs
yeast	pseudosimplitigs	16	9	zeros	11294786	11824882	11294786	530096	168354	3061100	294028	3355128	3299772	yeast.S_pseudosimplitigs.k_16.d_9.M_zeros
yeast	pseudosimplitigsAC	16	1	default	11294786	12692771	11294786	1397985	93199	3271568	170668	3442236	3472360	yeast.S_pseudosimplitigsAC.k_16.d_1.M_default
yeast	pseudosimplitigsAC	16	1	ones	11294786	12692771	11474203	1218568	130097	3271568	247312	3518880	3507340	yeast.S_pseudosimplitigsAC.k_16.d_1.M_ones
yeast	pseudosimplitigsAC	16	1	runs	11294786	12692771	11410139	1282632	92020	3271568	200716	3472284	3471628	yeast.S_pseudosimplitigsAC.k_16.d_1.M_runs
yeast	pseudosimplitigsAC	16	1	zeros	11294786	12692771	11294786	1397985	115208	3271568	218368	3489936	3498784	yeast.S_pseudosimplitigsAC.k_16.d_1.M_zeros
yeast	pseudosimplitigsAC	16	10	default	11294786	11795122	11294786	500336	159559	3053556	272088	3325644	3278688	yeast.S_pseudosimplitigsAC.k_16.d_10.M_default
yeast	pseudosimplitigsAC	16	10	ones	11294786	11795122	11444657	350465	86349	3053556	155652	3209208	3186860	yeast.S_pseudosimplitigsAC.k_16.d_10.M_ones
yeast	pseudosimplitigsAC	16	10	runs	11294786	11795122	11438005	357117	81529	3053556	151484	3205040	3183012	yeast.S_pseudosimplitigsAC.k_16.d_10.M_runs
yeast	pseudosimplitigsAC	16	10	zeros	11294786	11795122	11294786	500336	164390	3053556	286904	3340460	3286644	yeast.S_pseudosimplitigsAC.k_16.d_10.M_zeros
yeast	pseudosimplitigsAC	16	11	default	11294786	11793521	11294786	498735	159729	3053644	272424	3326068	3278288	yeast.S_pseudosimplitigsAC.k_16.d_11.M_default
yeast	pseudosimplitigsAC	16	11	ones	11294786	11793521	11445085	348436	86552	3053644	155860	3209504	3187404	yeast.S_pseudosimplitigsAC.k_16.d_11.M_ones
yeast	pseudosimplitigsAC	16	11	runs	11294786	11793521	11438351	355170	81637	3053644	151568	3205212	3183880	yeast.S_pseudosimplitigsAC.k_16.d_11.M_runs
yeast	pseudosimplitigsAC	16	11	zeros	11294786	11793521	11294786	498735	165211	3053644	288496	3342140	3288188	yeast.S_pseudosimplitigsAC.k_16.d_11.M_zeros
yeast	pseudosimplitigsAC	16	12	default	11294786	11792276	11294786	497490	159748	3052220	272496	3324716	3278672	yeast.S_pseudosimplitigsAC.k_16.d_12.M_default
yeast	pseudosimplitigsAC	16	12	ones	11294786	11792276	11445129	347147	86575	3052220	155852	3208072	3184972	yeast.S_pseudosimplitigsAC.k_16.d_12.M_ones
yeast	pseudosimplitigsAC	16	12	runs	11294786	11792276	11438303	353973	81617	3052220	151552	3203772	3184080	yeast.S_pseudosimplitigsAC.k_16.d_12.M_runs
yeast	pseudosimplitigsAC	16	12	zeros	11294786	11792276	11294786	497490	165272	3052220	288780	3341000	3287484	yeast.S_pseudosimplitigsAC.k_16.d_12.M_zeros
yeast	pseudosimplitigsAC	16	2	default	11294786	11930570	11294786	635784	103630	3089308	204628	3293936	3265724	yeast.S_pseudosimplitigsAC.k_16.d_2.M_default
yeast	pseudosimplitigsAC	16	2	ones	11294786	11930570	11425515	505055	61690	3089308	135884	3225192	3205004	yeast.S_pseudosimplitigsAC.k_16.d_2.M_ones
yeast	pseudosimplitigsAC	16	2	runs	11294786	11930570	11398595	531975	45919	3089308	116628	3205936	3190224	yeast.S_pseudosimplitigsAC.k_16.d_2.M_runs
yeast	pseudosimplitigsAC	16	2	zeros	11294786	11930570	11294786	635784	108112	3089308	213928	3303236	3270448	yeast.S_pseudosimplitigsAC.k_16.d_2.M_zeros
yeast	pseudosimplitigsAC	16	3	default	11294786	11736218	11294786	441432	113000	3043188	221508	3264696	3218268	yeast.S_pseudosimplitigsAC.k_16.d_3.M_default
yeast	pseudosimplitigsAC	16	3	ones	11294786	11736218	11426452	309766	48042	3043188	111364	3154552	3128516	yeast.S_pseudosimplitigsAC.k_16.d_3.M_ones
yeast	pseudosimplitigsAC	16	3	runs	11294786	11736218	11411934	324284	39416	3043188	101192	3144380	3121652	yeast.S_pseudosimplitigsAC.k_16.d_3.M_runs
yeast	pseudosimplitigsAC	16	3	zeros	11294786	11736218	11294786	441432	113921	3043188	223468	3266656	3218564	yeast.S_pseudosimplitigsAC.k_16.d_3.M_zeros
yeast	pseudosimplitigsAC	16	4	default	11294786	11709229	11294786	414443	121746	3036472	233964	3270436	3219724	yeast.S_pseudosimplitigsAC.k_16.d_4.M_default
yeast	pseudosimplitigsAC	16	4	ones	11294786	11709229	11429974	279255	51038	3036472	117832	3154304	3125176	yeast.S_pseudosimplitigsAC.k_16.d_4.M_ones
yeast	pseudosimplitigsAC	16	4	runs	11294786	11709229	11420151	289078	44939	3036472	110980	3147452	3120592	yeast.S_pseudosimplitigsAC.k_16.d_4.M_runs
yeast	pseudosimplitigsAC	16	4	zeros	11294786	11709229	11294786	414443	121964	3036472	234484	3270956	3220084	yeast.S_pseudosimplitigsAC.k_16.d_4.M_zeros
yeast	pseudosimplitigsAC	16	5	default	11294786	11723283	11294786	428497	130917	3039520	246496	3286016	3234548	yeast.S_pseudosimplitigsAC.k_16.d_5.M_default
yeast	pseudosimplitigsAC	16	5	ones	11294786	11723283	11432633	290650	58382	3039520	130400	3169920	3139744	yeast.S_pseudosimplitigsAC.k_16.d_5.M_ones
yeast	pseudosimplitigsAC	16	5	runs	11294786	11723283	11425248	298035	53456	3039520	125200	3164720	3136456	yeast.S_pseudosimplitigsAC.k_16.d_5.M_runs
yeast	pseudosimplitigsAC	16	5	zeros	11294786	11723283	11294786	428497	130972	3039520	246972	3286492	3235480	yeast.S_pseudosimplitigsAC.k_16.d_5.M_zeros
yeast	pseudosimplitigsAC	16	6	default	11294786	11751437	11294786	456651	140601	3045920	257044	3302964	3252716	yeast.S_pseudosimplitigsAC.k_16.d_6.M_default
yeast	pseudosimplitigsAC	16	6	ones	11294786	11751437	11436514	314923	67517	3045920	141128	3187048	3157896	yeast.S_pseudosimplitigsAC.k_16.d_6.M_ones
yeast	pseudosimplitigsAC	16	6	runs	11294786	11751437	11429971	321466	62968	3045920	136856	3182776	3155436	yeast.S_pseudosimplitigsAC.k_16.d_6.M_runs
yeast	pseudosimplitigsAC	16	6	zeros	11294786	11751437	11294786	456651	140756	3045920	257908	3303828	3252128	yeast.S_pseudosimplitigsAC.k_16.d_6.M_zeros
yeast	pseudosimplitigsAC	16	7	default	11294786	11777323	11294786	482537	148772	3050912	263992	3314904	3267308	yeast.S_pseudosimplitigsAC.k_16.d_7.M_default
yeast	pseudosimplitigsAC	16	7	ones	11294786	11777323	11440203	337120	75636	3050912	147528	3198440	3173508	yeast.S_pseudosimplitigsAC.k_16.d_7.M_ones
yeast	pseudosimplitigsAC	16	7	runs	11294786	11777323	11433707	343616	71020	3050912	143356	3194268	3171104	yeast.S_pseudosimplitigsAC.k_16.d_7.M_runs
yeast	pseudosimplitigsAC	16	7	zeros	11294786	11777323	11294786	482537	148958	3050912	264868	3315780	3267136	yeast.S_pseudosimplitigsAC.k_16.d_7.M_zeros
yeast	pseudosimplitigsAC	16	8	default	11294786	11795199	11294786	500413	155476	3054140	269368	3323508	3275964	yeast.S_pseudosimplitigsAC.k_16.d_8.M_default
yeast	pseudosimplitigsAC	16	8	ones	11294786	11795199	11443044	352155	82287	3054140	152960	3207100	3184140	yeast.S_pseudosimplitigsAC.k_16.d_8.M_ones
yeast	pseudosimplitigsAC	16	8	runs	11294786	11795199	11436445	358754	77560	3054140	148840	3202980	3181136	yeast.S_pseudosimplitigsAC.k_16.d_8.M_runs
yeast	pseudosimplitigsAC	16	8	zeros	11294786	11795199	11294786	500413	156705	3054140	274044	3328184	3279012	yeast.S_pseudosimplitigsAC.k_16.d_8.M_zeros
yeast	pseudosimplitigsAC	16	9	default	11294786	11798462	11294786	503676	158706	3054284	271732	3326016	3280736	yeast.S_pseudosimplitigsAC.k_16.d_9.M_default
yeast	pseudosimplitigsAC	16	9	ones	11294786	11798462	11444463	353999	85483	3054284	155352	3209636	3188072	yeast.S_pseudosimplitigsAC.k_16.d_9.M_ones
yeast	pseudosimplitigsAC	16	9	runs	11294786	11798462	11437680	360782	80622	3054284	151128	3205412	3184460	yeast.S_pseudosimplitigsAC.k_16.d_9.M_runs
yeast	pseudosimplitigsAC	16	9	zeros	11294786	11798462	11294786	503676	161643	3054284	281980	3336264	3285684	yeast.S_pseudosimplitigsAC.k_16.d_9.M_zeros
yeast	pseudosimplitigs	17	1	default	11409525	12024485	11409525	614960	38435	3106372	89080	3195452	3200832	yeast.S_pseudosimplitigs.k_17.d_1.M_default
yeast	pseudosimplitigs	17	1	ones	11409525	12024485	11474083	550402	47536	3106372	113816	3220188	3212624	yeast.S_pseudosimplitigs.k_17.d_1.M_ones
yeast	pseudosimplitigs	17	1	runs	11409525	12024485	11457234	567251	38080	3106372	100676	3207048	3199428	yeast.S_pseudosimplitigs.k_17.d_1.M_runs
yeast	pseudosimplitigs	17	1	zeros	11409525	12024485	11409525	614960	44730	3106372	105116	3211488	3209168	yeast.S_pseudosimplitigs.k_17.d_1.M_zeros
yeast	pseudosimplitigs	17	10	default	11409525	11714240	11409525	304715	71809	3031820	150944	3182764	3152024	yeast.S_pseudosimplitigs.k_17.d_10.M_default
yeast	pseudosimplitigs	17	10	ones	11409525	11714240	11476675	237565	42512	3031820	87360	3119180	3108888	yeast.S_pseudosimplitigs.k_17.d_10.M_ones
yeast	pseudosimplitigs	17	10	runs	11409525	11714240	11474105	240135	40705	3031820	85808	3117628	3106688	yeast.S_pseudosimplitigs.k_17.d_10.M_runs
yeast	pseudosimplitigs	17	10	zeros	11409525	11714240	11409525	304715	73437	3031820	157440	3189260	3153996	yeast.S_pseudosimplitigs.k_17.d_10.M_zeros
yeast	pseudosimplitigs	17	11	default	11409525	11717928	11409525	308403	72795	3031528	151616	3183144	3153320	yeast.S_pseudosimplitigs.k_17.d_11.M_default
yeast	pseudosimplitigs	17	11	ones	11409525	11717928	11477215	240713	43586	3031528	88052	3119580	3109464	yeast.S_pseudosimplitigs.k_17.d_11.M_ones
yeast	pseudosimplitigs	17	11	runs	11409525	11717928	11474345	243583	41637	3031528	86288	3117816	3107824	yeast.S_pseudosimplitigs.k_17.d_11.M_runs
yeast	pseudosimplitigs	17	11	zeros	11409525	11717928	11409525	308403	74634	3031528	158804	3190332	3156040	yeast.S_pseudosimplitigs.k_17.d_11.M_zeros
yeast	pseudosimplitigs	17	12	default	11409525	11718442	11409525	308917	73043	3031600	151948	3183548	3153548	yeast.S_pseudosimplitigs.k_17.d_12.M_default
yeast	pseudosimplitigs	17	12	ones	11409525	11718442	11477537	240905	43921	3031600	88336	3119936	3109252	yeast.S_pseudosimplitigs.k_17.d_12.M_ones
yeast	pseudosimplitigs	17	12	runs	11409525	11718442	11474511	243931	41915	3031600	86552	3118152	3107916	yeast.S_pseudosimplitigs.k_17.d_12.M_runs
yeast	pseudosimplitigs	17	12	zeros	11409525	11718442	11409525	308917	75148	3031600	159976	3191576	3156776	yeast.S_pseudosimplitigs.k_17.d_12.M_zeros
yeast	pseudosimplitigs	17	2	default	11409525	11714558	11409525	305033	41753	3033700	104276	3137976	3113320	yeast.S_pseudosimplitigs.k_17.d_2.M_default
yeast	pseudosimplitigs	17	2	ones	11409525	11714558	11460248	254310	24559	3033700	64200	3097900	3087656	yeast.S_pseudosimplitigs.k_17.d_2.M_ones
yeast	pseudosimplitigs	17	2	runs	11409525	11714558	11452143	262415	20074	3033700	58100	3091800	3082792	yeast.S_pseudosimplitigs.k_17.d_2.M_runs
yeast	pseudosimplitigs	17	2	zeros	11409525	11714558	11409525	305033	43181	3033700	107864	3141564	3114528	yeast.S_pseudosimplitigs.k_17.d_2.M_zeros
yeast	pseudosimplitigs	17	3	default	11409525	11633682	11409525	224157	44376	3012936	111432	3124368	3093576	yeast.S_pseudosimplitigs.k_17.d_3.M_default
yeast	pseudosimplitigs	17	3	ones	11409525	11633682	11461021	172661	19274	3012936	52328	3065264	3054692	yeast.S_pseudosimplitigs.k_17.d_3.M_ones
yeast	pseudosimplitigs	17	3	runs	11409525	11633682	11456351	177331	16712	3012936	48952	3061888	3052116	yeast.S_pseudosimplitigs.k_17.d_3.M_runs
yeast	pseudosimplitigs	17	3	zeros	11409525	11633682	11409525	224157	44674	3012936	112240	3125176	3093944	yeast.S_pseudosimplitigs.k_17.d_3.M_zeros
yeast	pseudosimplitigs	17	4	default	11409525	11614950	11409525	205425	47037	3009316	117344	3126660	3093292	yeast.S_pseudosimplitigs.k_17.d_4.M_default
yeast	pseudosimplitigs	17	4	ones	11409525	11614950	11462822	152128	19300	3009316	53232	3062548	3049092	yeast.S_pseudosimplitigs.k_17.d_4.M_ones
yeast	pseudosimplitigs	17	4	runs	11409525	11614950	11459851	155099	17590	3009316	50940	3060256	3048252	yeast.S_pseudosimplitigs.k_17.d_4.M_runs
yeast	pseudosimplitigs	17	4	zeros	11409525	11614950	11409525	205425	47103	3009316	117544	3126860	3092616	yeast.S_pseudosimplitigs.k_17.d_4.M_zeros
yeast	pseudosimplitigs	17	5	default	11409525	11614053	11409525	204528	50048	3010792	123960	3134752	3097108	yeast.S_pseudosimplitigs.k_17.d_5.M_default
yeast	pseudosimplitigs	17	5	ones	11409525	11614053	11465897	148156	21178	3010792	58480	3069272	3053104	yeast.S_pseudosimplitigs.k_17.d_5.M_ones
yeast	pseudosimplitigs	17	5	runs	11409525	11614053	11463719	150334	19790	3010792	56764	3067556	3052004	yeast.S_pseudosimplitigs.k_17.d_5.M_runs
yeast	pseudosimplitigs	17	5	zeros	11409525	11614053	11409525	204528	50080	3010792	124080	3134872	3097480	yeast.S_pseudosimplitigs.k_17.d_5.M_zeros
yeast	pseudosimplitigs	17	6	default	11409525	11625469	11409525	215944	53608	3013672	130624	3144296	3105980	yeast.S_pseudosimplitigs.k_17.d_6.M_default
yeast	pseudosimplitigs	17	6	ones	11409525	11625469	11467782	157687	24359	3013672	65416	3079088	3061724	yeast.S_pseudosimplitigs.k_17.d_6.M_ones
yeast	pseudosimplitigs	17	6	runs	11409525	11625469	11465907	159562	23107	3013672	63924	3077596	3061068	yeast.S_pseudosimplitigs.k_17.d_6.M_runs
yeast	pseudosimplitigs	17	6	zeros	11409525	11625469	11409525	215944	53634	3013672	130668	3144340	3105808	yeast.S_pseudosimplitigs.k_17.d_6.M_zeros
yeast	pseudosimplitigs	17	7	default	11409525	11648006	11409525	238481	58573	3018108	138648	3156756	3121472	yeast.S_pseudosimplitigs.k_17.d_7.M_default
yeast	pseudosimplitigs	17	7	ones	11409525	11648006	11470031	177975	29197	3018108	74200	3092308	3075424	yeast.S_pseudosimplitigs.k_17.d_7.M_ones
yeast	pseudosimplitigs	17	7	runs	11409525	11648006	11468261	179745	27941	3018108	72820	3090928	3074404	yeast.S_pseudosimplitigs.k_17.d_7.M_runs
yeast	pseudosimplitigs	17	7	zeros	11409525	11648006	11409525	238481	58785	3018108	139376	3157484	3121208	yeast.S_pseudosimplitigs.k_17.d_7.M_zeros
yeast	pseudosimplitigs	17	8	default	11409525	11678809	11409525	269284	64416	3024748	145236	3169984	3136288	yeast.S_pseudosimplitigs.k_17.d_8.M_default
yeast	pseudosimplitigs	17	8	ones	11409525	11678809	11473533	205276	35131	3024748	81280	3106028	3090108	yeast.S_pseudosimplitigs.k_17.d_8.M_ones
yeast	pseudosimplitigs	17	8	runs	11409525	11678809	11471439	207370	33663	3024748	79828	3104576	3089332	yeast.S_pseudosimplitigs.k_17.d_8.M_runs
yeast	pseudosimplitigs	17	8	zeros	11409525	11678809	11409525	269284	65415	3024748	148944	3173692	3136588	yeast.S_pseudosimplitigs.k_17.d_8.M_zeros
yeast	pseudosimplitigs	17	9	default	11409525	11701598	11409525	292073	69013	3029140	149164	3178304	3146160	yeast.S_pseudosimplitigs.k_17.d_9.M_default
yeast	pseudosimplitigs	17	9	ones	11409525	11701598	11475515	226083	39665	3029140	85452	3114592	3102104	yeast.S_pseudosimplitigs.k_17.d_9.M_ones
yeast	pseudosimplitigs	17	9	runs	11409525	11701598	11473176	228422	38027	3029140	83804	3112944	3100364	yeast.S_pseudosimplitigs.k_17.d_9.M_runs
yeast	pseudosimplitigs	17	9	zeros	11409525	11701598	11409525	292073	70482	3029140	155176	3184316	3148948	yeast.S_pseudosimplitigs.k_17.d_9.M_zeros
yeast	pseudosimplitigsAC	17	1	default	11409525	12024373	11409525	614848	38428	3102992	87104	3190096	3197640	yeast.S_pseudosimplitigsAC.k_17.d_1.M_default
yeast	pseudosimplitigsAC	17	1	ones	11409525	12024373	11474470	549903	47639	3102992	112092	3215084	3208520	yeast.S_pseudosimplitigsAC.k_17.d_1.M_ones
yeast	pseudosimplitigsAC	17	1	runs	11409525	12024373	11456864	567509	38006	3102992	98896	3201888	3198392	yeast.S_pseudosimplitigsAC.k_17.d_1.M_runs
yeast	pseudosimplitigsAC	17	1	zeros	11409525	12024373	11409525	614848	44913	3102992	103760	3206752	3207124	yeast.S_pseudosimplitigsAC.k_17.d_1.M_zeros
yeast	pseudosimplitigsAC	17	10	default	11409525	11701224	11409525	291699	69294	3027292	144788	3172080	3144224	yeast.S_pseudosimplitigsAC.k_17.d_10.M_default
yeast	pseudosimplitigsAC	17	10	ones	11409525	11701224	11475809	225415	39699	3027292	80216	3107508	3099716	yeast.S_pseudosimplitigsAC.k_17.d_10.M_ones
yeast	pseudosimplitigsAC	17	10	runs	11409525	11701224	11473466	227758	38054	3027292	78696	3105988	3098992	yeast.S_pseudosimplitigsAC.k_17.d_10.M_runs
yeast	pseudosimplitigsAC	17	10	zeros	11409525	11701224	11409525	291699	69900	3027292	147516	3174808	3145388	yeast.S_pseudosimplitigsAC.k_17.d_10.M_zeros
yeast	pseudosimplitigsAC	17	11	default	11409525	11703327	11409525	293802	70310	3026328	145476	3171804	3146060	yeast.S_pseudosimplitigsAC.k_17.d_11.M_default
yeast	pseudosimplitigsAC	17	11	ones	11409525	11703327	11476353	226974	40724	3026328	80704	3107032	3101256	yeast.S_pseudosimplitigsAC.k_17.d_11.M_ones
yeast	pseudosimplitigsAC	17	11	runs	11409525	11703327	11473935	229392	39007	3026328	79232	3105560	3099828	yeast.S_pseudosimplitigsAC.k_17.d_11.M_runs
yeast	pseudosimplitigsAC	17	11	zeros	11409525	11703327	11409525	293802	70919	3026328	148180	3174508	3146556	yeast.S_pseudosimplitigsAC.k_17.d_11.M_zeros
yeast	pseudosimplitigsAC	17	12	default	11409525	11702082	11409525	292557	70493	3025412	145512	3170924	3144060	yeast.S_pseudosimplitigsAC.k_17.d_12.M_default
yeast	pseudosimplitigsAC	17	12	ones	11409525	11702082	11476521	225561	40937	3025412	80756	3106168	3099556	yeast.S_pseudosimplitigsAC.k_17.d_12.M_ones
yeast	pseudosimplitigsAC	17	12	runs	11409525	11702082	11474025	228057	39153	3025412	79276	3104688	3098580	yeast.S_pseudosimplitigsAC.k_17.d_12.M_runs
yeast	pseudosimplitigsAC	17	12	zeros	11409525	11702082	11409525	292557	71133	3025412	148428	3173840	3145316	yeast.S_pseudosimplitigsAC.k_17.d_12.M_zeros
yeast	pseudosimplitigsAC	17	2	default	11409525	11711835	11409525	302310	41385	3033244	102036	3135280	3112024	yeast.S_pseudosimplitigsAC.k_17.d_2.M_default
yeast	pseudosimplitigsAC	17	2	ones	11409525	11711835	11460178	251657	24001	3033244	61368	3094612	3084072	yeast.S_pseudosimplitigsAC.k_17.d_2.M_ones
yeast	pseudosimplitigsAC	17	2	runs	11409525	11711835	11451976	259859	19529	3033244	55396	3088640	3079556	yeast.S_pseudosimplitigsAC.k_17.d_2.M_runs
yeast	pseudosimplitigsAC	17	2	zeros	11409525	11711835	11409525	302310	42784	3033244	105552	3138796	3113520	yeast.S_pseudosimplitigsAC.k_17.d_2.M_zeros
yeast	pseudosimplitigsAC	17	3	default	11409525	11629268	11409525	219743	43697	3012176	108828	3121004	3092948	yeast.S_pseudosimplitigsAC.k_17.d_3.M_default
yeast	pseudosimplitigsAC	17	3	ones	11409525	11629268	11461491	167777	18359	3012176	48880	3061056	3052948	yeast.S_pseudosimplitigsAC.k_17.d_3.M_ones
yeast	pseudosimplitigsAC	17	3	runs	11409525	11629268	11456821	172447	15779	3012176	45444	3057620	3050488	yeast.S_pseudosimplitigsAC.k_17.d_3.M_runs
yeast	pseudosimplitigsAC	17	3	zeros	11409525	11629268	11409525	219743	44025	3012176	109736	3121912	3091408	yeast.S_pseudosimplitigsAC.k_17.d_3.M_zeros
yeast	pseudosimplitigsAC	17	4	default	11409525	11609439	11409525	199914	46088	3007604	114256	3121860	3091624	yeast.S_pseudosimplitigsAC.k_17.d_4.M_default
yeast	pseudosimplitigsAC	17	4	ones	11409525	11609439	11463313	146126	18135	3007604	49244	3056848	3046468	yeast.S_pseudosimplitigsAC.k_17.d_4.M_ones
yeast	pseudosimplitigsAC	17	4	runs	11409525	11609439	11460275	149164	16413	3007604	46836	3054440	3045252	yeast.S_pseudosimplitigsAC.k_17.d_4.M_runs
yeast	pseudosimplitigsAC	17	4	zeros	11409525	11609439	11409525	199914	46166	3007604	114472	3122076	3089052	yeast.S_pseudosimplitigsAC.k_17.d_4.M_zeros
yeast	pseudosimplitigsAC	17	5	default	11409525	11606392	11409525	196867	48861	3007520	120244	3127764	3095436	yeast.S_pseudosimplitigsAC.k_17.d_5.M_default
yeast	pseudosimplitigsAC	17	5	ones	11409525	11606392	11465888	140504	19699	3007520	53856	3061376	3048128	yeast.S_pseudosimplitigsAC.k_17.d_5.M_ones
yeast	pseudosimplitigsAC	17	5	runs	11409525	11606392	11463785	142607	18358	3007520	52220	3059740	3047012	yeast.S_pseudosimplitigsAC.k_17.d_5.M_runs
yeast	pseudosimplitigsAC	17	5	zeros	11409525	11606392	11409525	196867	48892	3007520	120368	3127888	3093376	yeast.S_pseudosimplitigsAC.k_17.d_5.M_zeros
yeast	pseudosimplitigsAC	17	6	default	11409525	11616557	11409525	207032	51980	3008652	126204	3134856	3100284	yeast.S_pseudosimplitigsAC.k_17.d_6.M_default
yeast	pseudosimplitigsAC	17	6	ones	11409525	11616557	11467708	148849	22612	3008652	60252	3068904	3055504	yeast.S_pseudosimplitigsAC.k_17.d_6.M_ones
yeast	pseudosimplitigsAC	17	6	runs	11409525	11616557	11465936	150621	21415	3008652	58844	3067496	3054304	yeast.S_pseudosimplitigsAC.k_17.d_6.M_runs
yeast	pseudosimplitigsAC	17	6	zeros	11409525	11616557	11409525	207032	51996	3008652	126220	3134872	3100064	yeast.S_pseudosimplitigsAC.k_17.d_6.M_zeros
yeast	pseudosimplitigsAC	17	7	default	11409525	11637512	11409525	227987	56548	3014816	133244	3148060	3113216	yeast.S_pseudosimplitigsAC.k_17.d_7.M_default
yeast	pseudosimplitigsAC	17	7	ones	11409525	11637512	11470219	167293	26952	3014816	68196	3083012	3067544	yeast.S_pseudosimplitigsAC.k_17.d_7.M_ones
yeast	pseudosimplitigsAC	17	7	runs	11409525	11637512	11468470	169042	25766	3014816	66892	3081708	3066248	yeast.S_pseudosimplitigsAC.k_17.d_7.M_runs
yeast	pseudosimplitigsAC	17	7	zeros	11409525	11637512	11409525	227987	56683	3014816	133840	3148656	3113136	yeast.S_pseudosimplitigsAC.k_17.d_7.M_zeros
yeast	pseudosimplitigsAC	17	8	default	11409525	11664764	11409525	255239	61942	3020600	139444	3160044	3127484	yeast.S_pseudosimplitigsAC.k_17.d_8.M_default
yeast	pseudosimplitigsAC	17	8	ones	11409525	11664764	11473060	191704	32145	3020600	74464	3095064	3082476	yeast.S_pseudosimplitigsAC.k_17.d_8.M_ones
yeast	pseudosimplitigsAC	17	8	runs	11409525	11664764	11471212	193552	30849	3020600	73180	3093780	3081488	yeast.S_pseudosimplitigsAC.k_17.d_8.M_runs
yeast	pseudosimplitigsAC	17	8	zeros	11409525	11664764	11409525	255239	62420	3020600	141708	3162308	3129224	yeast.S_pseudosimplitigsAC.k_17.d_8.M_zeros
yeast	pseudosimplitigsAC	17	9	default	11409525	11688331	11409525	278806	66413	3025180	142716	3167896	3138172	yeast.S_pseudosimplitigsAC.k_17.d_9.M_default
yeast	pseudosimplitigsAC	17	9	ones	11409525	11688331	11474910	213421	36732	3025180	77944	3103124	3093948	yeast.S_pseudosimplitigsAC.k_17.d_9.M_ones
yeast	pseudosimplitigsAC	17	9	runs	11409525	11688331	11472830	215501	35279	3025180	76540	3101720	3094324	yeast.S_pseudosimplitigsAC.k_17.d_9.M_runs
yeast	pseudosimplitigsAC	17	9	zeros	11409525	11688331	11409525	278806	66888	3025180	144992	3170172	3140632	yeast.S_pseudosimplitigsAC.k_17.d_9.M_zeros
yeast	pseudosimplitigs	18	1	default	11456651	11770148	11456651	313497	18441	3039420	46332	3085752	3089984	yeast.S_pseudosimplitigs.k_18.d_1.M_default
yeast	pseudosimplitigs	18	1	ones	11456651	11770148	11486297	283851	21648	3039420	56764	3096184	3092456	yeast.S_pseudosimplitigs.k_18.d_1.M_ones
yeast	pseudosimplitigs	18	1	runs	11456651	11770148	11479478	290670	18246	3039420	51968	3091388	3088880	yeast.S_pseudosimplitigs.k_18.d_1.M_runs
yeast	pseudosimplitigs	18	1	zeros	11456651	11770148	11456651	313497	21015	3039420	53448	3092868	3093016	yeast.S_pseudosimplitigs.k_18.d_1.M_zeros
yeast	pseudosimplitigs	18	10	default	11456651	11667987	11456651	211336	36898	3017752	85008	3102760	3089044	yeast.S_pseudosimplitigs.k_18.d_10.M_default
yeast	pseudosimplitigs	18	10	ones	11456651	11667987	11493612	174375	24340	3017752	54384	3072136	3067392	yeast.S_pseudosimplitigs.k_18.d_10.M_ones
yeast	pseudosimplitigs	18	10	runs	11456651	11667987	11492374	175613	23537	3017752	53628	3071380	3066692	yeast.S_pseudosimplitigs.k_18.d_10.M_runs
yeast	pseudosimplitigs	18	10	zeros	11456651	11667987	11456651	211336	36928	3017752	85156	3102908	3088960	yeast.S_pseudosimplitigs.k_18.d_10.M_zeros
yeast	pseudosimplitigs	18	11	default	11456651	11683203	11456651	226552	39318	3021420	87280	3108700	3096740	yeast.S_pseudosimplitigs.k_18.d_11.M_default
yeast	pseudosimplitigs	18	11	ones	11456651	11683203	11494487	188716	26744	3021420	56628	3078048	3075500	yeast.S_pseudosimplitigs.k_18.d_11.M_ones
yeast	pseudosimplitigs	18	11	runs	11456651	11683203	11493106	190097	25846	3021420	55884	3077304	3074336	yeast.S_pseudosimplitigs.k_18.d_11.M_runs
yeast	pseudosimplitigs	18	11	zeros	11456651	11683203	11456651	226552	39600	3021420	88732	3110152	3096616	yeast.S_pseudosimplitigs.k_18.d_11.M_zeros
yeast	pseudosimplitigs	18	12	default	11456651	11690116	11456651	233465	40510	3022276	88140	3110416	3098980	yeast.S_pseudosimplitigs.k_18.d_12.M_default
yeast	pseudosimplitigs	18	12	ones	11456651	11690116	11494865	195251	27980	3022276	57496	3079772	3077940	yeast.S_pseudosimplitigs.k_18.d_12.M_ones
yeast	pseudosimplitigs	18	12	runs	11456651	11690116	11493418	196698	27028	3022276	56748	3079024	3077644	yeast.S_pseudosimplitigs.k_18.d_12.M_runs
yeast	pseudosimplitigs	18	12	zeros	11456651	11690116	11456651	233465	40924	3022276	90056	3112332	3099608	yeast.S_pseudosimplitigs.k_18.d_12.M_zeros
yeast	pseudosimplitigs	18	2	default	11456651	11649599	11456651	192948	19748	3011536	53076	3064612	3056380	yeast.S_pseudosimplitigs.k_18.d_2.M_default
yeast	pseudosimplitigs	18	2	ones	11456651	11649599	11480006	169593	13540	3011536	37144	3048680	3045892	yeast.S_pseudosimplitigs.k_18.d_2.M_ones
yeast	pseudosimplitigs	18	2	runs	11456651	11649599	11476626	172973	11748	3011536	34452	3045988	3043928	yeast.S_pseudosimplitigs.k_18.d_2.M_runs
yeast	pseudosimplitigs	18	2	zeros	11456651	11649599	11456651	192948	20370	3011536	54800	3066336	3057360	yeast.S_pseudosimplitigs.k_18.d_2.M_zeros
yeast	pseudosimplitigs	18	3	default	11456651	11611197	11456651	154546	20878	3003008	56776	3059784	3047728	yeast.S_pseudosimplitigs.k_18.d_3.M_default
yeast	pseudosimplitigs	18	3	ones	11456651	11611197	11480187	131010	11332	3003008	31784	3034792	3031800	yeast.S_pseudosimplitigs.k_18.d_3.M_ones
yeast	pseudosimplitigs	18	3	runs	11456651	11611197	11478075	133122	10235	3003008	30104	3033112	3031084	yeast.S_pseudosimplitigs.k_18.d_3.M_runs
yeast	pseudosimplitigs	18	3	zeros	11456651	11611197	11456651	154546	21026	3003008	57296	3060304	3047636	yeast.S_pseudosimplitigs.k_18.d_3.M_zeros
yeast	pseudosimplitigs	18	4	default	11456651	11592849	11456651	136198	21678	2998724	59296	3058020	3044180	yeast.S_pseudosimplitigs.k_18.d_4.M_default
yeast	pseudosimplitigs	18	4	ones	11456651	11592849	11482442	110407	10542	2998724	30268	3028992	3024896	yeast.S_pseudosimplitigs.k_18.d_4.M_ones
yeast	pseudosimplitigs	18	4	runs	11456651	11592849	11480992	111857	9773	2998724	29204	3027928	3024316	yeast.S_pseudosimplitigs.k_18.d_4.M_runs
yeast	pseudosimplitigs	18	4	zeros	11456651	11592849	11456651	136198	21726	2998724	59412	3058136	3044512	yeast.S_pseudosimplitigs.k_18.d_4.M_zeros
yeast	pseudosimplitigs	18	5	default	11456651	11589656	11456651	133005	22775	2998608	62304	3060912	3045512	yeast.S_pseudosimplitigs.k_18.d_5.M_default
yeast	pseudosimplitigs	18	5	ones	11456651	11589656	11483889	105767	10948	2998608	31816	3030424	3024736	yeast.S_pseudosimplitigs.k_18.d_5.M_ones
yeast	pseudosimplitigs	18	5	runs	11456651	11589656	11482940	106716	10367	2998608	31028	3029636	3024832	yeast.S_pseudosimplitigs.k_18.d_5.M_runs
yeast	pseudosimplitigs	18	5	zeros	11456651	11589656	11456651	133005	22796	2998608	62460	3061068	3045512	yeast.S_pseudosimplitigs.k_18.d_5.M_zeros
yeast	pseudosimplitigs	18	6	default	11456651	11590798	11456651	134147	24029	2998948	65680	3064628	3047604	yeast.S_pseudosimplitigs.k_18.d_6.M_default
yeast	pseudosimplitigs	18	6	ones	11456651	11590798	11485036	105762	11780	2998948	34700	3033648	3027008	yeast.S_pseudosimplitigs.k_18.d_6.M_ones
yeast	pseudosimplitigs	18	6	runs	11456651	11590798	11484373	106425	11331	2998948	34136	3033084	3026448	yeast.S_pseudosimplitigs.k_18.d_6.M_runs
yeast	pseudosimplitigs	18	6	zeros	11456651	11590798	11456651	134147	24048	2998948	65768	3064716	3048604	yeast.S_pseudosimplitigs.k_18.d_6.M_zeros
yeast	pseudosimplitigs	18	7	default	11456651	11599850	11456651	143199	26235	3000668	70864	3071532	3054380	yeast.S_pseudosimplitigs.k_18.d_7.M_default
yeast	pseudosimplitigs	18	7	ones	11456651	11599850	11487778	112072	13869	3000668	39928	3040596	3032952	yeast.S_pseudosimplitigs.k_18.d_7.M_ones
yeast	pseudosimplitigs	18	7	runs	11456651	11599850	11486938	112912	13319	3000668	39252	3039920	3032612	yeast.S_pseudosimplitigs.k_18.d_7.M_runs
yeast	pseudosimplitigs	18	7	zeros	11456651	11599850	11456651	143199	26258	3000668	70932	3071600	3053908	yeast.S_pseudosimplitigs.k_18.d_7.M_zeros
yeast	pseudosimplitigs	18	8	default	11456651	11617243	11456651	160592	29294	3005828	76664	3082492	3064412	yeast.S_pseudosimplitigs.k_18.d_8.M_default
yeast	pseudosimplitigs	18	8	ones	11456651	11617243	11489654	127589	16743	3005828	46004	3051832	3042600	yeast.S_pseudosimplitigs.k_18.d_8.M_ones
yeast	pseudosimplitigs	18	8	runs	11456651	11617243	11488826	128417	16216	3005828	45392	3051220	3042324	yeast.S_pseudosimplitigs.k_18.d_8.M_runs
yeast	pseudosimplitigs	18	8	zeros	11456651	11617243	11456651	160592	29308	3005828	76680	3082508	3064656	yeast.S_pseudosimplitigs.k_18.d_8.M_zeros
yeast	pseudosimplitigs	18	9	default	11456651	11641889	11456651	185238	32971	3011672	81468	3093140	3077048	yeast.S_pseudosimplitigs.k_18.d_9.M_default
yeast	pseudosimplitigs	18	9	ones	11456651	11641889	11491710	150179	20323	3011672	50580	3062252	3055428	yeast.S_pseudosimplitigs.k_18.d_9.M_ones
yeast	pseudosimplitigs	18	9	runs	11456651	11641889	11490771	151118	19708	3011672	49948	3061620	3054780	yeast.S_pseudosimplitigs.k_18.d_9.M_runs
yeast	pseudosimplitigs	18	9	zeros	11456651	11641889	11456651	185238	33024	3011672	81656	3093328	3076604	yeast.S_pseudosimplitigs.k_18.d_9.M_zeros
yeast	pseudosimplitigsAC	18	1	default	11456651	11770216	11456651	313565	18445	3039540	45404	3084944	3089688	yeast.S_pseudosimplitigsAC.k_18.d_1.M_default
yeast	pseudosimplitigsAC	18	1	ones	11456651	11770216	11486364	283852	21830	3039540	56300	3095840	3093808	yeast.S_pseudosimplitigsAC.k_18.d_1.M_ones
yeast	pseudosimplitigsAC	18	1	runs	11456651	11770216	11478843	291373	18217	3039540	50972	3090512	3089192	yeast.S_pseudosimplitigsAC.k_18.d_1.M_runs
yeast	pseudosimplitigsAC	18	1	zeros	11456651	11770216	11456651	313565	20846	3039540	52416	3091956	3092996	yeast.S_pseudosimplitigsAC.k_18.d_1.M_zeros
yeast	pseudosimplitigsAC	18	10	default	11456651	11663010	11456651	206359	36057	3015804	83040	3098844	3087588	yeast.S_pseudosimplitigsAC.k_18.d_10.M_default
yeast	pseudosimplitigsAC	18	10	ones	11456651	11663010	11493337	169673	23408	3015804	52316	3068120	3064068	yeast.S_pseudosimplitigsAC.k_18.d_10.M_ones
yeast	pseudosimplitigsAC	18	10	runs	11456651	11663010	11492170	170840	22647	3015804	51592	3067396	3064632	yeast.S_pseudosimplitigsAC.k_18.d_10.M_runs
yeast	pseudosimplitigsAC	18	10	zeros	11456651	11663010	11456651	206359	36324	3015804	84216	3100020	3086160	yeast.S_pseudosimplitigsAC.k_18.d_10.M_zeros
yeast	pseudosimplitigsAC	18	11	default	11456651	11678475	11456651	221824	38525	3018364	84544	3102908	3093692	yeast.S_pseudosimplitigsAC.k_18.d_11.M_default
yeast	pseudosimplitigsAC	18	11	ones	11456651	11678475	11494162	184313	25869	3018364	53820	3072184	3070668	yeast.S_pseudosimplitigsAC.k_18.d_11.M_ones
yeast	pseudosimplitigsAC	18	11	runs	11456651	11678475	11492894	185581	25034	3018364	53156	3071520	3070792	yeast.S_pseudosimplitigsAC.k_18.d_11.M_runs
yeast	pseudosimplitigsAC	18	11	zeros	11456651	11678475	11456651	221824	38792	3018364	85768	3104132	3092704	yeast.S_pseudosimplitigsAC.k_18.d_11.M_zeros
yeast	pseudosimplitigsAC	18	12	default	11456651	11682843	11456651	226192	39465	3017932	85144	3103076	3095224	yeast.S_pseudosimplitigsAC.k_18.d_12.M_default
yeast	pseudosimplitigsAC	18	12	ones	11456651	11682843	11494549	188294	26800	3017932	54348	3072280	3072320	yeast.S_pseudosimplitigsAC.k_18.d_12.M_ones
yeast	pseudosimplitigsAC	18	12	runs	11456651	11682843	11493235	189608	25923	3017932	53652	3071584	3072640	yeast.S_pseudosimplitigsAC.k_18.d_12.M_runs
yeast	pseudosimplitigsAC	18	12	zeros	11456651	11682843	11456651	226192	39730	3017932	86340	3104272	3094684	yeast.S_pseudosimplitigsAC.k_18.d_12.M_zeros
yeast	pseudosimplitigsAC	18	2	default	11456651	11649135	11456651	192484	19668	3012392	52040	3064432	3056924	yeast.S_pseudosimplitigsAC.k_18.d_2.M_default
yeast	pseudosimplitigsAC	18	2	ones	11456651	11649135	11480271	168864	13441	3012392	36136	3048528	3045500	yeast.S_pseudosimplitigsAC.k_18.d_2.M_ones
yeast	pseudosimplitigsAC	18	2	runs	11456651	11649135	11476758	172377	11642	3012392	33412	3045804	3043692	yeast.S_pseudosimplitigsAC.k_18.d_2.M_runs
yeast	pseudosimplitigsAC	18	2	zeros	11456651	11649135	11456651	192484	20287	3012392	53804	3066196	3056824	yeast.S_pseudosimplitigsAC.k_18.d_2.M_zeros
yeast	pseudosimplitigsAC	18	3	default	11456651	11610006	11456651	153355	20602	3003884	55436	3059320	3047740	yeast.S_pseudosimplitigsAC.k_18.d_3.M_default
yeast	pseudosimplitigsAC	18	3	ones	11456651	11610006	11480809	129197	11035	3003884	30292	3034176	3031176	yeast.S_pseudosimplitigsAC.k_18.d_3.M_ones
yeast	pseudosimplitigsAC	18	3	runs	11456651	11610006	11478656	131350	9949	3003884	28580	3032464	3030280	yeast.S_pseudosimplitigsAC.k_18.d_3.M_runs
yeast	pseudosimplitigsAC	18	3	zeros	11456651	11610006	11456651	153355	20803	3003884	56092	3059976	3047760	yeast.S_pseudosimplitigsAC.k_18.d_3.M_zeros
yeast	pseudosimplitigsAC	18	4	default	11456651	11591620	11456651	134969	21442	2998896	58040	3056936	3043732	yeast.S_pseudosimplitigsAC.k_18.d_4.M_default
yeast	pseudosimplitigsAC	18	4	ones	11456651	11591620	11482708	108912	10192	2998896	28740	3027636	3024820	yeast.S_pseudosimplitigsAC.k_18.d_4.M_ones
yeast	pseudosimplitigsAC	18	4	runs	11456651	11591620	11481284	110336	9435	2998896	27580	3026476	3023960	yeast.S_pseudosimplitigsAC.k_18.d_4.M_runs
yeast	pseudosimplitigsAC	18	4	zeros	11456651	11591620	11456651	134969	21503	2998896	58216	3057112	3043788	yeast.S_pseudosimplitigsAC.k_18.d_4.M_zeros
yeast	pseudosimplitigsAC	18	5	default	11456651	11587843	11456651	131192	22493	2998276	60920	3059196	3045808	yeast.S_pseudosimplitigsAC.k_18.d_5.M_default
yeast	pseudosimplitigsAC	18	5	ones	11456651	11587843	11484127	103716	10545	2998276	30160	3028436	3024316	yeast.S_pseudosimplitigsAC.k_18.d_5.M_ones
yeast	pseudosimplitigsAC	18	5	runs	11456651	11587843	11483216	104627	9996	2998276	29364	3027640	3024032	yeast.S_pseudosimplitigsAC.k_18.d_5.M_runs
yeast	pseudosimplitigsAC	18	5	zeros	11456651	11587843	11456651	131192	22515	2998276	60992	3059268	3046148	yeast.S_pseudosimplitigsAC.k_18.d_5.M_zeros
yeast	pseudosimplitigsAC	18	6	default	11456651	11589365	11456651	132714	23690	2999068	64264	3063332	3046768	yeast.S_pseudosimplitigsAC.k_18.d_6.M_default
yeast	pseudosimplitigsAC	18	6	ones	11456651	11589365	11485414	103951	11451	2999068	32928	3031996	3026512	yeast.S_pseudosimplitigsAC.k_18.d_6.M_ones
yeast	pseudosimplitigsAC	18	6	runs	11456651	11589365	11484642	104723	10934	2999068	32392	3031460	3025680	yeast.S_pseudosimplitigsAC.k_18.d_6.M_runs
yeast	pseudosimplitigsAC	18	6	zeros	11456651	11589365	11456651	132714	23708	2999068	64404	3063472	3047196	yeast.S_pseudosimplitigsAC.k_18.d_6.M_zeros
yeast	pseudosimplitigsAC	18	7	default	11456651	11597667	11456651	141016	25792	3000028	69140	3069168	3053804	yeast.S_pseudosimplitigsAC.k_18.d_7.M_default
yeast	pseudosimplitigsAC	18	7	ones	11456651	11597667	11487825	109842	13319	3000028	37988	3038016	3031480	yeast.S_pseudosimplitigsAC.k_18.d_7.M_ones
yeast	pseudosimplitigsAC	18	7	runs	11456651	11597667	11487040	110627	12790	3000028	37428	3037456	3030948	yeast.S_pseudosimplitigsAC.k_18.d_7.M_runs
yeast	pseudosimplitigsAC	18	7	zeros	11456651	11597667	11456651	141016	25804	3000028	69180	3069208	3054092	yeast.S_pseudosimplitigsAC.k_18.d_7.M_zeros
yeast	pseudosimplitigsAC	18	8	default	11456651	11612721	11456651	156070	28438	3003948	73952	3077900	3061892	yeast.S_pseudosimplitigsAC.k_18.d_8.M_default
yeast	pseudosimplitigsAC	18	8	ones	11456651	11612721	11489639	123082	15878	3003948	43160	3047108	3040568	yeast.S_pseudosimplitigsAC.k_18.d_8.M_ones
yeast	pseudosimplitigsAC	18	8	runs	11456651	11612721	11488836	123885	15346	3003948	42564	3046512	3039564	yeast.S_pseudosimplitigsAC.k_18.d_8.M_runs
yeast	pseudosimplitigsAC	18	8	zeros	11456651	11612721	11456651	156070	28535	3003948	74376	3078324	3061520	yeast.S_pseudosimplitigsAC.k_18.d_8.M_zeros
yeast	pseudosimplitigsAC	18	9	default	11456651	11637338	11456651	180687	32155	3009460	79232	3088692	3074392	yeast.S_pseudosimplitigsAC.k_18.d_9.M_default
yeast	pseudosimplitigsAC	18	9	ones	11456651	11637338	11491549	145789	19565	3009460	48484	3057944	3053112	yeast.S_pseudosimplitigsAC.k_18.d_9.M_ones
yeast	pseudosimplitigsAC	18	9	runs	11456651	11637338	11490558	146780	18919	3009460	47860	3057320	3053832	yeast.S_pseudosimplitigsAC.k_18.d_9.M_runs
yeast	pseudosimplitigsAC	18	9	zeros	11456651	11637338	11456651	180687	32363	3009460	80156	3089616	3074428	yeast.S_pseudosimplitigsAC.k_18.d_9.M_zeros
yeast	pseudosimplitigs	19	1	default	11479729	11692201	11479729	212472	11804	3015276	29652	3044928	3052456	yeast.S_pseudosimplitigs.k_19.d_1.M_default
yeast	pseudosimplitigs	19	1	ones	11479729	11692201	11496350	195851	13374	3015276	35768	3051044	3056004	yeast.S_pseudosimplitigs.k_19.d_1.M_ones
yeast	pseudosimplitigs	19	1	runs	11479729	11692201	11492960	199241	11699	3015276	33208	3048484	3051484	yeast.S_pseudosimplitigs.k_19.d_1.M_runs
yeast	pseudosimplitigs	19	1	zeros	11479729	11692201	11479729	212472	12954	3015276	33180	3048456	3053624	yeast.S_pseudosimplitigs.k_19.d_1.M_zeros
yeast	pseudosimplitigs	19	10	default	11479729	11637841	11479729	158112	22289	3006860	56000	3062860	3057396	yeast.S_pseudosimplitigs.k_19.d_10.M_default
yeast	pseudosimplitigs	19	10	ones	11479729	11637841	11505672	132169	15225	3006860	39304	3046164	3042476	yeast.S_pseudosimplitigs.k_19.d_10.M_ones
yeast	pseudosimplitigs	19	10	runs	11479729	11637841	11505067	132774	14842	3006860	38880	3045740	3042556	yeast.S_pseudosimplitigs.k_19.d_10.M_runs
yeast	pseudosimplitigs	19	10	zeros	11479729	11637841	11479729	158112	22481	3006860	56624	3063484	3059040	yeast.S_pseudosimplitigs.k_19.d_10.M_zeros
yeast	pseudosimplitigs	19	11	default	11479729	11664256	11479729	184527	25627	3014728	59384	3074112	3069604	yeast.S_pseudosimplitigs.k_19.d_11.M_default
yeast	pseudosimplitigs	19	11	ones	11479729	11664256	11507120	157136	18524	3014728	42548	3057276	3055664	yeast.S_pseudosimplitigs.k_19.d_11.M_ones
yeast	pseudosimplitigs	19	11	runs	11479729	11664256	11506348	157908	18062	3014728	42080	3056808	3054504	yeast.S_pseudosimplitigs.k_19.d_11.M_runs
yeast	pseudosimplitigs	19	11	zeros	11479729	11664256	11479729	184527	25723	3014728	59668	3074396	3068972	yeast.S_pseudosimplitigs.k_19.d_11.M_zeros
yeast	pseudosimplitigs	19	12	default	11479729	11680948	11479729	201219	27865	3017668	60952	3078620	3076076	yeast.S_pseudosimplitigs.k_19.d_12.M_default
yeast	pseudosimplitigs	19	12	ones	11479729	11680948	11507858	173090	20790	3017668	44204	3061872	3062308	yeast.S_pseudosimplitigs.k_19.d_12.M_ones
yeast	pseudosimplitigs	19	12	runs	11479729	11680948	11506937	174011	20206	3017668	43748	3061416	3061888	yeast.S_pseudosimplitigs.k_19.d_12.M_runs
yeast	pseudosimplitigs	19	12	zeros	11479729	11680948	11479729	201219	27965	3017668	61324	3078992	3075612	yeast.S_pseudosimplitigs.k_19.d_12.M_zeros
yeast	pseudosimplitigs	19	2	default	11479729	11634971	11479729	155242	12561	3005240	33380	3038620	3036600	yeast.S_pseudosimplitigs.k_19.d_2.M_default
yeast	pseudosimplitigs	19	2	ones	11479729	11634971	11493725	141246	9829	3005240	27036	3032276	3034000	yeast.S_pseudosimplitigs.k_19.d_2.M_ones
yeast	pseudosimplitigs	19	2	runs	11479729	11634971	11491809	143162	8924	3005240	25504	3030744	3034408	yeast.S_pseudosimplitigs.k_19.d_2.M_runs
yeast	pseudosimplitigs	19	2	zeros	11479729	11634971	11479729	155242	12856	3005240	34328	3039568	3036580	yeast.S_pseudosimplitigs.k_19.d_2.M_zeros
yeast	pseudosimplitigs	19	3	default	11479729	11606952	11479729	127223	13114	2998504	35544	3034048	3030764	yeast.S_pseudosimplitigs.k_19.d_3.M_default
yeast	pseudosimplitigs	19	3	ones	11479729	11606952	11494305	112647	8294	2998504	23568	3022072	3022084	yeast.S_pseudosimplitigs.k_19.d_3.M_ones
yeast	pseudosimplitigs	19	3	runs	11479729	11606952	11493181	113771	7715	2998504	22524	3021028	3021052	yeast.S_pseudosimplitigs.k_19.d_3.M_runs
yeast	pseudosimplitigs	19	3	zeros	11479729	11606952	11479729	127223	13220	2998504	35940	3034444	3030004	yeast.S_pseudosimplitigs.k_19.d_3.M_zeros
yeast	pseudosimplitigs	19	4	default	11479729	11596616	11479729	116887	13633	2996688	37228	3033916	3028680	yeast.S_pseudosimplitigs.k_19.d_4.M_default
yeast	pseudosimplitigs	19	4	ones	11479729	11596616	11495258	101358	7928	2996688	22872	3019560	3017740	yeast.S_pseudosimplitigs.k_19.d_4.M_ones
yeast	pseudosimplitigs	19	4	runs	11479729	11596616	11494575	102041	7521	2996688	22212	3018900	3017044	yeast.S_pseudosimplitigs.k_19.d_4.M_runs
yeast	pseudosimplitigs	19	4	zeros	11479729	11596616	11479729	116887	13666	2996688	37348	3034036	3028952	yeast.S_pseudosimplitigs.k_19.d_4.M_zeros
yeast	pseudosimplitigs	19	5	default	11479729	11591943	11479729	112214	14042	2994896	38676	3033572	3029080	yeast.S_pseudosimplitigs.k_19.d_5.M_default
yeast	pseudosimplitigs	19	5	ones	11479729	11591943	11496644	95299	7837	2994896	23084	3017980	3018220	yeast.S_pseudosimplitigs.k_19.d_5.M_ones
yeast	pseudosimplitigs	19	5	runs	11479729	11591943	11496174	95769	7545	2994896	22652	3017548	3017420	yeast.S_pseudosimplitigs.k_19.d_5.M_runs
yeast	pseudosimplitigs	19	5	zeros	11479729	11591943	11479729	112214	14062	2994896	38780	3033676	3027880	yeast.S_pseudosimplitigs.k_19.d_5.M_zeros
yeast	pseudosimplitigs	19	6	default	11479729	11588779	11479729	109050	14609	2994600	40324	3034924	3029172	yeast.S_pseudosimplitigs.k_19.d_6.M_default
yeast	pseudosimplitigs	19	6	ones	11479729	11588779	11498753	90026	7968	2994600	23732	3018332	3015868	yeast.S_pseudosimplitigs.k_19.d_6.M_ones
yeast	pseudosimplitigs	19	6	runs	11479729	11588779	11498314	90465	7687	2994600	23368	3017968	3015788	yeast.S_pseudosimplitigs.k_19.d_6.M_runs
yeast	pseudosimplitigs	19	6	zeros	11479729	11588779	11479729	109050	14624	2994600	40332	3034932	3028972	yeast.S_pseudosimplitigs.k_19.d_6.M_zeros
yeast	pseudosimplitigs	19	7	default	11479729	11592104	11479729	112375	15521	2994276	43116	3037392	3032588	yeast.S_pseudosimplitigs.k_19.d_7.M_default
yeast	pseudosimplitigs	19	7	ones	11479729	11592104	11500085	92019	8739	2994276	26360	3020636	3018080	yeast.S_pseudosimplitigs.k_19.d_7.M_ones
yeast	pseudosimplitigs	19	7	runs	11479729	11592104	11499657	92447	8476	2994276	26020	3020296	3017772	yeast.S_pseudosimplitigs.k_19.d_7.M_runs
yeast	pseudosimplitigs	19	7	zeros	11479729	11592104	11479729	112375	15533	2994276	43212	3037488	3031332	yeast.S_pseudosimplitigs.k_19.d_7.M_zeros
yeast	pseudosimplitigs	19	8	default	11479729	11599102	11479729	119373	16886	2996864	46616	3043480	3036048	yeast.S_pseudosimplitigs.k_19.d_8.M_default
yeast	pseudosimplitigs	19	8	ones	11479729	11599102	11501657	97445	9959	2996864	29840	3026704	3025468	yeast.S_pseudosimplitigs.k_19.d_8.M_ones
yeast	pseudosimplitigs	19	8	runs	11479729	11599102	11501216	97886	9673	2996864	29520	3026384	3025320	yeast.S_pseudosimplitigs.k_19.d_8.M_runs
yeast	pseudosimplitigs	19	8	zeros	11479729	11599102	11479729	119373	16916	2996864	46716	3043580	3036412	yeast.S_pseudosimplitigs.k_19.d_8.M_zeros
yeast	pseudosimplitigs	19	9	default	11479729	11613453	11479729	133724	19160	3000632	51408	3052040	3045128	yeast.S_pseudosimplitigs.k_19.d_9.M_default
yeast	pseudosimplitigs	19	9	ones	11479729	11613453	11503710	109743	12088	3000632	34488	3035120	3033336	yeast.S_pseudosimplitigs.k_19.d_9.M_ones
yeast	pseudosimplitigs	19	9	runs	11479729	11613453	11503193	110260	11766	3000632	34100	3034732	3031116	yeast.S_pseudosimplitigs.k_19.d_9.M_runs
yeast	pseudosimplitigs	19	9	zeros	11479729	11613453	11479729	133724	19196	3000632	51568	3052200	3043944	yeast.S_pseudosimplitigs.k_19.d_9.M_zeros
yeast	pseudosimplitigsAC	19	1	default	11479729	11692147	11479729	212418	11801	3017152	28964	3046116	3051452	yeast.S_pseudosimplitigsAC.k_19.d_1.M_default
yeast	pseudosimplitigsAC	19	1	ones	11479729	11692147	11497212	194935	13340	3017152	35180	3052332	3053856	yeast.S_pseudosimplitigsAC.k_19.d_1.M_ones
yeast	pseudosimplitigsAC	19	1	runs	11479729	11692147	11493625	198522	11679	3017152	32652	3049804	3051596	yeast.S_pseudosimplitigsAC.k_19.d_1.M_runs
yeast	pseudosimplitigsAC	19	1	zeros	11479729	11692147	11479729	212418	13064	3017152	32876	3050028	3053700	yeast.S_pseudosimplitigsAC.k_19.d_1.M_zeros
yeast	pseudosimplitigsAC	19	10	default	11479729	11635792	11479729	156063	21933	3010328	54596	3064924	3056348	yeast.S_pseudosimplitigsAC.k_19.d_10.M_default
yeast	pseudosimplitigsAC	19	10	ones	11479729	11635792	11505460	130332	14839	3010328	38048	3048376	3043100	yeast.S_pseudosimplitigsAC.k_19.d_10.M_ones
yeast	pseudosimplitigsAC	19	10	runs	11479729	11635792	11504902	130890	14486	3010328	37692	3048020	3043484	yeast.S_pseudosimplitigsAC.k_19.d_10.M_runs
yeast	pseudosimplitigsAC	19	10	zeros	11479729	11635792	11479729	156063	21961	3010328	54660	3064988	3056692	yeast.S_pseudosimplitigsAC.k_19.d_10.M_zeros
yeast	pseudosimplitigsAC	19	11	default	11479729	11662203	11479729	182474	25232	3012416	57976	3070392	3067172	yeast.S_pseudosimplitigsAC.k_19.d_11.M_default
yeast	pseudosimplitigsAC	19	11	ones	11479729	11662203	11506855	155348	18185	3012416	41372	3053788	3054384	yeast.S_pseudosimplitigsAC.k_19.d_11.M_ones
yeast	pseudosimplitigsAC	19	11	runs	11479729	11662203	11505994	156209	17672	3012416	40868	3053284	3054248	yeast.S_pseudosimplitigsAC.k_19.d_11.M_runs
yeast	pseudosimplitigsAC	19	11	zeros	11479729	11662203	11479729	182474	25338	3012416	58452	3070868	3068068	yeast.S_pseudosimplitigsAC.k_19.d_11.M_zeros
yeast	pseudosimplitigsAC	19	12	default	11479729	11680417	11479729	200688	27649	3015740	59636	3075376	3074680	yeast.S_pseudosimplitigsAC.k_19.d_12.M_default
yeast	pseudosimplitigsAC	19	12	ones	11479729	11680417	11507686	172731	20631	3015740	43148	3058888	3062392	yeast.S_pseudosimplitigsAC.k_19.d_12.M_ones
yeast	pseudosimplitigsAC	19	12	runs	11479729	11680417	11506706	173711	20039	3015740	42672	3058412	3062080	yeast.S_pseudosimplitigsAC.k_19.d_12.M_runs
yeast	pseudosimplitigsAC	19	12	zeros	11479729	11680417	11479729	200688	27748	3015740	60068	3075808	3075720	yeast.S_pseudosimplitigsAC.k_19.d_12.M_zeros
yeast	pseudosimplitigsAC	19	2	default	11479729	11634506	11479729	154777	12521	3005168	32680	3037848	3036908	yeast.S_pseudosimplitigsAC.k_19.d_2.M_default
yeast	pseudosimplitigsAC	19	2	ones	11479729	11634506	11493831	140675	9757	3005168	26360	3031528	3033408	yeast.S_pseudosimplitigsAC.k_19.d_2.M_ones
yeast	pseudosimplitigsAC	19	2	runs	11479729	11634506	11491950	142556	8849	3005168	24808	3029976	3032012	yeast.S_pseudosimplitigsAC.k_19.d_2.M_runs
yeast	pseudosimplitigsAC	19	2	zeros	11479729	11634506	11479729	154777	12899	3005168	33876	3039044	3037888	yeast.S_pseudosimplitigsAC.k_19.d_2.M_zeros
yeast	pseudosimplitigsAC	19	3	default	11479729	11606078	11479729	126349	13028	2998624	35088	3033712	3031516	yeast.S_pseudosimplitigsAC.k_19.d_3.M_default
yeast	pseudosimplitigsAC	19	3	ones	11479729	11606078	11494729	111349	8159	2998624	22912	3021536	3022692	yeast.S_pseudosimplitigsAC.k_19.d_3.M_ones
yeast	pseudosimplitigsAC	19	3	runs	11479729	11606078	11493491	112587	7556	2998624	21852	3020476	3021860	yeast.S_pseudosimplitigsAC.k_19.d_3.M_runs
yeast	pseudosimplitigsAC	19	3	zeros	11479729	11606078	11479729	126349	13152	2998624	35460	3034084	3030296	yeast.S_pseudosimplitigsAC.k_19.d_3.M_zeros
yeast	pseudosimplitigsAC	19	4	default	11479729	11596143	11479729	116414	13541	2997560	36676	3034236	3027820	yeast.S_pseudosimplitigsAC.k_19.d_4.M_default
yeast	pseudosimplitigsAC	19	4	ones	11479729	11596143	11495441	100702	7759	2997560	22088	3019648	3018820	yeast.S_pseudosimplitigsAC.k_19.d_4.M_ones
yeast	pseudosimplitigsAC	19	4	runs	11479729	11596143	11494743	101400	7369	2997560	21444	3019004	3018360	yeast.S_pseudosimplitigsAC.k_19.d_4.M_runs
yeast	pseudosimplitigsAC	19	4	zeros	11479729	11596143	11479729	116414	13579	2997560	36808	3034368	3028196	yeast.S_pseudosimplitigsAC.k_19.d_4.M_zeros
yeast	pseudosimplitigsAC	19	5	default	11479729	11591414	11479729	111685	13957	2995844	37904	3033748	3027448	yeast.S_pseudosimplitigsAC.k_19.d_5.M_default
yeast	pseudosimplitigsAC	19	5	ones	11479729	11591414	11496380	95034	7714	2995844	22200	3018044	3017096	yeast.S_pseudosimplitigsAC.k_19.d_5.M_ones
yeast	pseudosimplitigsAC	19	5	runs	11479729	11591414	11495958	95456	7443	2995844	21860	3017704	3016712	yeast.S_pseudosimplitigsAC.k_19.d_5.M_runs
yeast	pseudosimplitigsAC	19	5	zeros	11479729	11591414	11479729	111685	13979	2995844	37992	3033836	3027516	yeast.S_pseudosimplitigsAC.k_19.d_5.M_zeros
yeast	pseudosimplitigsAC	19	6	default	11479729	11587617	11479729	107888	14425	2994352	39480	3033832	3027372	yeast.S_pseudosimplitigsAC.k_19.d_6.M_default
yeast	pseudosimplitigsAC	19	6	ones	11479729	11587617	11498689	88928	7778	2994352	22904	3017256	3015940	yeast.S_pseudosimplitigsAC.k_19.d_6.M_ones
yeast	pseudosimplitigsAC	19	6	runs	11479729	11587617	11498264	89353	7494	2994352	22568	3016920	3015468	yeast.S_pseudosimplitigsAC.k_19.d_6.M_runs
yeast	pseudosimplitigsAC	19	6	zeros	11479729	11587617	11479729	107888	14444	2994352	39540	3033892	3027164	yeast.S_pseudosimplitigsAC.k_19.d_6.M_zeros
yeast	pseudosimplitigsAC	19	7	default	11479729	11590354	11479729	110625	15257	2995800	41956	3037756	3030936	yeast.S_pseudosimplitigsAC.k_19.d_7.M_default
yeast	pseudosimplitigsAC	19	7	ones	11479729	11590354	11499935	90419	8483	2995800	25164	3020964	3020524	yeast.S_pseudosimplitigsAC.k_19.d_7.M_ones
yeast	pseudosimplitigsAC	19	7	runs	11479729	11590354	11499538	90816	8213	2995800	24844	3020644	3019948	yeast.S_pseudosimplitigsAC.k_19.d_7.M_runs
yeast	pseudosimplitigsAC	19	7	zeros	11479729	11590354	11479729	110625	15278	2995800	42096	3037896	3031356	yeast.S_pseudosimplitigsAC.k_19.d_7.M_zeros
yeast	pseudosimplitigsAC	19	8	default	11479729	11596011	11479729	116282	16511	2996904	45104	3042008	3034436	yeast.S_pseudosimplitigsAC.k_19.d_8.M_default
yeast	pseudosimplitigsAC	19	8	ones	11479729	11596011	11501769	94242	9523	2996904	28324	3025228	3021336	yeast.S_pseudosimplitigsAC.k_19.d_8.M_ones
yeast	pseudosimplitigsAC	19	8	runs	11479729	11596011	11501366	94645	9243	2996904	27996	3024900	3020928	yeast.S_pseudosimplitigsAC.k_19.d_8.M_runs
yeast	pseudosimplitigsAC	19	8	zeros	11479729	11596011	11479729	116282	16539	2996904	45160	3042064	3034404	yeast.S_pseudosimplitigsAC.k_19.d_8.M_zeros
yeast	pseudosimplitigsAC	19	9	default	11479729	11611179	11479729	131450	18815	3000728	50068	3050796	3042980	yeast.S_pseudosimplitigsAC.k_19.d_9.M_default
yeast	pseudosimplitigsAC	19	9	ones	11479729	11611179	11503619	107560	11760	3000728	33404	3034132	3030264	yeast.S_pseudosimplitigsAC.k_19.d_9.M_ones
yeast	pseudosimplitigsAC	19	9	runs	11479729	11611179	11503064	108115	11414	3000728	33044	3033772	3029680	yeast.S_pseudosimplitigsAC.k_19.d_9.M_runs
yeast	pseudosimplitigsAC	19	9	zeros	11479729	11611179	11479729	131450	18841	3000728	50216	3050944	3043596	yeast.S_pseudosimplitigsAC.k_19.d_9.M_zeros
yeast	pseudosimplitigs	20	1	default	11494358	11666441	11494358	172083	9057	3005196	22336	3027532	3034092	yeast.S_pseudosimplitigs.k_20.d_1.M_default
yeast	pseudosimplitigs	20	1	ones	11494358	11666441	11506315	160126	9933	3005196	26608	3031804	3036712	yeast.S_pseudosimplitigs.k_20.d_1.M_ones
yeast	pseudosimplitigs	20	1	runs	11494358	11666441	11504233	162208	8945	3005196	25004	3030200	3035276	yeast.S_pseudosimplitigs.k_20.d_1.M_runs
yeast	pseudosimplitigs	20	1	zeros	11494358	11666441	11494358	172083	9774	3005196	24736	3029932	3035940	yeast.S_pseudosimplitigs.k_20.d_1.M_zeros
yeast	pseudosimplitigs	20	10	default	11494358	11616144	11494358	121786	14754	3000460	40244	3040704	3036972	yeast.S_pseudosimplitigs.k_20.d_10.M_default
yeast	pseudosimplitigs	20	10	ones	11494358	11616144	11514324	101820	9777	3000460	28924	3029384	3027612	yeast.S_pseudosimplitigs.k_20.d_10.M_ones
yeast	pseudosimplitigs	20	10	runs	11494358	11616144	11513993	102151	9571	3000460	28656	3029116	3027724	yeast.S_pseudosimplitigs.k_20.d_10.M_runs
yeast	pseudosimplitigs	20	10	zeros	11494358	11616144	11494358	121786	14791	3000460	40300	3040760	3036976	yeast.S_pseudosimplitigs.k_20.d_10.M_zeros
yeast	pseudosimplitigs	20	11	default	11494358	11639595	11494358	145237	17434	3005596	44276	3049872	3047600	yeast.S_pseudosimplitigs.k_20.d_11.M_default
yeast	pseudosimplitigs	20	11	ones	11494358	11639595	11516345	123250	12334	3005596	32904	3038500	3037740	yeast.S_pseudosimplitigs.k_20.d_11.M_ones
yeast	pseudosimplitigs	20	11	runs	11494358	11639595	11515966	123629	12091	3005596	32624	3038220	3038264	yeast.S_pseudosimplitigs.k_20.d_11.M_runs
yeast	pseudosimplitigs	20	11	zeros	11494358	11639595	11494358	145237	17455	3005596	44340	3049936	3047668	yeast.S_pseudosimplitigs.k_20.d_11.M_zeros
yeast	pseudosimplitigs	20	12	default	11494358	11666780	11494358	172422	20450	3010980	47744	3058724	3059876	yeast.S_pseudosimplitigs.k_20.d_12.M_default
yeast	pseudosimplitigs	20	12	ones	11494358	11666780	11517642	149138	15350	3010980	36444	3047424	3049684	yeast.S_pseudosimplitigs.k_20.d_12.M_ones
yeast	pseudosimplitigs	20	12	runs	11494358	11666780	11517125	149655	15038	3010980	36144	3047124	3049940	yeast.S_pseudosimplitigs.k_20.d_12.M_runs
yeast	pseudosimplitigs	20	12	zeros	11494358	11666780	11494358	172422	20560	3010980	48236	3059216	3059460	yeast.S_pseudosimplitigs.k_20.d_12.M_zeros
yeast	pseudosimplitigs	20	2	default	11494358	11625956	11494358	131598	9504	2998812	24976	3023788	3025356	yeast.S_pseudosimplitigs.k_20.d_2.M_default
yeast	pseudosimplitigs	20	2	ones	11494358	11625956	11504453	121503	7609	2998812	21268	3020080	3021780	yeast.S_pseudosimplitigs.k_20.d_2.M_ones
yeast	pseudosimplitigs	20	2	runs	11494358	11625956	11503305	122651	7075	2998812	20348	3019160	3021200	yeast.S_pseudosimplitigs.k_20.d_2.M_runs
yeast	pseudosimplitigs	20	2	zeros	11494358	11625956	11494358	131598	9715	2998812	25652	3024464	3026336	yeast.S_pseudosimplitigs.k_20.d_2.M_zeros
yeast	pseudosimplitigs	20	3	default	11494358	11609756	11494358	115398	9811	2995684	26300	3021984	3026588	yeast.S_pseudosimplitigs.k_20.d_3.M_default
yeast	pseudosimplitigs	20	3	ones	11494358	11609756	11504720	105036	6817	2995684	19528	3015212	3017008	yeast.S_pseudosimplitigs.k_20.d_3.M_ones
yeast	pseudosimplitigs	20	3	runs	11494358	11609756	11503928	105828	6424	2995684	18784	3014468	3016752	yeast.S_pseudosimplitigs.k_20.d_3.M_runs
yeast	pseudosimplitigs	20	3	zeros	11494358	11609756	11494358	115398	9882	2995684	26592	3022276	3023644	yeast.S_pseudosimplitigs.k_20.d_3.M_zeros
yeast	pseudosimplitigs	20	4	default	11494358	11601972	11494358	107614	10147	2994604	27408	3022012	3021988	yeast.S_pseudosimplitigs.k_20.d_4.M_default
yeast	pseudosimplitigs	20	4	ones	11494358	11601972	11505414	96558	6504	2994604	19040	3013644	3015688	yeast.S_pseudosimplitigs.k_20.d_4.M_ones
yeast	pseudosimplitigs	20	4	runs	11494358	11601972	11504952	97020	6254	2994604	18580	3013184	3014860	yeast.S_pseudosimplitigs.k_20.d_4.M_runs
yeast	pseudosimplitigs	20	4	zeros	11494358	11601972	11494358	107614	10174	2994604	27512	3022116	3023112	yeast.S_pseudosimplitigs.k_20.d_4.M_zeros
yeast	pseudosimplitigs	20	5	default	11494358	11595121	11494358	100763	10454	2993484	28424	3021908	3021392	yeast.S_pseudosimplitigs.k_20.d_5.M_default
yeast	pseudosimplitigs	20	5	ones	11494358	11595121	11507089	88032	6240	2993484	18668	3012152	3012392	yeast.S_pseudosimplitigs.k_20.d_5.M_ones
yeast	pseudosimplitigs	20	5	runs	11494358	11595121	11506757	88364	6044	2993484	18376	3011860	3012052	yeast.S_pseudosimplitigs.k_20.d_5.M_runs
yeast	pseudosimplitigs	20	5	zeros	11494358	11595121	11494358	100763	10474	2993484	28476	3021960	3020684	yeast.S_pseudosimplitigs.k_20.d_5.M_zeros
yeast	pseudosimplitigs	20	6	default	11494358	11592638	11494358	98280	10678	2992520	29440	3021960	3019564	yeast.S_pseudosimplitigs.k_20.d_6.M_default
yeast	pseudosimplitigs	20	6	ones	11494358	11592638	11508217	84421	6232	2992520	18900	3011420	3012300	yeast.S_pseudosimplitigs.k_20.d_6.M_ones
yeast	pseudosimplitigs	20	6	runs	11494358	11592638	11507962	84676	6071	2992520	18696	3011216	3012184	yeast.S_pseudosimplitigs.k_20.d_6.M_runs
yeast	pseudosimplitigs	20	6	zeros	11494358	11592638	11494358	98280	10696	2992520	29504	3022024	3020792	yeast.S_pseudosimplitigs.k_20.d_6.M_zeros
yeast	pseudosimplitigs	20	7	default	11494358	11592745	11494358	98387	11092	2992536	30664	3023200	3020720	yeast.S_pseudosimplitigs.k_20.d_7.M_default
yeast	pseudosimplitigs	20	7	ones	11494358	11592745	11509398	83347	6464	2992536	19764	3012300	3012400	yeast.S_pseudosimplitigs.k_20.d_7.M_ones
yeast	pseudosimplitigs	20	7	runs	11494358	11592745	11509166	83579	6305	2992536	19568	3012104	3011812	yeast.S_pseudosimplitigs.k_20.d_7.M_runs
yeast	pseudosimplitigs	20	7	zeros	11494358	11592745	11494358	98387	11100	2992536	30720	3023256	3021420	yeast.S_pseudosimplitigs.k_20.d_7.M_zeros
yeast	pseudosimplitigs	20	8	default	11494358	11593600	11494358	99242	11658	2991920	32584	3024504	3021968	yeast.S_pseudosimplitigs.k_20.d_8.M_default
yeast	pseudosimplitigs	20	8	ones	11494358	11593600	11511741	81859	6801	2991920	21144	3013064	3012568	yeast.S_pseudosimplitigs.k_20.d_8.M_ones
yeast	pseudosimplitigs	20	8	runs	11494358	11593600	11511474	82126	6626	2991920	20924	3012844	3012088	yeast.S_pseudosimplitigs.k_20.d_8.M_runs
yeast	pseudosimplitigs	20	8	zeros	11494358	11593600	11494358	99242	11690	2991920	32704	3024624	3022160	yeast.S_pseudosimplitigs.k_20.d_8.M_zeros
yeast	pseudosimplitigs	20	9	default	11494358	11600970	11494358	106612	12825	2994764	35864	3030628	3027876	yeast.S_pseudosimplitigs.k_20.d_9.M_default
yeast	pseudosimplitigs	20	9	ones	11494358	11600970	11512831	88139	7856	2994764	24340	3019104	3018220	yeast.S_pseudosimplitigs.k_20.d_9.M_ones
yeast	pseudosimplitigs	20	9	runs	11494358	11600970	11512521	88449	7662	2994764	24096	3018860	3017688	yeast.S_pseudosimplitigs.k_20.d_9.M_runs
yeast	pseudosimplitigs	20	9	zeros	11494358	11600970	11494358	106612	12846	2994764	35964	3030728	3027944	yeast.S_pseudosimplitigs.k_20.d_9.M_zeros
yeast	pseudosimplitigsAC	20	1	default	11494358	11666384	11494358	172026	9054	3007792	21704	3029496	3036476	yeast.S_pseudosimplitigsAC.k_20.d_1.M_default
yeast	pseudosimplitigsAC	20	1	ones	11494358	11666384	11506341	160043	9976	3007792	26296	3034088	3037032	yeast.S_pseudosimplitigsAC.k_20.d_1.M_ones
yeast	pseudosimplitigsAC	20	1	runs	11494358	11666384	11504113	162271	8946	3007792	24564	3032356	3036032	yeast.S_pseudosimplitigsAC.k_20.d_1.M_runs
yeast	pseudosimplitigsAC	20	1	zeros	11494358	11666384	11494358	172026	9806	3007792	24284	3032076	3037232	yeast.S_pseudosimplitigsAC.k_20.d_1.M_zeros
yeast	pseudosimplitigsAC	20	10	default	11494358	11612979	11494358	118621	14322	2999180	38804	3037984	3035396	yeast.S_pseudosimplitigsAC.k_20.d_10.M_default
yeast	pseudosimplitigsAC	20	10	ones	11494358	11612979	11513993	98986	9347	2999180	27732	3026912	3024756	yeast.S_pseudosimplitigsAC.k_20.d_10.M_ones
yeast	pseudosimplitigsAC	20	10	runs	11494358	11612979	11513646	99333	9137	2999180	27488	3026668	3024724	yeast.S_pseudosimplitigsAC.k_20.d_10.M_runs
yeast	pseudosimplitigsAC	20	10	zeros	11494358	11612979	11494358	118621	14353	2999180	38896	3038076	3035204	yeast.S_pseudosimplitigsAC.k_20.d_10.M_zeros
yeast	pseudosimplitigsAC	20	11	default	11494358	11638251	11494358	143893	17292	3004512	43628	3048140	3046820	yeast.S_pseudosimplitigsAC.k_20.d_11.M_default
yeast	pseudosimplitigsAC	20	11	ones	11494358	11638251	11515813	122438	12233	3004512	32468	3036980	3038508	yeast.S_pseudosimplitigsAC.k_20.d_11.M_ones
yeast	pseudosimplitigsAC	20	11	runs	11494358	11638251	11515474	122777	11999	3004512	32216	3036728	3036696	yeast.S_pseudosimplitigsAC.k_20.d_11.M_runs
yeast	pseudosimplitigsAC	20	11	zeros	11494358	11638251	11494358	143893	17335	3004512	43804	3048316	3047584	yeast.S_pseudosimplitigsAC.k_20.d_11.M_zeros
yeast	pseudosimplitigsAC	20	12	default	11494358	11667827	11494358	173469	20520	3012284	47172	3059456	3059392	yeast.S_pseudosimplitigsAC.k_20.d_12.M_default
yeast	pseudosimplitigsAC	20	12	ones	11494358	11667827	11517315	150512	15472	3012284	36092	3048376	3050576	yeast.S_pseudosimplitigsAC.k_20.d_12.M_ones
yeast	pseudosimplitigsAC	20	12	runs	11494358	11667827	11516717	151110	15120	3012284	35792	3048076	3049196	yeast.S_pseudosimplitigsAC.k_20.d_12.M_runs
yeast	pseudosimplitigsAC	20	12	zeros	11494358	11667827	11494358	173469	20605	3012284	47568	3059852	3060520	yeast.S_pseudosimplitigsAC.k_20.d_12.M_zeros
yeast	pseudosimplitigsAC	20	2	default	11494358	11625782	11494358	131424	9492	3000292	24376	3024668	3027192	yeast.S_pseudosimplitigsAC.k_20.d_2.M_default
yeast	pseudosimplitigsAC	20	2	ones	11494358	11625782	11504812	120970	7615	3000292	20924	3021216	3023192	yeast.S_pseudosimplitigsAC.k_20.d_2.M_ones
yeast	pseudosimplitigsAC	20	2	runs	11494358	11625782	11503618	122164	7043	3000292	19928	3020220	3022348	yeast.S_pseudosimplitigsAC.k_20.d_2.M_runs
yeast	pseudosimplitigsAC	20	2	zeros	11494358	11625782	11494358	131424	9736	3000292	25228	3025520	3027120	yeast.S_pseudosimplitigsAC.k_20.d_2.M_zeros
yeast	pseudosimplitigsAC	20	3	default	11494358	11609370	11494358	115012	9815	2996932	25856	3022788	3023128	yeast.S_pseudosimplitigsAC.k_20.d_3.M_default
yeast	pseudosimplitigsAC	20	3	ones	11494358	11609370	11504753	104617	6794	2996932	19100	3016032	3018208	yeast.S_pseudosimplitigsAC.k_20.d_3.M_ones
yeast	pseudosimplitigsAC	20	3	runs	11494358	11609370	11503935	105435	6410	2996932	18384	3015316	3017888	yeast.S_pseudosimplitigsAC.k_20.d_3.M_runs
yeast	pseudosimplitigsAC	20	3	zeros	11494358	11609370	11494358	115012	9892	2996932	26132	3023064	3023716	yeast.S_pseudosimplitigsAC.k_20.d_3.M_zeros
yeast	pseudosimplitigsAC	20	4	default	11494358	11601652	11494358	107294	10119	2995852	26880	3022732	3022144	yeast.S_pseudosimplitigsAC.k_20.d_4.M_default
yeast	pseudosimplitigsAC	20	4	ones	11494358	11601652	11505634	96018	6445	2995852	18636	3014488	3015484	yeast.S_pseudosimplitigsAC.k_20.d_4.M_ones
yeast	pseudosimplitigsAC	20	4	runs	11494358	11601652	11505083	96569	6194	2995852	18180	3014032	3015148	yeast.S_pseudosimplitigsAC.k_20.d_4.M_runs
yeast	pseudosimplitigsAC	20	4	zeros	11494358	11601652	11494358	107294	10146	2995852	27036	3022888	3022508	yeast.S_pseudosimplitigsAC.k_20.d_4.M_zeros
yeast	pseudosimplitigsAC	20	5	default	11494358	11594495	11494358	100137	10396	2994844	27776	3022620	3021072	yeast.S_pseudosimplitigsAC.k_20.d_5.M_default
yeast	pseudosimplitigsAC	20	5	ones	11494358	11594495	11507010	87485	6165	2994844	18192	3013036	3012912	yeast.S_pseudosimplitigsAC.k_20.d_5.M_ones
yeast	pseudosimplitigsAC	20	5	runs	11494358	11594495	11506697	87798	5985	2994844	17896	3012740	3012628	yeast.S_pseudosimplitigsAC.k_20.d_5.M_runs
yeast	pseudosimplitigsAC	20	5	zeros	11494358	11594495	11494358	100137	10419	2994844	27864	3022708	3020792	yeast.S_pseudosimplitigsAC.k_20.d_5.M_zeros
yeast	pseudosimplitigsAC	20	6	default	11494358	11592508	11494358	98150	10658	2993196	28924	3022120	3021548	yeast.S_pseudosimplitigsAC.k_20.d_6.M_default
yeast	pseudosimplitigsAC	20	6	ones	11494358	11592508	11508007	84501	6223	2993196	18656	3011852	3012016	yeast.S_pseudosimplitigsAC.k_20.d_6.M_ones
yeast	pseudosimplitigsAC	20	6	runs	11494358	11592508	11507757	84751	6068	2993196	18440	3011636	3011696	yeast.S_pseudosimplitigsAC.k_20.d_6.M_runs
yeast	pseudosimplitigsAC	20	6	zeros	11494358	11592508	11494358	98150	10665	2993196	28992	3022188	3020964	yeast.S_pseudosimplitigsAC.k_20.d_6.M_zeros
yeast	pseudosimplitigsAC	20	7	default	11494358	11592630	11494358	98272	11022	2993796	30028	3023824	3022692	yeast.S_pseudosimplitigsAC.k_20.d_7.M_default
yeast	pseudosimplitigsAC	20	7	ones	11494358	11592630	11509400	83230	6452	2993796	19468	3013264	3012704	yeast.S_pseudosimplitigsAC.k_20.d_7.M_ones
yeast	pseudosimplitigsAC	20	7	runs	11494358	11592630	11509125	83505	6279	2993796	19264	3013060	3012660	yeast.S_pseudosimplitigsAC.k_20.d_7.M_runs
yeast	pseudosimplitigsAC	20	7	zeros	11494358	11592630	11494358	98272	11035	2993796	30084	3023880	3021848	yeast.S_pseudosimplitigsAC.k_20.d_7.M_zeros
yeast	pseudosimplitigsAC	20	8	default	11494358	11593207	11494358	98849	11594	2994100	32056	3026156	3022536	yeast.S_pseudosimplitigsAC.k_20.d_8.M_default
yeast	pseudosimplitigsAC	20	8	ones	11494358	11593207	11511212	81995	6792	2994100	21040	3015140	3013264	yeast.S_pseudosimplitigsAC.k_20.d_8.M_ones
yeast	pseudosimplitigsAC	20	8	runs	11494358	11593207	11510941	82266	6632	2994100	20820	3014920	3013488	yeast.S_pseudosimplitigsAC.k_20.d_8.M_runs
yeast	pseudosimplitigsAC	20	8	zeros	11494358	11593207	11494358	98849	11602	2994100	32100	3026200	3022944	yeast.S_pseudosimplitigsAC.k_20.d_8.M_zeros
yeast	pseudosimplitigsAC	20	9	default	11494358	11600464	11494358	106106	12729	2995672	35268	3030940	3029384	yeast.S_pseudosimplitigsAC.k_20.d_9.M_default
yeast	pseudosimplitigsAC	20	9	ones	11494358	11600464	11512544	87920	7833	2995672	24036	3019708	3018656	yeast.S_pseudosimplitigsAC.k_20.d_9.M_ones
yeast	pseudosimplitigsAC	20	9	runs	11494358	11600464	11512214	88250	7645	2995672	23780	3019452	3018608	yeast.S_pseudosimplitigsAC.k_20.d_9.M_runs
yeast	pseudosimplitigsAC	20	9	zeros	11494358	11600464	11494358	106106	12741	2995672	35268	3030940	3028860	yeast.S_pseudosimplitigsAC.k_20.d_9.M_zeros
yeast	pseudosimplitigs	21	1	default	11505228	11650348	11505228	145120	7256	3001592	18180	3019772	3024820	yeast.S_pseudosimplitigs.k_21.d_1.M_default
yeast	pseudosimplitigs	21	1	ones	11505228	11650348	11513973	136375	7772	3001592	21332	3022924	3026168	yeast.S_pseudosimplitigs.k_21.d_1.M_ones
yeast	pseudosimplitigs	21	1	runs	11505228	11650348	11512754	137594	7198	3001592	20352	3021944	3025376	yeast.S_pseudosimplitigs.k_21.d_1.M_runs
yeast	pseudosimplitigs	21	1	zeros	11505228	11650348	11505228	145120	7680	3001592	19724	3021316	3025560	yeast.S_pseudosimplitigs.k_21.d_1.M_zeros
yeast	pseudosimplitigs	21	10	default	11505228	11606644	11505228	101416	10466	2995540	29976	3025516	3024056	yeast.S_pseudosimplitigs.k_21.d_10.M_default
yeast	pseudosimplitigs	21	10	ones	11505228	11606644	11521685	84959	6877	2995540	21908	3017448	3016204	yeast.S_pseudosimplitigs.k_21.d_10.M_ones
yeast	pseudosimplitigs	21	10	runs	11505228	11606644	11521468	85176	6746	2995540	21772	3017312	3015932	yeast.S_pseudosimplitigs.k_21.d_10.M_runs
yeast	pseudosimplitigs	21	10	zeros	11505228	11606644	11505228	101416	10486	2995540	30020	3025560	3024244	yeast.S_pseudosimplitigs.k_21.d_10.M_zeros
yeast	pseudosimplitigs	21	11	default	11505228	11621530	11505228	116302	12124	2998316	33704	3032020	3031788	yeast.S_pseudosimplitigs.k_21.d_11.M_default
yeast	pseudosimplitigs	21	11	ones	11505228	11621530	11523312	98218	8435	2998316	25772	3024088	3023460	yeast.S_pseudosimplitigs.k_21.d_11.M_ones
yeast	pseudosimplitigs	21	11	runs	11505228	11621530	11523076	98454	8302	2998316	25576	3023892	3023696	yeast.S_pseudosimplitigs.k_21.d_11.M_runs
yeast	pseudosimplitigs	21	11	zeros	11505228	11621530	11505228	116302	12152	2998316	33776	3032092	3031972	yeast.S_pseudosimplitigs.k_21.d_11.M_zeros
yeast	pseudosimplitigs	21	12	default	11505228	11645989	11505228	140761	14648	3003112	37820	3040932	3041940	yeast.S_pseudosimplitigs.k_21.d_12.M_default
yeast	pseudosimplitigs	21	12	ones	11505228	11645989	11524658	121331	10884	3003112	29720	3032832	3034880	yeast.S_pseudosimplitigs.k_21.d_12.M_ones
yeast	pseudosimplitigs	21	12	runs	11505228	11645989	11524366	121623	10702	3003112	29560	3032672	3034564	yeast.S_pseudosimplitigs.k_21.d_12.M_runs
yeast	pseudosimplitigs	21	12	zeros	11505228	11645989	11505228	140761	14761	3003112	38312	3041424	3043008	yeast.S_pseudosimplitigs.k_21.d_12.M_zeros
yeast	pseudosimplitigs	21	2	default	11505228	11627107	11505228	121879	7594	2996720	19952	3016672	3022940	yeast.S_pseudosimplitigs.k_21.d_2.M_default
yeast	pseudosimplitigs	21	2	ones	11505228	11627107	11512910	114197	6582	2996720	18684	3015404	3018836	yeast.S_pseudosimplitigs.k_21.d_2.M_ones
yeast	pseudosimplitigs	21	2	runs	11505228	11627107	11512131	114976	6236	2996720	18000	3014720	3017840	yeast.S_pseudosimplitigs.k_21.d_2.M_runs
yeast	pseudosimplitigs	21	2	zeros	11505228	11627107	11505228	121879	7737	2996720	20540	3017260	3020528	yeast.S_pseudosimplitigs.k_21.d_2.M_zeros
yeast	pseudosimplitigs	21	3	default	11505228	11615856	11505228	110628	7809	2995392	20952	3016344	3018688	yeast.S_pseudosimplitigs.k_21.d_3.M_default
yeast	pseudosimplitigs	21	3	ones	11505228	11615856	11512912	102944	6038	2995392	17524	3012916	3016384	yeast.S_pseudosimplitigs.k_21.d_3.M_ones
yeast	pseudosimplitigs	21	3	runs	11505228	11615856	11512465	103391	5830	2995392	17104	3012496	3015628	yeast.S_pseudosimplitigs.k_21.d_3.M_runs
yeast	pseudosimplitigs	21	3	zeros	11505228	11615856	11505228	110628	7857	2995392	21128	3016520	3018936	yeast.S_pseudosimplitigs.k_21.d_3.M_zeros
yeast	pseudosimplitigs	21	4	default	11505228	11606008	11505228	100780	8041	2993476	21992	3015468	3016536	yeast.S_pseudosimplitigs.k_21.d_4.M_default
yeast	pseudosimplitigs	21	4	ones	11505228	11606008	11514194	91814	5585	2993476	16624	3010100	3011088	yeast.S_pseudosimplitigs.k_21.d_4.M_ones
yeast	pseudosimplitigs	21	4	runs	11505228	11606008	11513910	92098	5437	2993476	16324	3009800	3010984	yeast.S_pseudosimplitigs.k_21.d_4.M_runs
yeast	pseudosimplitigs	21	4	zeros	11505228	11606008	11505228	100780	8064	2993476	22096	3015572	3017728	yeast.S_pseudosimplitigs.k_21.d_4.M_zeros
yeast	pseudosimplitigs	21	5	default	11505228	11601564	11505228	96336	8155	2993288	22376	3015664	3016432	yeast.S_pseudosimplitigs.k_21.d_5.M_default
yeast	pseudosimplitigs	21	5	ones	11505228	11601564	11514954	86610	5413	2993288	16300	3009588	3010660	yeast.S_pseudosimplitigs.k_21.d_5.M_ones
yeast	pseudosimplitigs	21	5	runs	11505228	11601564	11514765	86799	5302	2993288	16108	3009396	3010532	yeast.S_pseudosimplitigs.k_21.d_5.M_runs
yeast	pseudosimplitigs	21	5	zeros	11505228	11601564	11505228	96336	8173	2993288	22448	3015736	3016644	yeast.S_pseudosimplitigs.k_21.d_5.M_zeros
yeast	pseudosimplitigs	21	6	default	11505228	11599314	11505228	94086	8390	2992140	23136	3015276	3016180	yeast.S_pseudosimplitigs.k_21.d_6.M_default
yeast	pseudosimplitigs	21	6	ones	11505228	11599314	11516063	83251	5410	2992140	16516	3008656	3008984	yeast.S_pseudosimplitigs.k_21.d_6.M_ones
yeast	pseudosimplitigs	21	6	runs	11505228	11599314	11515907	83407	5310	2992140	16360	3008500	3009300	yeast.S_pseudosimplitigs.k_21.d_6.M_runs
yeast	pseudosimplitigs	21	6	zeros	11505228	11599314	11505228	94086	8407	2992140	23196	3015336	3016812	yeast.S_pseudosimplitigs.k_21.d_6.M_zeros
yeast	pseudosimplitigs	21	7	default	11505228	11596429	11505228	91201	8578	2991916	24164	3016080	3016800	yeast.S_pseudosimplitigs.k_21.d_7.M_default
yeast	pseudosimplitigs	21	7	ones	11505228	11596429	11517876	78553	5302	2991916	16632	3008548	3008948	yeast.S_pseudosimplitigs.k_21.d_7.M_ones
yeast	pseudosimplitigs	21	7	runs	11505228	11596429	11517706	78723	5195	2991916	16492	3008408	3008820	yeast.S_pseudosimplitigs.k_21.d_7.M_runs
yeast	pseudosimplitigs	21	7	zeros	11505228	11596429	11505228	91201	8596	2991916	24204	3016120	3016756	yeast.S_pseudosimplitigs.k_21.d_7.M_zeros
yeast	pseudosimplitigs	21	8	default	11505228	11596806	11505228	91578	8909	2991144	25124	3016268	3017040	yeast.S_pseudosimplitigs.k_21.d_8.M_default
yeast	pseudosimplitigs	21	8	ones	11505228	11596806	11518781	78025	5518	2991144	17340	3008484	3008644	yeast.S_pseudosimplitigs.k_21.d_8.M_ones
yeast	pseudosimplitigs	21	8	runs	11505228	11596806	11518635	78171	5425	2991144	17236	3008380	3008300	yeast.S_pseudosimplitigs.k_21.d_8.M_runs
yeast	pseudosimplitigs	21	8	zeros	11505228	11596806	11505228	91578	8921	2991144	25160	3016304	3018388	yeast.S_pseudosimplitigs.k_21.d_8.M_zeros
yeast	pseudosimplitigs	21	9	default	11505228	11599295	11505228	94067	9423	2990920	26972	3017892	3018568	yeast.S_pseudosimplitigs.k_21.d_9.M_default
yeast	pseudosimplitigs	21	9	ones	11505228	11599295	11520165	79130	5906	2990920	18980	3009900	3010132	yeast.S_pseudosimplitigs.k_21.d_9.M_ones
yeast	pseudosimplitigs	21	9	runs	11505228	11599295	11519984	79311	5799	2990920	18868	3009788	3009828	yeast.S_pseudosimplitigs.k_21.d_9.M_runs
yeast	pseudosimplitigs	21	9	zeros	11505228	11599295	11505228	94067	9445	2990920	27036	3017956	3018768	yeast.S_pseudosimplitigs.k_21.d_9.M_zeros
yeast	pseudosimplitigsAC	21	1	default	11505228	11650388	11505228	145160	7258	3004324	17636	3021960	3028048	yeast.S_pseudosimplitigsAC.k_21.d_1.M_default
yeast	pseudosimplitigsAC	21	1	ones	11505228	11650388	11514198	136190	7787	3004324	20992	3025316	3032836	yeast.S_pseudosimplitigsAC.k_21.d_1.M_ones
yeast	pseudosimplitigsAC	21	1	runs	11505228	11650388	11512826	137562	7191	3004324	19988	3024312	3028876	yeast.S_pseudosimplitigsAC.k_21.d_1.M_runs
yeast	pseudosimplitigsAC	21	1	zeros	11505228	11650388	11505228	145160	7780	3004324	19524	3023848	3030240	yeast.S_pseudosimplitigsAC.k_21.d_1.M_zeros
yeast	pseudosimplitigsAC	21	10	default	11505228	11605338	11505228	100110	10257	2994936	29056	3023992	3024184	yeast.S_pseudosimplitigsAC.k_21.d_10.M_default
yeast	pseudosimplitigsAC	21	10	ones	11505228	11605338	11521545	83793	6644	2994936	21072	3016008	3017032	yeast.S_pseudosimplitigsAC.k_21.d_10.M_ones
yeast	pseudosimplitigsAC	21	10	runs	11505228	11605338	11521380	83958	6538	2994936	20956	3015892	3016888	yeast.S_pseudosimplitigsAC.k_21.d_10.M_runs
yeast	pseudosimplitigsAC	21	10	zeros	11505228	11605338	11505228	100110	10270	2994936	29124	3024060	3023928	yeast.S_pseudosimplitigsAC.k_21.d_10.M_zeros
yeast	pseudosimplitigsAC	21	11	default	11505228	11620384	11505228	115156	11985	2997792	33112	3030904	3031236	yeast.S_pseudosimplitigsAC.k_21.d_11.M_default
yeast	pseudosimplitigsAC	21	11	ones	11505228	11620384	11523273	97111	8283	2997792	25004	3022796	3024360	yeast.S_pseudosimplitigsAC.k_21.d_11.M_ones
yeast	pseudosimplitigsAC	21	11	runs	11505228	11620384	11523031	97353	8146	2997792	24868	3022660	3024308	yeast.S_pseudosimplitigsAC.k_21.d_11.M_runs
yeast	pseudosimplitigsAC	21	11	zeros	11505228	11620384	11505228	115156	12012	2997792	33260	3031052	3031852	yeast.S_pseudosimplitigsAC.k_21.d_11.M_zeros
yeast	pseudosimplitigsAC	21	12	default	11505228	11644924	11505228	139696	14532	3003048	37332	3040380	3041232	yeast.S_pseudosimplitigsAC.k_21.d_12.M_default
yeast	pseudosimplitigsAC	21	12	ones	11505228	11644924	11524657	120267	10795	3003048	29280	3032328	3034328	yeast.S_pseudosimplitigsAC.k_21.d_12.M_ones
yeast	pseudosimplitigsAC	21	12	runs	11505228	11644924	11524348	120576	10611	3003048	29100	3032148	3033504	yeast.S_pseudosimplitigsAC.k_21.d_12.M_runs
yeast	pseudosimplitigsAC	21	12	zeros	11505228	11644924	11505228	139696	14626	3003048	37832	3040880	3042656	yeast.S_pseudosimplitigsAC.k_21.d_12.M_zeros
yeast	pseudosimplitigsAC	21	2	default	11505228	11627005	11505228	121777	7568	2999660	19384	3019044	3021748	yeast.S_pseudosimplitigsAC.k_21.d_2.M_default
yeast	pseudosimplitigsAC	21	2	ones	11505228	11627005	11512933	114072	6526	2999660	18068	3017728	3021096	yeast.S_pseudosimplitigsAC.k_21.d_2.M_ones
yeast	pseudosimplitigsAC	21	2	runs	11505228	11627005	11512186	114819	6182	2999660	17424	3017084	3020132	yeast.S_pseudosimplitigsAC.k_21.d_2.M_runs
yeast	pseudosimplitigsAC	21	2	zeros	11505228	11627005	11505228	121777	7708	2999660	19900	3019560	3023600	yeast.S_pseudosimplitigsAC.k_21.d_2.M_zeros
yeast	pseudosimplitigsAC	21	3	default	11505228	11615557	11505228	110329	7779	2997256	20500	3017756	3022592	yeast.S_pseudosimplitigsAC.k_21.d_3.M_default
yeast	pseudosimplitigsAC	21	3	ones	11505228	11615557	11513240	102317	6011	2997256	17012	3014268	3017368	yeast.S_pseudosimplitigsAC.k_21.d_3.M_ones
yeast	pseudosimplitigsAC	21	3	runs	11505228	11615557	11512743	102814	5774	2997256	16532	3013788	3016828	yeast.S_pseudosimplitigsAC.k_21.d_3.M_runs
yeast	pseudosimplitigsAC	21	3	zeros	11505228	11615557	11505228	110329	7839	2997256	20736	3017992	3019456	yeast.S_pseudosimplitigsAC.k_21.d_3.M_zeros
yeast	pseudosimplitigsAC	21	4	default	11505228	11605782	11505228	100554	7965	2996216	21228	3017444	3018488	yeast.S_pseudosimplitigsAC.k_21.d_4.M_default
yeast	pseudosimplitigsAC	21	4	ones	11505228	11605782	11514235	91547	5540	2996216	16128	3012344	3014144	yeast.S_pseudosimplitigsAC.k_21.d_4.M_ones
yeast	pseudosimplitigsAC	21	4	runs	11505228	11605782	11513893	91889	5383	2996216	15824	3012040	3013400	yeast.S_pseudosimplitigsAC.k_21.d_4.M_runs
yeast	pseudosimplitigsAC	21	4	zeros	11505228	11605782	11505228	100554	7984	2996216	21348	3017564	3018712	yeast.S_pseudosimplitigsAC.k_21.d_4.M_zeros
yeast	pseudosimplitigsAC	21	5	default	11505228	11601642	11505228	96414	8147	2994388	22000	3016388	3019136	yeast.S_pseudosimplitigsAC.k_21.d_5.M_default
yeast	pseudosimplitigsAC	21	5	ones	11505228	11601642	11514965	86677	5407	2994388	15924	3010312	3011736	yeast.S_pseudosimplitigsAC.k_21.d_5.M_ones
yeast	pseudosimplitigsAC	21	5	runs	11505228	11601642	11514747	86895	5286	2994388	15704	3010092	3011672	yeast.S_pseudosimplitigsAC.k_21.d_5.M_runs
yeast	pseudosimplitigsAC	21	5	zeros	11505228	11601642	11505228	96414	8159	2994388	22024	3016412	3018200	yeast.S_pseudosimplitigsAC.k_21.d_5.M_zeros
yeast	pseudosimplitigsAC	21	6	default	11505228	11599353	11505228	94125	8316	2993296	22580	3015876	3016964	yeast.S_pseudosimplitigsAC.k_21.d_6.M_default
yeast	pseudosimplitigsAC	21	6	ones	11505228	11599353	11515998	83355	5337	2993296	15964	3009260	3010804	yeast.S_pseudosimplitigsAC.k_21.d_6.M_ones
yeast	pseudosimplitigsAC	21	6	runs	11505228	11599353	11515873	83480	5246	2993296	15852	3009148	3011220	yeast.S_pseudosimplitigsAC.k_21.d_6.M_runs
yeast	pseudosimplitigsAC	21	6	zeros	11505228	11599353	11505228	94125	8321	2993296	22620	3015916	3016416	yeast.S_pseudosimplitigsAC.k_21.d_6.M_zeros
yeast	pseudosimplitigsAC	21	7	default	11505228	11595858	11505228	90630	8510	2992284	23456	3015740	3018120	yeast.S_pseudosimplitigsAC.k_21.d_7.M_default
yeast	pseudosimplitigsAC	21	7	ones	11505228	11595858	11517829	78029	5218	2992284	16072	3008356	3009476	yeast.S_pseudosimplitigsAC.k_21.d_7.M_ones
yeast	pseudosimplitigsAC	21	7	runs	11505228	11595858	11517679	78179	5129	2992284	15948	3008232	3009152	yeast.S_pseudosimplitigsAC.k_21.d_7.M_runs
yeast	pseudosimplitigsAC	21	7	zeros	11505228	11595858	11505228	90630	8521	2992284	23524	3015808	3016372	yeast.S_pseudosimplitigsAC.k_21.d_7.M_zeros
yeast	pseudosimplitigsAC	21	8	default	11505228	11596411	11505228	91183	8819	2994204	24420	3018624	3019304	yeast.S_pseudosimplitigsAC.k_21.d_8.M_default
yeast	pseudosimplitigsAC	21	8	ones	11505228	11596411	11518797	77614	5459	2994204	16896	3011100	3011080	yeast.S_pseudosimplitigsAC.k_21.d_8.M_ones
yeast	pseudosimplitigsAC	21	8	runs	11505228	11596411	11518601	77810	5348	2994204	16724	3010928	3010456	yeast.S_pseudosimplitigsAC.k_21.d_8.M_runs
yeast	pseudosimplitigsAC	21	8	zeros	11505228	11596411	11505228	91183	8834	2994204	24480	3018684	3018728	yeast.S_pseudosimplitigsAC.k_21.d_8.M_zeros
yeast	pseudosimplitigsAC	21	9	default	11505228	11598626	11505228	93398	9294	2994976	26040	3021016	3020740	yeast.S_pseudosimplitigsAC.k_21.d_9.M_default
yeast	pseudosimplitigsAC	21	9	ones	11505228	11598626	11519962	78664	5819	2994976	18232	3013208	3012196	yeast.S_pseudosimplitigsAC.k_21.d_9.M_ones
yeast	pseudosimplitigsAC	21	9	runs	11505228	11598626	11519775	78851	5708	2994976	18108	3013084	3012384	yeast.S_pseudosimplitigsAC.k_21.d_9.M_runs
yeast	pseudosimplitigsAC	21	9	zeros	11505228	11598626	11505228	93398	9306	2994976	26076	3021052	3020836	yeast.S_pseudosimplitigsAC.k_21.d_9.M_zeros
